player,nationality,position,age,club,league,minutes_90s,p_tackled,tklw,def_3rd,mid_3rd,att_3rd,d_tackled,challenges,challenge_tackles_pct,challenges_lost,blocks,blocked_shots,blocked_passes,intr,tkl_intr,clr,err
Henrikh Mkhitaryan,ARM,MF,35,Inter,Serie A,30.9,62,34,18,35,9,24,49,49.0,25,23,4,19,29,91,43,0
Yann Sommer,SUI,GK,35,Inter,Serie A,34.0,2,1,2,0,0,2,2,100.0,0,1,0,1,0,2,7,1
Nicolò Barella,ITA,MF,27,Inter,Serie A,31.6,46,30,17,20,9,19,63,30.2,44,31,1,30,10,56,12,1
Marcus Thuram,FRA,FW,26,Inter,Serie A,29.9,23,15,9,9,5,4,13,30.8,9,26,3,23,4,27,19,0
Hakan Çalhanoğlu,TUR,MF,30,Inter,Serie A,28.4,66,33,29,29,8,32,49,65.3,17,29,13,16,24,90,22,0
Lautaro Martínez,ARG,FW,26,Inter,Serie A,29.5,22,16,4,13,5,4,19,21.1,15,30,1,29,20,42,10,0
Federico Dimarco,ITA,DF,26,Inter,Serie A,23.1,42,25,19,14,9,17,35,48.6,18,18,3,15,9,51,34,1
Alessandro Bastoni,ITA,DF,25,Inter,Serie A,25.2,46,33,31,12,3,26,40,65.0,14,25,11,14,23,69,48,1
Matteo Darmian,ITA,DF,34,Inter,Serie A,26.7,48,22,23,15,10,20,53,37.7,33,27,11,16,13,61,55,0
Francesco Acerbi,ITA,DF,36,Inter,Serie A,26.5,22,13,16,6,0,11,14,78.6,3,20,13,7,32,54,77,1
Benjamin Pavard,FRA,DF,28,Inter,Serie A,18.6,34,21,21,11,2,20,24,83.3,4,25,15,10,32,66,44,1
Denzel Dumfries,NED,DF,28,Inter,Serie A,18.2,22,13,9,11,2,9,23,39.1,14,15,6,9,12,34,33,1
Stefan de Vrij,NED,DF,32,Inter,Serie A,17.6,18,13,13,4,1,8,15,53.3,7,22,10,12,24,42,51,0
Carlos Augusto,BRA,DF,25,Inter,Serie A,19.2,29,21,20,9,0,15,22,68.2,7,20,8,12,16,45,52,0
Yann Aurel Bisseck,GER,DF,23,Inter,Serie A,10.0,14,6,10,3,1,6,9,66.7,3,10,7,3,5,19,23,0
Davide Frattesi,ITA,MF,24,Inter,Serie A,10.6,10,6,3,7,0,4,8,50.0,4,9,3,6,5,15,19,0
Kristjan Asllani,ALB,MF,22,Inter,Serie A,8.7,7,2,3,4,0,2,11,18.2,9,9,3,6,11,18,8,0
Alexis Sánchez,CHI,FW,35,Inter,Serie A,8.5,7,6,0,5,2,1,4,25.0,3,4,1,3,1,8,3,0
Marko Arnautović,AUT,FW,35,Inter,Serie A,8.9,10,4,3,5,2,4,7,57.1,3,8,1,7,5,15,5,0
Emil Audero,ITA,GK,27,Inter,Serie A,3.7,0,0,0,0,0,0,0,0.0,0,0,0,0,0,0,1,0
Davy Klaassen,NED,MF,31,Inter,Serie A,2.3,4,2,0,4,0,1,3,33.3,2,5,1,4,3,7,4,0
Juan Cuadrado,COL,DF,36,Inter,Serie A,3.0,4,3,2,2,0,3,5,60.0,2,6,1,5,1,5,2,0
Tajon Buchanan,CAN,DF,25,Inter,Serie A,1.8,1,1,0,0,1,1,2,50.0,1,1,0,1,0,1,4,0
Stefano Sensi,ITA,MF,28,Inter,Serie A,0.5,1,1,0,1,0,1,3,33.3,2,1,0,1,1,2,0,0
Raffaele Di Gennaro,ITA,GK,30,Inter,Serie A,0.3,0,0,0,0,0,0,0,0.0,0,0,0,0,0,0,0,0
Ebenezer Akinsanmiro,NGA,MF,19,Inter,Serie A,0.2,0,0,0,0,0,0,1,0.0,1,0,0,0,0,0,0,0
Lucien Agoume,FRA,MF,22,Inter,Serie A,0.1,0,0,0,0,0,0,0,0.0,0,0,0,0,0,0,0,0
Tijjani Reijnders,NED,MF,25,Milan,Serie A,31.3,46,25,10,31,5,21,43,48.8,22,26,8,18,18,64,26,0
Christian Pulisic,USA,"FW,MF",25,Milan,Serie A,28.9,35,26,14,11,10,17,30,56.7,13,20,1,19,10,45,10,1
Theo Hernández,FRA,DF,26,Milan,Serie A,31.0,30,17,19,11,0,11,22,50.0,11,33,13,20,23,53,42,1
Mike Maignan,FRA,GK,28,Milan,Serie A,29.0,1,0,1,0,0,1,1,100.0,0,1,0,1,1,2,4,3
Rafael Leão,POR,FW,24,Milan,Serie A,27.9,16,10,3,8,5,8,13,61.5,5,15,1,14,9,25,19,0
Olivier Giroud,FRA,FW,37,Milan,Serie A,26.3,17,11,6,6,5,2,14,14.3,12,14,3,11,6,23,22,0
Davide Calabria,ITA,DF,27,Milan,Serie A,24.3,70,38,38,25,7,44,72,61.1,28,26,7,19,24,94,49,1
Ruben Loftus-Cheek,ENG,MF,28,Milan,Serie A,23.0,28,18,7,14,7,15,27,55.6,12,24,12,12,9,37,10,1
Fikayo Tomori,ENG,DF,26,Milan,Serie A,23.6,42,24,29,10,3,18,29,62.1,11,34,23,11,26,68,75,1
Alessandro Florenzi,ITA,DF,33,Milan,Serie A,19.2,43,21,26,12,5,26,48,54.2,22,16,9,7,20,63,25,1
Malick Thiaw,GER,DF,22,Milan,Serie A,18.0,34,17,15,17,2,12,25,48.0,13,23,13,10,13,47,55,0
Yacine Adli,FRA,MF,23,Milan,Serie A,15.6,34,17,17,13,4,13,35,37.1,22,22,8,14,20,54,15,1
Matteo Gabbia,ITA,DF,24,Milan,Serie A,14.2,29,20,15,13,1,18,24,75.0,6,11,6,5,10,39,48,0
Simon Kjær,DEN,DF,35,Milan,Serie A,13.0,24,15,11,11,2,14,22,63.6,8,22,16,6,14,38,46,2
Yunus Musah,USA,"MF,FW",21,Milan,Serie A,16.4,25,14,15,6,4,8,15,53.3,7,18,4,14,10,35,16,1
Ismaël Bennacer,ALG,MF,26,Milan,Serie A,12.8,29,19,11,16,2,11,22,50.0,11,12,4,8,12,41,9,2
Samuel Chukwueze,NGA,FW,25,Milan,Serie A,11.3,18,7,11,5,2,9,17,52.9,8,3,1,2,6,24,3,0
Luka Jović,SRB,FW,26,Milan,Serie A,9.7,6,4,0,3,3,4,6,66.7,2,3,0,3,1,7,9,0
Rade Krunić,BIH,MF,30,Milan,Serie A,7.6,10,8,3,6,1,4,9,44.4,5,7,3,4,11,21,14,0
Marco Sportiello,ITA,GK,32,Milan,Serie A,7.0,0,0,0,0,0,0,0,0.0,0,0,0,0,0,0,2,0
Noah Okafor,SUI,"FW,MF",24,Milan,Serie A,9.9,6,4,1,4,1,3,10,30.0,7,8,1,7,0,6,10,0
Pierre Kalulu,FRA,DF,23,Milan,Serie A,4.2,5,1,2,3,0,1,2,50.0,1,4,3,1,1,6,12,1
Tommaso Pobega,ITA,MF,24,Milan,Serie A,3.5,16,9,11,5,0,6,13,46.2,7,10,2,8,6,22,7,0
Antonio Mirante,ITA,GK,40,Milan,Serie A,2.0,0,0,0,0,0,0,0,0.0,0,0,0,0,0,0,1,0
Filippo Terracciano,ITA,"DF,FW",21,Milan,Serie A,0.8,2,2,1,1,0,1,3,33.3,2,3,0,3,0,2,1,0
Jan-Carlo Simic,SRB,DF,19,Milan,Serie A,1.6,1,1,1,0,0,0,0,0.0,0,5,4,1,0,1,3,0
Luka Romero,ARG,"FW,MF",19,Milan,Serie A,1.0,0,0,0,0,0,0,3,0.0,3,2,0,2,0,0,0,0
Davide Bartesaghi,ITA,"DF,MF",18,Milan,Serie A,0.9,2,0,1,1,0,2,4,50.0,2,1,1,0,0,2,7,0
Alejandro Jiménez,ESP,DF,19,Milan,Serie A,0.8,2,1,2,0,0,2,5,40.0,3,0,0,0,0,2,4,0
Marco Pellegrino,ARG,DF,21,Milan,Serie A,0.8,1,1,0,0,1,0,2,0.0,2,1,1,0,1,2,2,0
Mattia Caldara,ITA,DF,30,Milan,Serie A,0.4,1,1,1,0,0,1,1,100.0,0,1,1,0,1,2,1,0
Kevin Zeroli,ITA,MF,19,Milan,Serie A,0.3,1,1,1,0,0,0,0,0.0,0,1,0,1,0,1,1,0
Chaka Traorè,CIV,FW,19,Milan,Serie A,0.2,2,1,2,0,0,1,2,50.0,1,1,1,0,0,2,0,0
Francesco Camarda,ITA,FW,16,Milan,Serie A,0.2,0,0,0,0,0,0,2,0.0,2,0,0,0,0,0,0,0
Lapo Nava,ITA,GK,20,Milan,Serie A,0.0,0,0,0,0,0,0,0,0.0,0,0,0,0,0,0,0,0
Gleison Bremer,BRA,DF,27,Juventus,Serie A,35.9,58,42,32,21,5,21,29,72.4,8,45,27,18,40,98,147,0
Wojciech Szczęsny,POL,GK,34,Juventus,Serie A,35.0,0,0,0,0,0,0,0,0.0,0,0,0,0,1,1,11,2
Manuel Locatelli,ITA,MF,26,Juventus,Serie A,33.4,69,43,24,35,10,31,58,53.4,27,43,17,26,25,94,65,0
Adrien Rabiot,FRA,MF,29,Juventus,Serie A,29.5,58,39,22,30,6,30,45,66.7,15,26,6,20,25,83,34,0
Federico Gatti,ITA,DF,25,Juventus,Serie A,29.3,33,19,16,16,1,19,24,79.2,5,26,15,11,19,52,90,1
Weston McKennie,USA,"MF,DF",25,Juventus,Serie A,28.8,48,29,31,11,6,17,27,63.0,10,28,7,21,18,66,69,0
Andrea Cambiaso,ITA,"DF,FW",24,Juventus,Serie A,26.4,47,30,23,15,9,25,43,58.1,18,28,3,25,11,58,26,1
Danilo,BRA,DF,32,Juventus,Serie A,27.2,60,36,38,18,4,32,48,66.7,16,34,15,19,37,97,94,0
Dušan Vlahović,SRB,FW,24,Juventus,Serie A,25.6,9,5,0,6,3,4,11,36.4,7,4,2,2,1,10,11,0
Filip Kostić,SRB,DF,31,Juventus,Serie A,20.2,37,23,20,13,4,17,33,51.5,16,29,8,21,9,46,43,0
Federico Chiesa,ITA,FW,26,Juventus,Serie A,24.4,20,10,7,6,7,3,13,23.1,10,17,1,16,6,26,4,0
Fabio Miretti,ITA,MF,20,Juventus,Serie A,12.3,18,14,6,8,4,10,26,38.5,16,10,1,9,7,25,6,0
Daniele Rugani,ITA,DF,29,Juventus,Serie A,13.2,11,9,7,3,1,4,5,80.0,1,11,4,7,9,20,42,0
Timothy Weah,USA,"DF,FW",24,Juventus,Serie A,14.0,27,20,16,8,3,15,20,75.0,5,12,1,11,5,32,15,0
Kenan Yıldız,TUR,"FW,DF",19,Juventus,Serie A,10.6,13,9,5,6,2,4,8,50.0,4,6,0,6,1,14,4,0
Alex Sandro,BRA,DF,33,Juventus,Serie A,8.0,13,7,7,6,0,4,5,80.0,1,13,7,6,15,28,23,0
Moise Kean,ITA,FW,24,Juventus,Serie A,7.3,7,4,3,2,2,1,3,33.3,2,4,1,3,2,9,5,0
Arkadiusz Milik,POL,FW,30,Juventus,Serie A,10.2,9,5,2,5,2,3,5,60.0,2,7,1,6,5,14,3,0
Samuel Iling-Junior,ENG,"DF,MF",20,Juventus,Serie A,9.0,23,13,9,11,3,11,18,61.1,7,17,5,12,6,29,19,0
Nicolò Fagioli,ITA,MF,23,Juventus,Serie A,4.9,5,3,1,3,1,3,7,42.9,4,3,0,3,4,9,1,0
Carlos Alcaraz,ARG,MF,21,Juventus,Serie A,4.2,6,6,0,6,0,5,10,50.0,5,5,2,3,5,11,4,0
Hans Nicolussi Caviglia,ITA,MF,23,Juventus,Serie A,3.0,5,2,1,3,1,4,6,66.7,2,5,1,4,0,5,2,0
Mattia Perin,ITA,GK,31,Juventus,Serie A,2.5,0,0,0,0,0,0,0,0.0,0,0,0,0,0,0,1,0
Mattia De Sciglio,ITA,DF,31,Juventus,Serie A,0.5,0,0,0,0,0,0,0,0.0,0,1,0,1,1,1,2,0
Paul Pogba,FRA,MF,31,Juventus,Serie A,0.6,1,1,0,1,0,1,1,100.0,0,0,0,0,1,2,1,0
Carlo Pinsoglio,ITA,GK,34,Juventus,Serie A,0.5,0,0,0,0,0,0,0,0.0,0,0,0,0,0,0,0,0
Joseph Nonge,BEL,MF,19,Juventus,Serie A,0.3,0,0,0,0,0,0,0,0.0,0,0,0,0,0,0,1,0
Tiago Djaló,POR,DF,24,Juventus,Serie A,0.2,0,0,0,0,0,0,0,0.0,0,1,0,1,0,0,1,0
Dean Huijsen,ESP,DF,19,Juventus,Serie A,0.1,0,0,0,0,0,0,0,0.0,0,0,0,0,0,0,1,0
Nikola Sekulov,ITA,FW,22,Juventus,Serie A,0.1,0,0,0,0,0,0,0,0.0,0,0,0,0,0,0,0,0
Leonardo Cerri,ITA,DF,21,Juventus,Serie A,0.1,0,0,0,0,0,0,0,0.0,0,0,0,0,0,0,0,0
Berat Djimsiti,ALB,DF,31,Atalanta,Serie A,31.3,42,24,29,12,1,19,31,61.3,12,53,33,20,57,99,99,0
Ederson,BRA,MF,24,Atalanta,Serie A,30.9,80,46,37,36,7,43,62,69.4,19,47,8,39,40,120,33,1
Giorgio Scalvini,ITA,DF,20,Atalanta,Serie A,27.3,52,32,29,18,5,19,39,48.7,20,43,17,26,57,109,70,0
Marten de Roon,NED,"MF,DF",33,Atalanta,Serie A,28.9,80,43,36,32,12,35,82,42.7,47,36,10,26,40,120,54,0
Teun Koopmeiners,NED,MF,26,Atalanta,Serie A,28.2,39,24,12,22,5,17,50,34.0,33,33,3,30,10,49,34,0
Matteo Ruggeri,ITA,DF,21,Atalanta,Serie A,26.2,27,14,13,7,7,14,28,50.0,14,42,3,39,22,49,42,0
Marco Carnesecchi,ITA,GK,23,Atalanta,Serie A,25.9,0,0,0,0,0,0,0,0.0,0,0,0,0,0,0,20,3
Sead Kolašinac,BIH,DF,30,Atalanta,Serie A,24.2,44,32,23,19,2,30,49,61.2,19,22,9,13,21,65,47,0
Charles De Ketelaere,BEL,"FW,MF",23,Atalanta,Serie A,21.7,31,20,3,12,16,8,18,44.4,10,29,2,27,7,38,6,0
Davide Zappacosta,ITA,DF,31,Atalanta,Serie A,20.7,30,20,15,10,5,16,34,47.1,18,29,4,25,5,35,19,0
Mario Pašalić,CRO,"MF,FW",29,Atalanta,Serie A,21.8,28,17,9,18,1,14,31,45.2,17,28,6,22,16,44,34,0
Ademola Lookman,NGA,"FW,MF",26,Atalanta,Serie A,20.4,18,13,2,9,7,8,22,36.4,14,18,0,18,9,27,0,1
Gianluca Scamacca,ITA,FW,25,Atalanta,Serie A,15.8,15,9,4,5,6,7,14,50.0,7,7,1,6,4,19,8,0
Aleksei Miranchuk,RUS,"MF,FW",28,Atalanta,Serie A,12.7,12,6,6,4,2,5,13,38.5,8,6,1,5,2,14,5,1
Juan Musso,ARG,GK,30,Atalanta,Serie A,11.0,1,0,1,0,0,1,1,100.0,0,0,0,0,0,1,6,0
Emil Holm,SWE,DF,24,Atalanta,Serie A,9.9,26,17,17,7,2,15,35,42.9,20,24,3,21,7,33,25,0
Hans Hateboer,NED,DF,30,Atalanta,Serie A,12.3,12,5,8,2,2,5,15,33.3,10,21,7,14,4,16,21,0
Rafael Tolói,ITA,DF,33,Atalanta,Serie A,9.9,19,8,6,8,5,13,26,50.0,13,8,4,4,13,32,27,0
Isak Hien,SWE,DF,25,Atalanta,Serie A,9.4,18,12,8,10,0,7,14,50.0,7,11,5,6,11,29,29,0
Mitchel Bakker,NED,DF,23,Atalanta,Serie A,4.2,7,3,6,1,0,2,12,16.7,10,5,0,5,3,10,6,0
El Bilal Touré,MLI,FW,22,Atalanta,Serie A,4.2,1,1,0,1,0,0,1,0.0,1,0,0,0,1,2,2,0
Luis Muriel,COL,"FW,MF",33,Atalanta,Serie A,4.5,3,2,0,2,1,1,1,100.0,0,4,0,4,1,4,0,0
Duván Zapata,COL,FW,33,Atalanta,Serie A,1.2,0,0,0,0,0,0,1,0.0,1,0,0,0,0,0,1,0
Giovanni Bonfanti,ITA,DF,21,Atalanta,Serie A,1.0,4,2,2,2,0,2,3,66.7,1,1,1,0,1,5,1,0
Nadir Zortea,ITA,DF,24,Atalanta,Serie A,1.7,5,4,3,1,1,1,4,25.0,3,2,0,2,1,6,3,0
Michel Ndary Adopo,FRA,MF,23,Atalanta,Serie A,1.2,4,3,0,3,1,1,1,100.0,0,0,0,0,0,4,2,1
José Luis Palomino,ARG,DF,34,Atalanta,Serie A,0.3,2,1,1,1,0,1,1,100.0,0,2,1,1,1,3,6,0
Francesco Rossi,ITA,GK,33,Atalanta,Serie A,0.1,0,0,0,0,0,0,0,0.0,0,0,0,0,0,0,0,0
Leonardo Mendicino,ITA,MF,17,Atalanta,Serie A,0.0,0,0,0,0,0,0,0,0.0,0,0,0,0,0,0,0,0
Lukasz Skorupski,POL,GK,33,Bologna,Serie A,32.0,2,2,2,0,0,2,3,66.7,1,0,0,0,1,3,11,3
Joshua Zirkzee,NED,FW,23,Bologna,Serie A,30.7,32,20,8,15,9,13,24,54.2,11,25,2,23,3,35,36,0
Lewis Ferguson,SCO,MF,24,Bologna,Serie A,30.1,37,21,16,17,4,16,37,43.2,21,25,8,17,17,54,27,1
Remo Freuler,SUI,MF,32,Bologna,Serie A,29.2,78,50,41,32,5,38,69,55.1,31,37,9,28,36,114,53,2
Sam Beukema,NED,DF,25,Bologna,Serie A,28.3,27,11,14,11,2,16,25,64.0,9,35,21,14,15,42,99,2
Stefan Posch,AUT,DF,27,Bologna,Serie A,26.8,77,46,35,38,4,49,88,55.7,39,27,8,19,18,95,72,0
Riccardo Calafiori,ITA,DF,22,Bologna,Serie A,26.1,47,32,28,16,3,22,32,68.8,10,38,13,25,50,97,74,3
Victor Bernth Kristiansen,DEN,DF,21,Bologna,Serie A,25.6,52,34,23,22,7,20,35,57.1,15,35,8,27,12,64,45,1
Michel Aebischer,SUI,MF,27,Bologna,Serie A,24.8,35,20,9,20,6,15,34,44.1,19,28,6,22,12,47,22,0
Jhon Lucumí,COL,DF,25,Bologna,Serie A,24.6,48,29,31,17,0,27,36,75.0,9,32,17,15,16,64,68,2
Alexis Saelemaekers,BEL,"FW,MF",24,Bologna,Serie A,21.0,32,22,13,14,5,12,27,44.4,15,13,1,12,13,45,10,1
Dan Ndoye,SUI,"FW,MF",23,Bologna,Serie A,19.7,30,15,17,11,2,17,39,43.6,22,20,1,19,10,40,14,0
Riccardo Orsolini,ITA,"FW,MF",27,Bologna,Serie A,19.9,23,14,13,4,6,9,30,30.0,21,25,3,22,8,31,19,1
Giovanni Fabbian,ITA,"MF,FW",21,Bologna,Serie A,11.7,17,10,9,7,1,7,12,58.3,5,5,2,3,7,24,11,0
Charalambos Lykogiannis,GRE,DF,30,Bologna,Serie A,10.0,10,6,5,4,1,5,10,50.0,5,15,5,10,5,15,30,0
Nikola Moro,CRO,MF,26,Bologna,Serie A,9.3,21,16,8,12,1,8,15,53.3,7,14,1,13,7,28,10,0
Kacper Urbanski,POL,"MF,FW",19,Bologna,Serie A,10.3,16,10,5,10,1,6,13,46.2,7,15,1,14,4,20,14,0
Lorenzo De Silvestri,ITA,DF,36,Bologna,Serie A,7.5,10,8,5,2,3,4,7,57.1,3,9,4,5,6,16,27,0
Federico Ravaglia,ITA,GK,24,Bologna,Serie A,5.9,0,0,0,0,0,0,0,0.0,0,0,0,0,0,0,2,0
Oussama El Azzouzi,MAR,MF,23,Bologna,Serie A,6.1,12,7,4,5,3,7,14,50.0,7,8,2,6,6,18,12,0
Jens Odgaard,DEN,"FW,MF",25,Bologna,Serie A,4.8,4,4,1,1,2,1,3,33.3,2,9,0,9,1,5,3,0
Jesper Karlsson,SWE,FW,25,Bologna,Serie A,3.8,3,3,2,1,0,2,8,25.0,6,4,0,4,4,7,1,0
Santiago Castro,ARG,FW,19,Bologna,Serie A,2.7,2,1,0,1,1,1,3,33.3,2,1,0,1,1,3,1,0
Sydney van Hooijdonk,NED,FW,24,Bologna,Serie A,2.4,3,0,0,2,1,1,2,50.0,1,1,1,0,1,4,4,0
Tommaso Corazza,ITA,DF,19,Bologna,Serie A,2.2,10,4,9,1,0,4,9,44.4,5,2,0,2,5,15,3,0
Nicolás Domínguez,ARG,MF,25,Bologna,Serie A,1.1,1,0,1,0,0,0,2,0.0,2,3,0,3,0,1,2,0
Kevin Bonifazi,ITA,DF,28,Bologna,Serie A,1.0,4,0,0,4,0,1,2,50.0,1,0,0,0,0,4,7,1
Nicola Bagnolini,ITA,GK,20,Bologna,Serie A,0.1,0,0,0,0,0,0,0,0.0,0,0,0,0,0,0,0,0
Bryan Cristante,ITA,"MF,DF",29,Roma,Serie A,36.5,72,41,33,28,11,28,50,56.0,22,36,6,30,25,97,55,2
Gianluca Mancini,ITA,DF,28,Roma,Serie A,31.9,34,20,21,11,2,11,27,40.7,16,38,26,12,36,70,77,1
Leandro Paredes,ARG,MF,29,Roma,Serie A,29.3,57,36,30,22,5,33,77,42.9,44,26,7,19,29,86,43,1
Romelu Lukaku,BEL,FW,31,Roma,Serie A,29.3,6,5,1,2,3,2,4,50.0,2,7,1,6,0,6,19,1
Diego Llorente,ESP,DF,30,Roma,Serie A,24.1,31,19,20,10,1,11,24,45.8,13,40,27,13,22,53,79,0
Obite N'Dicka,CIV,DF,24,Roma,Serie A,24.1,32,18,12,19,1,12,20,60.0,8,30,16,14,16,48,75,0
Paulo Dybala,ARG,"FW,MF",30,Roma,Serie A,21.8,22,13,3,10,9,2,18,11.1,16,12,0,12,3,25,6,1
Rui Patrício,POR,GK,36,Roma,Serie A,23.0,0,0,0,0,0,0,1,0.0,1,1,0,1,0,0,3,1
Lorenzo Pellegrini,ITA,MF,27,Roma,Serie A,20.7,35,20,14,16,5,17,51,33.3,34,28,5,23,20,55,22,0
Rasmus Kristensen,DEN,DF,26,Roma,Serie A,19.4,36,19,25,8,3,28,50,56.0,22,27,7,20,8,44,50,0
Stephan El Shaarawy,ITA,"FW,DF",31,Roma,Serie A,19.3,21,13,14,4,3,6,15,40.0,9,11,4,7,13,34,15,2
Edoardo Bove,ITA,MF,22,Roma,Serie A,19.8,60,31,16,31,13,27,46,58.7,19,21,1,20,11,71,11,1
Mile Svilar,SRB,GK,24,Roma,Serie A,15.0,0,0,0,0,0,0,0,0.0,0,0,0,0,0,0,2,1
Leonardo Spinazzola,ITA,DF,31,Roma,Serie A,14.6,15,7,10,5,0,8,18,44.4,10,8,2,6,3,18,15,0
Rick Karsdorp,NED,DF,29,Roma,Serie A,13.2,25,18,11,8,6,16,24,66.7,8,13,4,9,9,34,16,0
Angeliño,ESP,DF,27,Roma,Serie A,12.7,21,11,12,6,3,11,19,57.9,8,11,5,6,12,33,37,1
Nicola Zalewski,POL,"DF,FW",22,Roma,Serie A,10.8,20,14,10,9,1,8,22,36.4,14,12,4,8,9,29,17,0
Houssem Aouar,ALG,"MF,FW",25,Roma,Serie A,8.4,16,11,4,10,2,3,12,25.0,9,5,0,5,4,20,2,1
Andrea Belotti,ITA,FW,30,Roma,Serie A,7.5,8,4,2,3,3,3,6,50.0,3,7,0,7,2,10,3,0
Zeki Çelik,TUR,DF,27,Roma,Serie A,7.5,23,16,10,10,3,14,25,56.0,11,12,5,7,8,31,25,0
Tommaso Baldanzi,ITA,"FW,MF",21,Roma,Serie A,5.8,9,5,3,4,2,1,1,100.0,0,2,0,2,0,9,4,0
Dean Huijsen,ESP,DF,19,Roma,Serie A,5.7,10,5,5,5,0,1,4,25.0,3,7,4,3,4,14,26,2
Chris Smalling,ENG,DF,34,Roma,Serie A,4.3,1,1,1,0,0,1,4,25.0,3,6,5,1,5,6,8,0
Sardar Azmoun,IRN,"FW,MF",29,Roma,Serie A,6.5,8,5,2,5,1,4,8,50.0,4,4,1,3,3,11,6,1
Tammy Abraham,ENG,FW,26,Roma,Serie A,2.7,3,1,0,1,2,0,0,0.0,0,1,0,1,0,3,4,0
Renato Sanches,POR,MF,26,Roma,Serie A,1.6,2,1,1,1,0,2,3,66.7,1,2,0,2,0,2,1,0
Riccardo Pagano,ITA,"MF,DF",19,Roma,Serie A,0.6,2,2,1,1,0,0,6,0.0,6,3,2,1,0,2,2,0
Ola Solbakken,NOR,FW,25,Roma,Serie A,0.3,0,0,0,0,0,0,0,0.0,0,0,0,0,0,0,0,0
João Costa,BRA,"MF,FW",19,Roma,Serie A,0.2,0,0,0,0,0,0,0,0.0,0,0,0,0,0,0,0,0
Niccolò Pisilli,ITA,MF,19,Roma,Serie A,0.1,0,0,0,0,0,0,0,0.0,0,0,0,0,0,0,0,0
Adam Marušić,MNE,DF,31,Lazio,Serie A,34.4,45,31,24,19,2,27,49,55.1,22,27,7,20,29,74,63,2
Felipe Anderson,BRA,"FW,MF",31,Lazio,Serie A,30.8,78,45,32,33,13,34,90,37.8,56,45,3,42,27,105,23,0
Ivan Provedel,ITA,GK,30,Lazio,Serie A,30.0,1,0,1,0,0,1,3,33.3,2,0,0,0,0,1,12,1
Luis Alberto,ESP,MF,31,Lazio,Serie A,25.7,35,20,16,12,7,15,53,28.3,38,34,4,30,7,42,13,0
Mattéo Guendouzi,FRA,MF,25,Lazio,Serie A,26.3,34,15,11,18,5,21,49,42.9,28,24,6,18,21,55,24,1
Alessio Romagnoli,ITA,DF,29,Lazio,Serie A,26.8,25,18,14,11,0,16,24,66.7,8,29,17,12,29,54,115,0
Mattia Zaccagni,ITA,"FW,MF",28,Lazio,Serie A,21.7,27,16,11,15,1,9,21,42.9,12,26,2,24,21,48,15,0
Mario Gila,ESP,DF,23,Lazio,Serie A,20.1,32,14,23,8,1,19,34,55.9,15,27,14,13,20,52,69,0
Ciro Immobile,ITA,FW,34,Lazio,Serie A,18.4,11,9,2,5,4,3,14,21.4,11,9,3,6,5,16,11,0
Manuel Lazzari,ITA,DF,30,Lazio,Serie A,18.6,26,18,13,10,3,18,28,64.3,10,20,4,16,12,38,37,1
Patric,ESP,DF,31,Lazio,Serie A,17.9,13,8,10,3,0,8,18,44.4,10,15,9,6,6,19,44,0
Daichi Kamada,JPN,MF,27,Lazio,Serie A,17.2,53,36,22,22,9,28,52,53.8,24,24,5,19,18,71,7,0
Valentín Castellanos,ARG,FW,25,Lazio,Serie A,18.7,22,10,1,12,9,6,20,30.0,14,22,2,20,2,24,18,0
Nicolò Casale,ITA,DF,26,Lazio,Serie A,17.3,15,9,13,2,0,6,15,40.0,9,19,16,3,12,27,61,0
Nicolò Rovella,ITA,MF,22,Lazio,Serie A,14.6,46,28,25,17,4,16,36,44.4,20,27,6,21,23,69,29,0
Danilo Cataldi,ITA,MF,29,Lazio,Serie A,15.1,24,12,7,16,1,8,18,44.4,10,15,7,8,17,41,19,1
Gustav Isaksen,DEN,FW,23,Lazio,Serie A,11.9,4,3,2,1,1,1,9,11.1,8,11,1,10,4,8,4,0
Elseid Hysaj,ALB,DF,30,Lazio,Serie A,13.3,24,14,8,13,3,15,24,62.5,9,16,6,10,17,41,31,0
Matías Vecino,URU,MF,32,Lazio,Serie A,12.8,32,17,12,20,0,20,31,64.5,11,17,5,12,12,44,21,0
Luca Pellegrini,ITA,DF,25,Lazio,Serie A,8.7,18,13,7,10,1,9,17,52.9,8,7,3,4,9,27,20,0
Christos Mandas,GRE,GK,22,Lazio,Serie A,8.0,0,0,0,0,0,0,1,0.0,1,0,0,0,1,1,3,1
Pedro,ESP,"FW,MF",36,Lazio,Serie A,9.1,16,12,5,7,4,3,12,25.0,9,16,2,14,3,19,1,0
Pietro Terracciano,ITA,GK,34,Fiorentina,Serie A,33.0,1,1,1,0,0,1,3,33.3,2,1,0,1,0,1,8,0
Nikola Milenković,SRB,DF,26,Fiorentina,Serie A,27.9,41,21,24,14,3,22,36,61.1,14,22,14,8,27,68,95,1
Giacomo Bonaventura,ITA,MF,34,Fiorentina,Serie A,25.3,26,13,6,10,10,9,21,42.9,12,16,1,15,14,40,10,0
Cristiano Biraghi,ITA,DF,31,Fiorentina,Serie A,25.2,46,28,20,23,3,28,50,56.0,22,28,4,24,14,60,39,0
Lucas Martínez Quarta,ARG,DF,28,Fiorentina,Serie A,24.5,68,45,38,26,4,34,48,70.8,14,37,14,23,28,96,65,4
Arthur Melo,BRA,MF,27,Fiorentina,Serie A,22.1,45,30,17,24,4,26,42,61.9,16,27,3,24,18,63,8,0
Alfred Duncan,GHA,MF,31,Fiorentina,Serie A,20.1,34,21,12,15,7,15,33,45.5,18,26,5,21,10,44,12,0
Luca Ranieri,ITA,DF,25,Fiorentina,Serie A,21.9,12,9,9,1,2,8,13,61.5,5,24,11,13,28,40,63,0
Michael Kayode,ITA,DF,19,Fiorentina,Serie A,21.9,50,29,24,15,11,32,45,71.1,13,24,12,12,17,67,45,2
Nicolás González,ARG,FW,26,Fiorentina,Serie A,20.3,28,18,15,8,5,8,26,30.8,18,22,1,21,12,40,7,0
Lucas Beltrán,ARG,"FW,MF",23,Fiorentina,Serie A,18.0,26,14,4,17,5,11,20,55.0,9,28,3,25,2,28,11,0
Jonathan Ikone,FRA,FW,26,Fiorentina,Serie A,18.5,22,11,7,9,6,10,17,58.8,7,12,0,12,2,24,8,0
Rolando Mandragora,ITA,MF,26,Fiorentina,Serie A,17.6,26,11,8,13,5,10,22,45.5,12,14,3,11,9,35,18,1
Fabiano Parisi,ITA,DF,23,Fiorentina,Serie A,16.2,30,15,11,12,7,15,26,57.7,11,21,5,16,17,47,26,0
M'Bala Nzola,ANG,FW,27,Fiorentina,Serie A,17.2,11,8,1,4,6,6,7,85.7,1,10,1,9,0,11,22,0
Riccardo Sottil,ITA,FW,24,Fiorentina,Serie A,12.3,10,5,5,1,4,3,8,37.5,5,12,0,12,2,12,2,0
Christian Kouamé,CIV,FW,26,Fiorentina,Serie A,11.8,10,2,6,4,0,4,8,50.0,4,16,0,16,2,12,10,0
Andrea Belotti,ITA,FW,30,Fiorentina,Serie A,9.5,7,3,1,4,2,4,9,44.4,5,8,1,7,1,8,3,0
Antonín Barák,CZE,"MF,FW",29,Fiorentina,Serie A,8.9,6,2,1,3,2,3,7,42.9,4,5,0,5,2,8,3,0
Josip Brekalo,CRO,FW,25,Fiorentina,Serie A,7.2,8,6,6,2,0,2,11,18.2,9,7,0,7,1,9,0,0
Dodô,BRA,DF,25,Fiorentina,Serie A,5.8,5,3,1,4,0,2,5,40.0,3,2,0,2,5,10,11,0
Maxime Lopez,FRA,MF,26,Fiorentina,Serie A,7.9,18,9,5,10,3,6,12,50.0,6,3,1,2,2,20,6,0
Davide Faraoni,ITA,DF,32,Fiorentina,Serie A,4.3,9,4,5,2,2,5,11,45.5,6,3,1,2,5,14,14,0
Oliver Christensen,DEN,GK,25,Fiorentina,Serie A,4.0,0,0,0,0,0,0,0,0.0,0,0,0,0,0,0,1,0
Gaetano Castrovilli,ITA,"FW,MF",27,Fiorentina,Serie A,3.4,1,0,0,1,0,1,6,16.7,5,2,0,2,2,3,2,0
Gino Infantino,ARG,MF,21,Fiorentina,Serie A,0.9,1,1,0,1,0,0,1,0.0,1,3,0,3,1,2,1,0
Yerry Mina,COL,"DF,MF",29,Fiorentina,Serie A,0.5,1,1,1,0,0,1,2,50.0,1,0,0,0,0,1,2,0
Pietro Comuzzo,ITA,"DF,FW",19,Fiorentina,Serie A,0.5,1,1,1,0,0,1,1,100.0,0,1,0,1,1,2,2,0
Lorenzo Amatucci,ITA,MF,20,Fiorentina,Serie A,0.2,0,0,0,0,0,0,0,0.0,0,0,0,0,0,0,0,0
Vanja Milinković-Savić,SRB,GK,27,Torino,Serie A,36.0,1,0,1,0,0,1,1,100.0,0,0,0,0,1,2,14,4
Raoul Bellanova,ITA,DF,24,Torino,Serie A,33.8,36,26,15,17,4,18,31,58.1,13,21,4,17,15,51,36,3
Duván Zapata,COL,FW,33,Torino,Serie A,32.0,18,7,9,2,7,3,12,25.0,9,20,6,14,7,25,26,0
Ricardo Rodríguez,SUI,DF,31,Torino,Serie A,30.8,45,26,21,22,2,28,45,62.2,17,22,9,13,24,69,64,2
Nikola Vlašić,CRO,"MF,FW",26,Torino,Serie A,29.0,28,16,6,14,8,4,30,13.3,26,26,7,19,11,39,16,0
Alessandro Buongiorno,ITA,DF,24,Torino,Serie A,28.1,70,39,43,24,3,24,34,70.6,10,20,12,8,69,139,131,0
Samuele Ricci,ITA,MF,22,Torino,Serie A,26.6,33,18,17,12,4,15,23,65.2,8,21,3,18,27,60,25,0
Adrien Tameze,CMR,"DF,MF",30,Torino,Serie A,23.8,35,16,13,18,4,18,37,48.6,19,24,11,13,47,82,25,2
Ivan Ilić,SRB,MF,23,Torino,Serie A,23.3,22,8,9,10,3,13,27,48.1,14,20,7,13,20,42,31,0
Antonio Sanabria,PAR,"FW,MF",28,Torino,Serie A,23.7,18,15,5,9,4,4,9,44.4,5,7,1,6,6,24,12,0
Valentino Lazaro,AUT,"DF,MF",28,Torino,Serie A,22.2,18,11,7,9,2,13,19,68.4,6,14,1,13,8,26,29,0
Karol Linetty,POL,MF,29,Torino,Serie A,20.6,30,21,9,20,1,9,29,31.0,20,24,8,16,23,53,27,1
Mërgim Vojvoda,KVX,DF,29,Torino,Serie A,15.3,17,8,7,6,4,11,16,68.8,5,12,2,10,13,30,28,0
Adam Masina,MAR,DF,30,Torino,Serie A,11.4,17,12,8,8,1,5,20,25.0,15,12,6,6,11,28,30,0
Perr Schuurs,NED,DF,24,Torino,Serie A,8.6,20,12,11,8,1,3,9,33.3,6,10,2,8,9,29,23,0
Koffi Djidji,CIV,DF,31,Torino,Serie A,8.4,14,9,9,5,0,3,4,75.0,1,10,5,5,10,24,20,0
Pietro Pellegri,ITA,FW,23,Torino,Serie A,8.4,5,1,1,4,0,1,5,20.0,4,4,1,3,2,7,3,0
Matteo Lovato,ITA,DF,24,Torino,Serie A,6.0,10,7,5,5,0,4,5,80.0,1,9,5,4,13,23,10,0
Demba Seck,SEN,MF,23,Torino,Serie A,4.7,5,3,1,4,0,3,4,75.0,1,1,0,1,1,6,0,0
Gvidas Gineitis,LTU,MF,20,Torino,Serie A,6.0,11,7,3,8,0,4,7,57.1,3,10,4,6,4,15,9,1
Nemanja Radonjić,SRB,"MF,FW",28,Torino,Serie A,4.2,1,1,0,0,1,1,3,33.3,2,3,0,3,0,1,0,0
David Okereke,NGA,"FW,MF",26,Torino,Serie A,2.8,3,1,1,1,1,0,3,0.0,3,2,0,2,1,4,0,0
Saba Sazonov,GEO,DF,22,Torino,Serie A,4.0,9,7,4,5,0,3,3,100.0,0,8,5,3,3,12,22,0
Luca Gemello,ITA,GK,23,Torino,Serie A,2.0,0,0,0,0,0,0,1,0.0,1,0,0,0,0,0,1,1
Brandon Soppy,FRA,DF,22,Torino,Serie A,2.0,2,2,1,1,0,2,6,33.3,4,2,0,2,0,2,3,1
Yann Karamoh,FRA,"MF,FW",25,Torino,Serie A,1.8,1,0,0,0,1,0,0,0.0,0,0,0,0,0,1,1,0
David Zima,CZE,DF,23,Torino,Serie A,1.0,1,1,1,0,0,0,0,0.0,0,0,0,0,3,4,7,0
Zanos Savva,CYP,"DF,MF",18,Torino,Serie A,0.3,1,1,0,1,0,1,3,33.3,2,0,0,0,0,1,1,0
Alessandro Dellavalle,ITA,DF,20,Torino,Serie A,0.2,0,0,0,0,0,0,0,0.0,0,1,1,0,1,1,0,0
Simone Verdi,ITA,FW,31,Torino,Serie A,0.0,0,0,0,0,0,0,0,0.0,0,0,0,0,0,0,0,0
Stanislav Lobotka,SVK,MF,29,Napoli,Serie A,36.5,61,39,18,30,13,24,60,40.0,36,30,8,22,30,91,29,0
Giovanni Di Lorenzo,ITA,DF,30,Napoli,Serie A,35.9,58,36,26,26,6,32,68,47.1,36,43,16,27,24,82,45,0
Andre-Frank Zambo Anguissa,CMR,MF,28,Napoli,Serie A,31.0,61,33,21,29,11,34,69,49.3,35,40,5,35,28,89,19,1
Khvicha Kvaratskhelia,GEO,FW,23,Napoli,Serie A,30.4,42,21,11,19,12,15,49,30.6,34,15,1,14,13,55,9,0
Alex Meret,ITA,GK,27,Napoli,Serie A,30.8,1,0,1,0,0,1,2,50.0,1,0,0,0,0,1,10,1
Matteo Politano,ITA,FW,30,Napoli,Serie A,26.2,19,8,8,7,4,11,34,32.4,23,9,1,8,15,34,11,1
Amir Rrahmani,KVX,DF,30,Napoli,Serie A,28.9,33,27,17,14,2,16,32,50.0,16,24,10,14,20,53,90,0
Juan Jesus,BRA,DF,32,Napoli,Serie A,23.5,42,19,28,12,2,23,33,69.7,10,23,12,11,23,65,67,1
Piotr Zieliński,POL,MF,30,Napoli,Serie A,21.4,23,15,6,13,4,12,24,50.0,12,12,1,11,9,32,15,0
Victor Osimhen,NGA,FW,25,Napoli,Serie A,22.0,9,5,0,4,5,2,4,50.0,2,5,1,4,2,11,18,0
Leo Skiri Østigård,NOR,DF,24,Napoli,Serie A,18.1,24,12,13,10,1,6,11,54.5,5,18,12,6,16,40,65,0
Mathías Olivera,URU,DF,26,Napoli,Serie A,17.4,50,29,29,15,6,23,39,59.0,16,35,6,29,20,70,25,0
Giacomo Raspadori,ITA,"FW,MF",24,Napoli,Serie A,17.6,21,10,6,10,5,6,15,40.0,9,15,1,14,3,24,7,0
Mário Rui,POR,DF,33,Napoli,Serie A,13.4,27,15,17,5,5,14,21,66.7,7,17,2,15,15,42,19,0
Jens Cajuste,SWE,MF,24,Napoli,Serie A,11.3,36,24,13,17,6,20,37,54.1,17,20,3,17,4,40,15,0
Natan,BRA,DF,23,Napoli,Serie A,10.6,14,10,10,3,1,5,10,50.0,5,12,9,3,8,22,32,0
Giovanni Simeone,ARG,FW,28,Napoli,Serie A,8.9,12,4,1,3,8,3,12,25.0,9,11,0,11,1,13,7,0
Pierluigi Gollini,ITA,GK,29,Napoli,Serie A,7.0,1,1,1,0,0,1,1,100.0,0,0,0,0,1,2,2,0
Hamed Junior Traorè,CIV,MF,24,Napoli,Serie A,4.2,4,2,2,0,2,1,6,16.7,5,3,0,3,2,6,1,1
Pasquale Mazzocchi,ITA,DF,28,Napoli,Serie A,4.8,5,2,1,2,2,2,3,66.7,1,5,1,4,1,6,13,0
Elif Elmas,MKD,"FW,MF",24,Napoli,Serie A,3.8,4,3,1,3,0,2,2,100.0,0,2,0,2,2,6,8,0
Jesper Lindstrøm,DEN,"FW,MF",24,Napoli,Serie A,4.8,8,3,2,3,3,4,8,50.0,4,3,0,3,2,10,6,0
Cyril Ngonge,BEL,FW,24,Napoli,Serie A,3.5,5,3,1,4,0,2,2,100.0,0,2,0,2,0,5,2,0
Gianluca Gaetano,ITA,MF,24,Napoli,Serie A,1.8,4,1,0,4,0,2,4,50.0,2,5,2,3,1,5,4,0
Alessio Zerbin,ITA,"FW,DF",25,Napoli,Serie A,1.7,5,2,1,3,1,2,7,28.6,5,1,0,1,0,5,0,0
Diego Demme,GER,MF,32,Napoli,Serie A,0.8,1,1,0,1,0,0,1,0.0,1,0,0,0,0,1,0,0
Alessandro Zanoli,ITA,"DF,FW",23,Napoli,Serie A,0.6,1,1,1,0,0,0,0,0.0,0,0,0,0,1,2,1,0
Leander Dendoncker,BEL,MF,29,Napoli,Serie A,0.3,0,0,0,0,0,0,0,0.0,0,1,1,0,0,0,0,0
Nikita Contini Baranovsky,ITA,GK,28,Napoli,Serie A,0.2,0,0,0,0,0,0,0,0.0,0,0,0,0,0,0,1,0
Josep Martinez,ESP,GK,26,Genoa,Serie A,36.0,0,0,0,0,0,0,0,0.0,0,0,0,0,1,1,21,3
Morten Frendrup,DEN,MF,23,Genoa,Serie A,34.9,133,72,47,70,16,55,91,60.4,36,55,14,41,51,184,42,1
Albert Guðmundsson,ISL,"FW,MF",26,Genoa,Serie A,33.5,23,10,8,10,5,12,44,27.3,32,15,2,13,11,34,13,0
Johan Vásquez,MEX,DF,25,Genoa,Serie A,31.7,51,33,38,11,2,32,50,64.0,18,50,26,24,45,96,113,0
Milan Badelj,CRO,MF,35,Genoa,Serie A,28.2,51,27,23,24,4,24,61,39.3,37,45,13,32,50,101,54,1
Stefano Sabelli,ITA,DF,31,Genoa,Serie A,27.0,50,24,28,19,3,15,46,32.6,31,27,6,21,23,73,35,0
Mattia Bani,ITA,DF,30,Genoa,Serie A,25.6,26,10,18,7,1,11,22,50.0,11,51,31,20,22,48,116,1
Koni De Winter,BEL,DF,21,Genoa,Serie A,26.4,44,25,26,13,5,21,31,67.7,10,30,10,20,21,65,78,0
Mateo Retegui,ITA,FW,25,Genoa,Serie A,24.6,17,9,7,8,2,6,20,30.0,14,18,2,16,0,17,30,0
Radu Drăgușin,ROU,DF,22,Genoa,Serie A,19.0,16,11,9,6,1,8,9,88.9,1,18,12,6,21,37,87,3
Ruslan Malinovskyi,UKR,MF,31,Genoa,Serie A,17.2,35,20,18,11,6,17,41,41.5,24,22,8,14,5,40,16,0
Aarón Martín,ESP,DF,27,Genoa,Serie A,15.3,21,10,7,10,4,9,22,40.9,13,12,4,8,9,30,15,0
Kevin Strootman,NED,MF,34,Genoa,Serie A,13.4,34,19,13,18,3,15,31,48.4,16,20,6,14,7,41,22,0
Alessandro Vogliacco,ITA,DF,25,Genoa,Serie A,13.0,23,15,14,8,1,12,15,80.0,3,16,10,6,30,53,40,1
Junior Messias,BRA,"MF,DF",33,Genoa,Serie A,11.7,26,20,19,5,2,8,19,42.1,11,9,1,8,5,31,22,0
Caleb Ekuban,GHA,FW,30,Genoa,Serie A,12.6,8,4,2,4,2,5,9,55.6,4,11,3,8,1,9,7,0
Morten Thorsby,NOR,MF,28,Genoa,Serie A,12.9,19,11,9,8,2,7,14,50.0,7,21,5,16,4,23,20,0
Djed Spence,ENG,DF,23,Genoa,Serie A,9.5,16,10,12,4,0,8,10,80.0,2,20,5,15,8,24,28,0
Ridgeciano Haps,SUR,DF,30,Genoa,Serie A,8.6,7,6,3,2,2,5,8,62.5,3,3,0,3,6,13,11,1
Vitinha,POR,"FW,MF",24,Genoa,Serie A,3.2,2,2,1,0,1,1,2,50.0,1,2,0,2,0,2,2,0
Nicola Leali,ITA,GK,31,Genoa,Serie A,2.0,0,0,0,0,0,0,0,0.0,0,0,0,0,0,0,0,0
George Pușcaș,ROU,FW,28,Genoa,Serie A,2.1,0,0,0,0,0,0,3,0.0,3,1,0,1,0,0,1,0
Silvan Hefti,SUI,"MF,DF",26,Genoa,Serie A,1.3,6,1,2,3,1,4,7,57.1,3,2,0,2,0,6,1,0
Giorgio Cittadini,ITA,DF,22,Genoa,Serie A,1.2,5,4,4,1,0,3,3,100.0,0,1,0,1,3,8,5,0
Alan Matturro,URU,DF,19,Genoa,Serie A,1.2,1,1,1,0,0,1,1,100.0,0,6,3,3,2,3,4,0
Davide Biraschi,ITA,DF,29,Genoa,Serie A,1.0,3,3,1,2,0,1,3,33.3,2,0,0,0,2,5,5,0
Berkan Kutlu,TUR,MF,26,Genoa,Serie A,2.2,6,4,5,1,0,3,6,50.0,3,3,0,3,4,10,5,0
David Akpan Ankeye,NGA,FW,22,Genoa,Serie A,0.6,1,0,0,1,0,0,1,0.0,1,1,0,1,0,1,0,0
Emil Bohinen,NOR,MF,25,Genoa,Serie A,0.6,1,1,0,1,0,0,0,0.0,0,1,0,1,0,1,3,0
Seydou Fini,ITA,"DF,FW",17,Genoa,Serie A,0.4,0,0,0,0,0,0,0,0.0,0,0,0,0,0,0,0,0
Filip Jagiełło,POL,MF,26,Genoa,Serie A,0.4,0,0,0,0,0,0,1,0.0,1,1,1,0,1,1,0,0
Pablo Galdames Millán,CHI,"MF,DF",27,Genoa,Serie A,0.1,0,0,0,0,0,0,0,0.0,0,1,0,1,0,0,0,0
Daniele Sommariva,ITA,GK,26,Genoa,Serie A,0.1,0,0,0,0,0,0,0,0.0,0,0,0,0,0,0,0,0
Christos Papadopoulos,GRE,FW,19,Genoa,Serie A,0.0,0,0,0,0,0,0,1,0.0,1,0,0,0,0,0,0,0
Matteo Pessina,ITA,MF,27,Monza,Serie A,35.8,44,25,20,20,4,23,49,46.9,26,29,11,18,27,71,46,1
Andrea Colpani,ITA,"MF,FW",25,Monza,Serie A,29.5,25,15,6,13,6,11,20,55.0,9,11,4,7,14,39,14,0
Michele Di Gregorio,ITA,GK,26,Monza,Serie A,31.9,1,0,1,0,0,1,4,25.0,3,1,0,1,1,2,10,2
Pablo Marí,ESP,DF,30,Monza,Serie A,29.1,41,25,34,7,0,22,34,64.7,12,40,25,15,37,78,115,1
Roberto Gagliardini,ITA,"MF,DF",30,Monza,Serie A,26.2,61,30,27,25,9,31,50,62.0,19,30,11,19,31,92,38,0
Dany Mota,POR,"FW,MF",26,Monza,Serie A,22.8,13,7,2,5,6,8,17,47.1,9,4,1,3,2,15,18,0
Luca Caldirola,ITA,DF,33,Monza,Serie A,23.8,25,14,19,4,2,13,22,59.1,9,26,17,9,29,54,53,0
Samuele Birindelli,ITA,DF,24,Monza,Serie A,22.4,28,19,16,7,5,14,25,56.0,11,30,11,19,18,46,48,0
Giorgos Kyriakopoulos,GRE,DF,28,Monza,Serie A,19.0,19,10,16,3,0,11,24,45.8,13,18,1,17,13,32,28,0
Armando Izzo,ITA,DF,32,Monza,Serie A,18.3,27,17,17,9,1,16,27,59.3,11,20,16,4,27,54,49,1
Patrick Ciurria,ITA,"DF,MF",29,Monza,Serie A,17.8,30,18,13,13,4,13,21,61.9,8,20,5,15,9,39,28,0
Danilo D'Ambrosio,ITA,DF,35,Monza,Serie A,17.1,57,34,34,20,3,28,41,68.3,13,22,13,9,14,71,31,0
Andrea Carboni,ITA,DF,23,Monza,Serie A,16.5,38,22,24,12,2,20,31,64.5,11,23,13,10,17,55,56,1
Lorenzo Colombo,ITA,FW,22,Monza,Serie A,15.1,17,12,3,9,5,8,14,57.1,6,18,5,13,0,17,14,0
Warren Bondo,FRA,MF,20,Monza,Serie A,16.4,29,22,16,10,3,13,17,76.5,4,13,3,10,6,35,13,0
Milan Đurić,BIH,FW,34,Monza,Serie A,14.0,5,5,0,5,0,2,4,50.0,2,6,2,4,0,5,27,0
Valentin Carboni,ARG,"MF,FW",19,Monza,Serie A,13.0,25,15,10,12,3,8,26,30.8,18,12,1,11,7,32,4,0
Pedro Pereira,POR,DF,26,Monza,Serie A,9.3,19,13,14,4,1,9,17,52.9,8,15,2,13,4,23,18,0
Jean-Daniel Akpa-Akpro,CIV,MF,31,Monza,Serie A,7.8,20,11,14,4,2,3,9,33.3,6,10,4,6,12,32,15,0
Alessio Zerbin,ITA,"DF,FW",25,Monza,Serie A,7.6,18,10,13,2,3,4,13,30.8,9,16,3,13,3,21,5,0
Alessandro Sorrentino,ITA,GK,22,Monza,Serie A,6.1,0,0,0,0,0,0,0,0.0,0,0,0,0,0,0,0,0
Gianluca Caprari,ITA,"MF,FW",30,Monza,Serie A,3.2,2,1,1,1,0,0,1,0.0,1,0,0,0,2,4,0,0
Samuele Vignato,ITA,"MF,FW",20,Monza,Serie A,3.8,6,4,2,3,1,2,3,66.7,1,2,0,2,1,7,1,0
Daniel Maldini,ITA,"MF,FW",22,Monza,Serie A,3.7,3,2,0,2,1,3,6,50.0,3,2,0,2,2,5,1,0
Pepín,EQG,"MF,FW",27,Monza,Serie A,2.7,6,1,1,4,1,2,4,50.0,2,5,2,3,0,6,6,0
Mirko Marić,CRO,FW,29,Monza,Serie A,3.2,4,0,2,1,1,0,2,0.0,2,4,0,4,2,6,3,0
Papu Gómez,ARG,"MF,FW",36,Monza,Serie A,0.5,0,0,0,0,0,0,2,0.0,2,0,0,0,1,1,0,0
Giulio Donati,ITA,DF,34,Monza,Serie A,0.4,0,0,0,0,0,0,0,0.0,0,0,0,0,0,0,1,1
Giorgio Cittadini,ITA,DF,22,Monza,Serie A,0.2,1,1,1,0,0,1,1,100.0,0,1,1,0,0,1,0,0
Andrea Ferraris,ITA,MF,21,Monza,Serie A,0.1,1,1,1,0,0,0,0,0.0,0,0,0,0,0,1,0,0
Davide Bettella,ITA,MF,24,Monza,Serie A,0.0,0,0,0,0,0,0,0,0.0,0,0,0,0,0,0,0,0
Lorenzo Montipò,ITA,GK,28,Hellas Verona,Serie A,37.0,1,1,1,0,0,1,3,33.3,2,0,0,0,0,1,25,2
Michael Folorunsho,ITA,"MF,FW",26,Hellas Verona,Serie A,30.9,50,28,21,22,7,23,57,40.4,34,45,12,33,17,67,44,2
Ondrej Duda,SVK,MF,29,Hellas Verona,Serie A,27.3,59,39,17,35,7,31,52,59.6,21,29,12,17,26,85,21,0
Giangiacomo Magnani,ITA,DF,28,Hellas Verona,Serie A,27.2,33,18,23,10,0,15,25,60.0,10,50,28,22,45,78,118,0
Paweł Dawidowicz,POL,DF,29,Hellas Verona,Serie A,23.8,53,30,33,18,2,17,29,58.6,12,17,9,8,24,77,114,1
Tomáš Suslov,SVK,"MF,FW",21,Hellas Verona,Serie A,23.2,42,30,11,22,9,15,47,31.9,32,15,0,15,6,48,8,0
Darko Lazović,SRB,"FW,MF",33,Hellas Verona,Serie A,21.4,26,16,11,6,9,16,31,51.6,15,10,1,9,6,32,14,0
Jackson Tchatchoua,CMR,DF,22,Hellas Verona,Serie A,19.2,39,26,25,12,2,23,48,47.9,25,17,7,10,23,62,49,2
Suat Serdar,GER,MF,27,Hellas Verona,Serie A,18.4,51,39,24,23,4,22,45,48.9,23,29,7,22,20,71,25,1
Diego Coppola,ITA,DF,20,Hellas Verona,Serie A,18.2,36,22,25,9,2,20,33,60.6,13,26,9,17,27,63,89,1
Juan David Cabal,COL,DF,23,Hellas Verona,Serie A,16.6,36,27,19,14,3,18,29,62.1,11,30,9,21,26,62,55,2
Cyril Ngonge,BEL,"FW,MF",24,Hellas Verona,Serie A,15.9,14,9,5,3,6,5,14,35.7,9,7,1,6,4,18,10,0
Tijjani Noslin,NED,"FW,MF",24,Hellas Verona,Serie A,14.9,18,8,5,7,6,6,16,37.5,10,17,2,15,2,20,14,0
Filippo Terracciano,ITA,DF,21,Hellas Verona,Serie A,14.4,30,19,23,6,1,17,31,54.8,14,24,6,18,20,50,17,0
Milan Đurić,BIH,FW,34,Hellas Verona,Serie A,13.4,1,0,0,0,1,0,3,0.0,3,0,0,0,1,2,13,0
Martin Hongla,CMR,MF,26,Hellas Verona,Serie A,12.0,24,13,9,13,2,8,11,72.7,3,8,3,5,7,31,24,0
Josh Doig,SCO,DF,22,Hellas Verona,Serie A,9.2,16,9,9,7,0,13,17,76.5,4,12,3,9,4,20,17,1
Federico Bonazzoli,ITA,"FW,MF",27,Hellas Verona,Serie A,11.3,4,1,1,3,0,1,8,12.5,7,9,1,8,3,7,3,0
Isak Hien,SWE,DF,25,Hellas Verona,Serie A,9.6,17,10,10,7,0,10,19,52.6,9,12,5,7,7,24,33,1
Fabien Centonze,FRA,DF,28,Hellas Verona,Serie A,7.5,14,8,10,4,0,5,10,50.0,5,14,2,12,10,24,18,0
Davide Faraoni,ITA,DF,32,Hellas Verona,Serie A,6.7,13,10,5,6,2,7,10,70.0,3,9,5,4,6,19,21,0
Bruno Amione,ARG,DF,22,Hellas Verona,Serie A,6.4,11,3,9,2,0,4,5,80.0,1,4,2,2,9,20,19,2
Jordi Mboula,ESP,"FW,MF",25,Hellas Verona,Serie A,3.4,4,4,1,2,1,4,7,57.1,3,4,1,3,1,5,0,0
Stefan Mitrović,SRB,"FW,MF",21,Hellas Verona,Serie A,4.3,6,3,0,5,1,2,5,40.0,3,6,1,5,0,6,4,0
Karol Świderski,POL,"FW,MF",27,Hellas Verona,Serie A,5.6,7,3,1,3,3,2,3,66.7,1,6,4,2,1,8,8,0
Daniel Bandeira,POR,MF,24,Hellas Verona,Serie A,5.0,6,5,1,4,1,3,7,42.9,4,3,0,3,3,9,9,0
Riccardo Saponara,ITA,"FW,MF",32,Hellas Verona,Serie A,3.8,3,1,2,0,1,1,7,14.3,6,4,0,4,0,3,2,0
Thomas Henry,FRA,FW,29,Hellas Verona,Serie A,3.7,0,0,0,0,0,0,0,0.0,0,0,0,0,0,0,5,0
Rúben Vinagre,POR,"DF,FW",25,Hellas Verona,Serie A,3.1,4,2,1,1,2,3,4,75.0,1,6,3,3,1,5,4,0
Juan Cruz,ARG,"FW,MF",24,Hellas Verona,Serie A,1.2,2,2,0,0,2,0,0,0.0,0,1,0,1,1,3,0,0
Reda Belahyane,FRA,MF,19,Hellas Verona,Serie A,1.0,1,1,0,1,0,1,1,100.0,0,0,0,0,1,2,0,0
Simone Perilli,ITA,GK,29,Hellas Verona,Serie A,1.0,0,0,0,0,0,0,0,0.0,0,0,0,0,0,0,0,0
Elayis Tavsan,NED,"MF,FW",23,Hellas Verona,Serie A,0.6,0,0,0,0,0,0,1,0.0,1,0,0,0,0,0,1,0
Charlys,BRA,MF,20,Hellas Verona,Serie A,0.3,0,0,0,0,0,0,0,0.0,0,0,0,0,1,1,0,0
Alphadjo Cissè,ITA,FW,17,Hellas Verona,Serie A,0.1,0,0,0,0,0,0,0,0.0,0,0,0,0,0,0,0,0
Yayah Kallon,SLE,FW,22,Hellas Verona,Serie A,0.0,0,0,0,0,0,0,0,0.0,0,0,0,0,0,0,0,0
Wladimiro Falcone,ITA,GK,29,Lecce,Serie A,38.0,0,0,0,0,0,0,0,0.0,0,1,0,1,1,1,21,2
Federico Baschirotto,ITA,DF,27,Lecce,Serie A,36.6,21,12,16,5,0,8,15,53.3,7,42,26,16,23,44,144,1
Marin Pongračić,CRO,DF,26,Lecce,Serie A,35.8,43,30,22,20,1,19,25,76.0,6,37,26,11,51,94,130,1
Valentin Gendrey,FRA,DF,23,Lecce,Serie A,33.8,55,33,35,16,4,30,46,65.2,16,40,11,29,35,90,99,0
Ylber Ramadani,ALB,MF,28,Lecce,Serie A,33.0,68,41,32,29,7,37,96,38.5,59,54,13,41,44,112,44,0
Antonino Gallo,ITA,DF,24,Lecce,Serie A,27.7,43,27,31,11,1,31,49,63.3,18,34,9,25,25,68,67,0
Nikola Krstović,MNE,FW,24,Lecce,Serie A,26.4,17,6,3,9,5,6,10,60.0,4,12,4,8,4,21,22,0
Pontus Almqvist,SWE,"FW,MF",24,Lecce,Serie A,23.4,45,29,16,22,7,23,51,45.1,28,21,2,19,14,59,10,0
Remi Oudin,FRA,"MF,FW",27,Lecce,Serie A,20.2,26,14,12,12,2,12,19,63.2,7,13,1,12,20,46,22,0
Patrick Dorgu,DEN,"DF,MF",19,Lecce,Serie A,17.4,43,22,22,17,4,22,34,64.7,12,16,5,11,9,52,45,2
Lameck Banda,ZAM,FW,23,Lecce,Serie A,15.0,27,23,11,12,4,7,21,33.3,14,18,0,18,3,30,7,0
Hamza Rafia,TUN,MF,25,Lecce,Serie A,13.4,44,31,13,27,4,13,30,43.3,17,27,1,26,11,55,13,0
Alexis Blin,FRA,MF,27,Lecce,Serie A,18.2,33,19,11,19,3,15,43,34.9,28,16,2,14,22,55,39,0
Mohamed Kaba,FRA,MF,22,Lecce,Serie A,15.3,39,23,15,16,8,17,34,50.0,17,22,4,18,12,51,13,0
Joan Gonzàlez,ESP,MF,22,Lecce,Serie A,14.3,31,18,16,12,3,17,28,60.7,11,20,3,17,5,36,9,0
Gabriel Strefezza,BRA,FW,27,Lecce,Serie A,12.4,24,17,8,7,9,14,20,70.0,6,17,0,17,7,31,11,0
Roberto Piccoli,ITA,FW,23,Lecce,Serie A,15.3,10,6,3,5,2,1,4,25.0,3,17,1,16,4,14,16,0
Nicola Sansone,ITA,"FW,MF",32,Lecce,Serie A,8.5,11,6,6,2,3,5,16,31.3,11,7,1,6,4,15,5,2
Lorenzo Venuti,ITA,DF,29,Lecce,Serie A,4.0,6,4,5,1,0,6,10,60.0,4,4,3,1,5,11,14,0
Ahmed Touba,ALG,DF,26,Lecce,Serie A,3.1,6,4,3,3,0,3,4,75.0,1,4,3,1,7,13,20,0
Medon Berisha,ALB,"FW,MF",20,Lecce,Serie A,2.3,3,1,3,0,0,0,2,0.0,2,2,2,0,1,4,0,0
Santiago Pierotti,ARG,"MF,FW",23,Lecce,Serie A,2.2,8,8,2,5,1,2,8,25.0,6,5,0,5,1,9,0,0
Federico Di Francesco,ITA,"FW,MF",29,Lecce,Serie A,0.2,1,0,0,1,0,0,0,0.0,0,0,0,0,0,1,0,0
Jeppe Corfitzen,DEN,FW,19,Lecce,Serie A,0.1,1,0,0,1,0,1,1,100.0,0,0,0,0,0,1,0,0
Rareș-Cătălin Burnete,ROU,FW,20,Lecce,Serie A,0.1,0,0,0,0,0,0,0,0.0,0,0,0,0,0,0,0,0
Marcin Listkowski,POL,FW,26,Lecce,Serie A,0.1,0,0,0,0,0,0,0,0.0,0,0,0,0,0,0,0,0
Walace,BRA,MF,29,Udinese,Serie A,36.0,66,43,40,26,0,36,77,46.8,41,43,6,37,43,109,66,1
Nehuén Pérez,ARG,DF,23,Udinese,Serie A,36.0,72,48,42,28,2,39,48,81.3,9,53,26,27,45,117,158,1
Lorenzo Lucca,ITA,FW,23,Udinese,Serie A,28.8,19,11,4,11,4,5,20,25.0,15,18,3,15,3,22,36,1
Lazar Samardzic,SRB,MF,22,Udinese,Serie A,26.4,40,19,18,18,4,16,39,41.0,23,26,6,20,10,50,25,0
Hassane Kamara,CIV,DF,30,Udinese,Serie A,24.7,45,32,26,13,6,25,38,65.8,13,29,2,27,26,71,66,0
Thomas Kristensen,DEN,DF,22,Udinese,Serie A,23.3,35,24,25,10,0,21,33,63.6,12,29,20,9,29,64,118,0
Jaka Bijol,SVN,DF,25,Udinese,Serie A,23.2,43,27,34,9,0,22,35,62.9,13,36,21,15,23,66,140,1
Roberto Pereyra,ARG,"FW,MF",33,Udinese,Serie A,20.6,19,9,11,5,3,11,29,37.9,18,20,4,16,7,26,18,0
Sandi Lovrić,SVN,MF,26,Udinese,Serie A,22.1,25,12,9,11,5,9,23,39.1,14,21,2,19,21,46,24,0
Maduka Okoye,NGA,GK,24,Udinese,Serie A,21.0,0,0,0,0,0,0,0,0.0,0,0,0,0,1,1,4,2
Martín Payero,ARG,MF,25,Udinese,Serie A,20.0,54,32,28,19,7,19,46,41.3,27,25,7,18,15,69,21,0
Festy Ebosele,IRL,DF,21,Udinese,Serie A,18.9,33,20,23,9,1,21,35,60.0,14,33,2,31,10,43,27,0
Florian Thauvin,FRA,FW,31,Udinese,Serie A,19.0,7,4,2,4,1,4,13,30.8,9,9,1,8,3,10,2,0
João Ferreira,POR,DF,23,Udinese,Serie A,20.2,58,42,36,18,4,34,58,58.6,24,27,6,21,29,87,89,0
Marco Silvestri,ITA,GK,33,Udinese,Serie A,17.0,0,0,0,0,0,0,3,0.0,3,1,0,1,0,0,5,3
Kingsley Ehizibue,NED,DF,29,Udinese,Serie A,10.6,22,14,16,4,2,11,18,61.1,7,21,3,18,8,30,36,0
Jordan Zemura,ZIM,DF,24,Udinese,Serie A,11.5,24,16,13,7,4,11,19,57.9,8,5,1,4,13,37,21,0
Christian Kabasele,BEL,DF,33,Udinese,Serie A,9.6,10,7,4,5,1,2,11,18.2,9,15,9,6,12,22,56,0
Isaac Success,NGA,"FW,MF",28,Udinese,Serie A,9.8,6,4,0,5,1,1,3,33.3,2,6,1,5,2,8,11,0
Lautaro Gianetti,ARG,DF,30,Udinese,Serie A,7.0,9,4,7,2,0,4,5,80.0,1,10,6,4,19,28,39,0
Oier Zarraga,ESP,MF,25,Udinese,Serie A,4.5,3,3,2,1,0,1,5,20.0,4,5,2,3,5,8,16,1
Brenner,BRA,"MF,FW",24,Udinese,Serie A,2.1,8,7,1,5,2,4,7,57.1,3,2,0,2,0,8,2,0
Beto,GNB,FW,26,Udinese,Serie A,0.8,1,0,0,0,1,0,0,0.0,0,0,0,0,0,1,0,0
Adam Masina,MAR,DF,30,Udinese,Serie A,0.7,4,0,2,2,0,2,4,50.0,2,2,1,1,2,6,5,0
Keinan Davis,ENG,"FW,MF",26,Udinese,Serie A,2.1,0,0,0,0,0,0,0,0.0,0,0,0,0,0,0,3,0
Axel Guessand,FRA,DF,19,Udinese,Serie A,0.5,1,1,0,1,0,1,1,100.0,0,1,0,1,0,1,0,0
Domingos Quina,POR,MF,24,Udinese,Serie A,0.1,1,1,1,0,0,0,0,0.0,0,0,0,0,0,1,0,0
Vivaldo Semedo,POR,FW,19,Udinese,Serie A,0.1,0,0,0,0,0,0,0,0.0,0,0,0,0,0,0,0,0
Marley Aké,FRA,FW,23,Udinese,Serie A,0.1,0,0,0,0,0,0,0,0.0,0,0,0,0,0,0,0,0
Enzo Ebosse,CMR,DF,25,Udinese,Serie A,0.1,1,1,1,0,0,0,1,0.0,1,0,0,0,1,2,0,0
Simone Pafundi,ITA,MF,18,Udinese,Serie A,0.1,0,0,0,0,0,0,0,0.0,0,0,0,0,0,0,0,0
Antonio Tikvić,CRO,DF,20,Udinese,Serie A,0.0,0,0,0,0,0,0,0,0.0,0,0,0,0,0,0,0,0
Alberto Dossena,ITA,DF,25,Cagliari,Serie A,33.1,55,35,43,12,0,32,48,66.7,16,50,27,23,45,100,172,2
Antoine Makoumbou,CGO,MF,25,Cagliari,Serie A,30.0,41,24,21,15,5,15,30,50.0,15,23,4,19,16,57,27,2
Simone Scuffet,ITA,GK,27,Cagliari,Serie A,31.0,1,0,1,0,0,1,2,50.0,1,1,0,1,1,2,9,0
Nahitan Nández,URU,"MF,DF",28,Cagliari,Serie A,26.0,59,40,27,23,9,27,64,42.2,37,25,2,23,19,78,32,0
Tommaso Augello,ITA,DF,29,Cagliari,Serie A,26.9,26,19,18,6,2,16,25,64.0,9,21,10,11,17,43,89,0
Gabriele Zappa,ITA,DF,24,Cagliari,Serie A,28.5,54,31,29,16,9,29,41,70.7,12,29,5,24,20,74,75,2
Matteo Prati,ITA,MF,20,Cagliari,Serie A,21.9,45,25,15,27,3,26,42,61.9,16,29,6,23,15,60,26,1
Zito Luvumbo,ANG,"FW,MF",22,Cagliari,Serie A,21.6,9,6,5,2,2,4,15,26.7,11,19,0,19,1,10,2,0
Alessandro Deiola,ITA,MF,28,Cagliari,Serie A,17.9,33,19,13,16,4,18,47,38.3,29,16,6,10,9,42,37,0
Ibrahim Sulemana,GHA,MF,21,Cagliari,Serie A,14.9,36,14,15,15,6,17,27,63.0,10,24,5,19,7,43,23,0
Yerry Mina,COL,DF,29,Cagliari,Serie A,13.5,20,13,14,6,0,13,19,68.4,6,23,14,9,4,24,77,0
Gianluca Lapadula,PER,FW,34,Cagliari,Serie A,13.4,1,1,0,0,1,1,10,10.0,9,2,1,1,2,3,5,0
Andrea Petagna,ITA,FW,28,Cagliari,Serie A,11.1,4,2,1,0,3,1,2,50.0,1,6,3,3,1,5,4,0
Jakub Jankto,CZE,"MF,FW",28,Cagliari,Serie A,9.7,12,9,9,1,2,8,20,40.0,12,5,1,4,5,17,20,0
Pantelis Hatzidiakos,GRE,DF,27,Cagliari,Serie A,9.5,22,10,12,10,0,10,17,58.8,7,14,5,9,13,35,30,1
Edoardo Goldaniga,ITA,DF,30,Cagliari,Serie A,11.2,12,7,9,3,0,4,10,40.0,6,11,7,4,15,27,37,1
Nicolas Viola,ITA,"MF,FW",34,Cagliari,Serie A,13.4,13,9,2,8,3,7,17,41.2,10,9,0,9,2,15,6,0
Gaetano Oristanio,ITA,"FW,MF",21,Cagliari,Serie A,12.3,20,10,5,14,1,5,17,29.4,12,11,0,11,9,29,8,0
Mateusz Wieteska,POL,DF,27,Cagliari,Serie A,10.7,14,11,9,3,2,3,10,30.0,7,10,5,5,14,28,48,0
Adam Obert,SVK,DF,21,Cagliari,Serie A,10.5,17,9,8,8,1,8,17,47.1,9,13,7,6,21,38,41,1
Eldor Shomurodov,UZB,"FW,MF",28,Cagliari,Serie A,10.4,11,4,2,6,3,6,10,60.0,4,5,0,5,4,15,4,0
Gianluca Gaetano,ITA,"FW,MF",24,Cagliari,Serie A,8.3,7,4,0,4,3,2,7,28.6,5,4,0,4,3,10,4,0
Paulo Azzi,BRA,"DF,MF",29,Cagliari,Serie A,10.6,19,11,10,6,3,9,18,50.0,9,11,2,9,16,35,23,0
Boris Radunović,SRB,GK,28,Cagliari,Serie A,7.0,0,0,0,0,0,0,0,0.0,0,0,0,0,1,1,1,2
Leonardo Pavoletti,ITA,FW,35,Cagliari,Serie A,7.0,1,1,0,0,1,0,1,0.0,1,2,1,1,0,1,7,0
Marco Mancosu,ITA,"MF,FW",35,Cagliari,Serie A,1.7,3,0,0,2,1,1,2,50.0,1,0,0,0,0,3,0,0
Alessandro Di Pardo,ITA,"DF,MF",24,Cagliari,Serie A,4.0,4,1,3,0,1,0,3,0.0,3,9,2,7,5,9,7,0
Kingstone Mutandwa,ZAM,"FW,MF",21,Cagliari,Serie A,0.4,1,0,1,0,0,1,4,25.0,3,1,0,1,0,1,2,0
Simone Aresti,ITA,GK,38,Cagliari,Serie A,0.0,0,0,0,0,0,0,0,0.0,0,0,0,0,0,0,0,0
Sebastiano Luperto,ITA,DF,27,Empoli,Serie A,37.8,37,26,25,10,2,15,24,62.5,9,46,35,11,32,69,157,1
Youssef Maleh,MAR,MF,25,Empoli,Serie A,28.9,74,48,30,36,8,23,52,44.2,29,62,7,55,25,99,29,0
Nicolò Cambiaghi,ITA,"FW,MF",23,Empoli,Serie A,28.4,51,39,15,20,16,16,35,45.7,19,26,1,25,14,65,8,0
Elia Caprile,ITA,GK,22,Empoli,Serie A,23.0,1,0,1,0,0,1,1,100.0,0,0,0,0,0,1,16,2
Sebastian Walukiewicz,POL,DF,24,Empoli,Serie A,22.8,39,28,33,6,0,28,41,68.3,13,50,31,19,15,54,121,0
Ardian Ismajli,ALB,DF,27,Empoli,Serie A,22.7,26,16,18,6,2,18,23,78.3,5,28,17,11,23,49,126,1
Alberto Grassi,ITA,MF,29,Empoli,Serie A,20.1,30,18,13,13,4,10,26,38.5,16,26,11,15,41,71,37,0
Bartosz Bereszyński,POL,DF,31,Empoli,Serie A,19.6,41,25,25,13,3,24,40,60.0,16,22,10,12,21,62,52,0
Emmanuel Gyasi,GHA,"DF,FW",30,Empoli,Serie A,20.9,34,17,18,13,3,15,32,46.9,17,30,12,18,5,39,27,1
Răzvan Marin,ROU,MF,28,Empoli,Serie A,20.2,40,22,13,23,4,19,29,65.5,10,16,4,12,6,46,30,2
Liberato Cacace,NZL,DF,23,Empoli,Serie A,21.2,40,24,24,13,3,24,38,63.2,14,23,6,17,19,59,56,0
Matteo Cancellieri,ITA,"FW,MF",22,Empoli,Serie A,19.9,35,22,12,16,7,13,36,36.1,23,19,0,19,6,41,18,0
Francesco Caputo,ITA,FW,36,Empoli,Serie A,14.1,2,0,0,0,2,0,1,0.0,1,4,0,4,1,3,3,0
Etrit Berisha,ALB,GK,35,Empoli,Serie A,14.0,0,0,0,0,0,0,1,0.0,1,0,0,0,0,0,7,1
Jacopo Fazzini,ITA,MF,21,Empoli,Serie A,13.7,49,25,27,13,9,30,53,56.6,23,21,3,18,12,61,18,0
Giuseppe Pezzella,ITA,DF,26,Empoli,Serie A,12.1,25,14,19,5,1,20,28,71.4,8,17,6,11,2,27,35,0
Tyronne Ebuehi,NGA,DF,28,Empoli,Serie A,12.2,14,9,9,5,0,7,11,63.6,4,9,4,5,6,20,27,1
Szymon Żurkowski,POL,MF,26,Empoli,Serie A,9.6,15,6,5,8,2,5,15,33.3,10,5,1,4,6,21,11,0
Alberto Cerri,ITA,FW,28,Empoli,Serie A,6.1,3,3,1,1,1,2,5,40.0,3,3,1,2,3,6,7,0
Simone Bastoni,ITA,"MF,DF",27,Empoli,Serie A,8.3,22,13,12,7,3,11,22,50.0,11,8,0,8,11,33,18,0
Tommaso Baldanzi,ITA,"MF,FW",21,Empoli,Serie A,8.3,4,2,1,1,2,3,10,30.0,7,7,0,7,2,6,0,0
M'Baye Niang,SEN,FW,29,Empoli,Serie A,7.9,3,1,0,1,2,0,6,0.0,6,7,1,6,3,6,10,0
Filippo Ranocchia,ITA,"MF,DF",23,Empoli,Serie A,5.3,16,11,7,9,0,7,16,43.8,9,9,1,8,3,19,14,0
Viktor Kovalenko,UKR,MF,28,Empoli,Serie A,6.8,5,2,2,2,1,2,8,25.0,6,12,2,10,1,6,7,0
Steven Shpendi,ALB,"FW,MF",21,Empoli,Serie A,4.6,0,0,0,0,0,0,4,0.0,4,2,1,1,1,1,0,0
Mattia Destro,ITA,"FW,MF",33,Empoli,Serie A,4.1,2,1,0,2,0,1,1,100.0,0,4,0,4,2,4,3,0
Daniel Maldini,ITA,"FW,MF",22,Empoli,Serie A,2.9,4,2,0,2,2,2,2,100.0,0,5,0,5,2,6,2,0
Nicolas Haas,SUI,MF,28,Empoli,Serie A,1.0,5,3,1,2,2,3,3,100.0,0,1,0,1,1,6,1,0
Samuele Perisan,ITA,GK,26,Empoli,Serie A,1.0,0,0,0,0,0,0,0,0.0,0,0,0,0,0,0,0,0
Roberto Piccoli,ITA,FW,23,Empoli,Serie A,0.4,1,1,0,0,1,1,1,100.0,0,0,0,0,0,1,0,0
Giacomo Corona,ITA,FW,20,Empoli,Serie A,0.1,0,0,0,0,0,0,0,0.0,0,0,0,0,0,0,0,0
Emmanuel Ekong,SWE,FW,21,Empoli,Serie A,0.1,0,0,0,0,0,0,0,0.0,0,0,0,0,0,0,0,0
Liam Henderson,SCO,MF,28,Empoli,Serie A,0.1,0,0,0,0,0,0,0,0.0,0,0,0,0,0,0,0,0
Andrea Sodero,ITA,MF,19,Empoli,Serie A,0.1,0,0,0,0,0,0,0,0.0,0,0,0,0,0,0,0,0
Matìas Soulé,ARG,"FW,MF",21,Frosinone,Serie A,34.7,41,27,12,14,15,19,40,47.5,21,38,4,34,18,59,9,0
Caleb Okoli,ITA,DF,22,Frosinone,Serie A,32.4,56,34,33,22,1,29,44,65.9,15,48,32,16,29,85,156,4
Enzo Barrenechea,ARG,MF,23,Frosinone,Serie A,31.2,65,42,28,29,8,28,70,40.0,42,47,12,35,27,92,61,2
Stefano Turati,ITA,GK,22,Frosinone,Serie A,30.5,0,0,0,0,0,0,0,0.0,0,0,0,0,0,0,6,3
Simone Romagnoli,ITA,DF,34,Frosinone,Serie A,30.2,35,15,23,11,1,15,20,75.0,5,51,36,15,29,64,147,0
Luca Mazzitelli,ITA,MF,28,Frosinone,Serie A,24.6,45,23,15,24,6,26,49,53.1,23,23,7,16,19,64,62,0
Marco Brescianini,ITA,MF,24,Frosinone,Serie A,25.8,28,13,13,12,3,9,25,36.0,16,22,5,17,10,38,37,0
Walid Cheddira,MAR,FW,26,Frosinone,Serie A,23.6,12,7,1,8,3,4,8,50.0,4,6,1,5,5,17,10,0
Pol Lirola,ESP,DF,26,Frosinone,Serie A,17.1,30,18,14,15,1,17,35,48.6,18,12,1,11,19,49,41,1
Francesco Gelli,ITA,"MF,DF",27,Frosinone,Serie A,17.3,19,13,8,4,7,10,24,41.7,14,19,3,16,11,30,27,1
Ilario Monterisi,ITA,DF,22,Frosinone,Serie A,16.3,23,13,14,7,2,12,26,46.2,14,22,18,4,8,31,63,0
Nadir Zortea,ITA,DF,24,Frosinone,Serie A,14.0,21,14,8,13,0,10,22,45.5,12,13,5,8,4,25,29,1
Anthony Oyono,GAB,DF,23,Frosinone,Serie A,13.3,37,26,21,14,2,23,34,67.6,11,17,3,14,9,46,32,0
Emanuele Valeri,ITA,DF,25,Frosinone,Serie A,13.1,19,16,10,5,4,10,21,47.6,11,14,3,11,9,28,22,0
Riccardo Marchizza,ITA,DF,26,Frosinone,Serie A,12.8,7,6,4,3,0,3,13,23.1,10,10,2,8,7,14,33,0
Reinier,BRA,"MF,FW",22,Frosinone,Serie A,11.8,21,10,6,12,3,5,17,29.4,12,24,4,20,10,31,5,0
Abdou Harroui,NED,"MF,FW",26,Frosinone,Serie A,11.3,23,11,11,11,1,8,16,50.0,8,19,3,16,5,28,8,0
Kaio Jorge,BRA,FW,22,Frosinone,Serie A,9.0,6,4,0,1,5,3,4,75.0,1,6,0,6,1,7,0,0
Michele Cerofolini,ITA,GK,25,Frosinone,Serie A,7.5,0,0,0,0,0,0,0,0.0,0,0,0,0,0,0,5,1
Marvin Cuni,ALB,FW,22,Frosinone,Serie A,5.9,8,3,1,3,4,3,4,75.0,1,10,1,9,1,9,0,0
Jaime Báez,URU,"FW,MF",29,Frosinone,Serie A,5.6,4,1,0,2,2,0,7,0.0,7,5,0,5,4,8,1,0
Luca Garritano,ITA,"MF,DF",30,Frosinone,Serie A,5.4,10,5,7,2,1,5,15,33.3,10,13,0,13,4,14,8,1
Arijon Ibrahimović,GER,"FW,DF",18,Frosinone,Serie A,5.3,7,6,4,2,1,1,9,11.1,8,4,0,4,1,8,3,0
Kevin Bonifazi,ITA,DF,28,Frosinone,Serie A,3.4,5,3,2,3,0,2,3,66.7,1,1,0,1,3,8,9,0
Demba Seck,SEN,"FW,MF",23,Frosinone,Serie A,3.3,7,4,2,3,2,4,5,80.0,1,3,0,3,1,8,1,0
Mateus Lusuardi,BRA,DF,20,Frosinone,Serie A,2.4,2,1,1,1,0,1,3,33.3,2,4,2,2,4,6,8,0
Mehdi Bourabia,MAR,MF,32,Frosinone,Serie A,2.2,5,4,1,4,0,2,4,50.0,2,3,0,3,0,5,4,0
Giuseppe Caso,ITA,"FW,MF",25,Frosinone,Serie A,4.6,4,3,2,0,2,2,3,66.7,1,0,0,0,0,4,0,0
Farés Ghedjemis,FRA,"FW,MF",21,Frosinone,Serie A,2.0,2,0,1,0,1,0,2,0.0,2,2,0,2,1,3,2,0
Giorgi Kvernadze,GEO,"FW,DF",21,Frosinone,Serie A,0.7,3,0,2,0,1,2,2,100.0,0,1,0,1,1,4,0,0
Gennaro Borrelli,ITA,FW,24,Frosinone,Serie A,0.3,0,0,0,0,0,0,0,0.0,0,0,0,0,0,0,0,0
Karlo Lulić,CRO,MF,28,Frosinone,Serie A,0.2,0,0,0,0,0,0,0,0.0,0,1,0,1,1,1,0,0
Luigi Canotto,ITA,FW,30,Frosinone,Serie A,0.2,0,0,0,0,0,0,0,0.0,0,0,0,0,0,0,0,0
Przemysław Szymiński,POL,MF,29,Frosinone,Serie A,0.1,0,0,0,0,0,0,0,0.0,0,1,1,0,0,0,0,0
Andrea Pinamonti,ITA,FW,25,Sassuolo,Serie A,34.2,13,8,1,6,6,5,22,22.7,17,19,2,17,1,14,40,0
Andrea Consigli,ITA,GK,37,Sassuolo,Serie A,35.0,0,0,0,0,0,0,0,0.0,0,1,0,1,1,1,19,1
Armand Lauriente,FRA,FW,25,Sassuolo,Serie A,32.3,31,20,8,14,9,13,44,29.5,31,29,4,25,15,46,11,0
Martin Erlic,CRO,DF,26,Sassuolo,Serie A,29.1,37,22,26,8,3,20,30,66.7,10,31,16,15,28,65,128,1
Kristian Thorstvedt,NOR,MF,25,Sassuolo,Serie A,26.6,40,22,7,28,5,22,44,50.0,22,25,9,16,21,61,36,0
Matheus Henrique,BRA,MF,26,Sassuolo,Serie A,27.8,43,29,21,18,4,18,43,41.9,25,18,8,10,25,68,31,6
Gian Marco Ferrari,ITA,DF,32,Sassuolo,Serie A,25.2,22,10,11,11,0,12,18,66.7,6,28,17,11,25,47,76,0
Jeremy Toljan,GER,DF,29,Sassuolo,Serie A,23.1,13,10,8,4,1,9,15,60.0,6,17,5,12,16,29,49,1
Daniel Boloca,ROU,MF,25,Sassuolo,Serie A,22.5,48,33,18,25,5,27,46,58.7,19,23,13,10,14,62,33,2
Domenico Berardi,ITA,FW,29,Sassuolo,Serie A,15.9,17,8,7,9,1,2,21,9.5,19,17,0,17,13,30,9,0
Marcus Pedersen,NOR,DF,23,Sassuolo,Serie A,17.9,36,24,25,5,6,21,25,84.0,4,19,5,14,10,46,51,0
Ruan,BRA,DF,24,Sassuolo,Serie A,16.8,25,15,11,10,4,10,18,55.6,8,18,15,3,24,49,68,2
Josh Doig,SCO,DF,22,Sassuolo,Serie A,14.9,25,17,16,9,0,15,27,55.6,12,31,10,21,16,41,38,0
Nedim Bajrami,ALB,"MF,FW",25,Sassuolo,Serie A,14.6,13,6,6,3,4,5,13,38.5,8,5,1,4,6,19,8,0
Matías Viña,URU,DF,26,Sassuolo,Serie A,11.3,34,21,22,7,5,20,36,55.6,16,12,2,10,9,43,34,0
Mattia Viti,ITA,DF,22,Sassuolo,Serie A,10.9,24,15,14,7,3,10,22,45.5,12,20,10,10,10,34,44,0
Uroš Račić,SRB,MF,26,Sassuolo,Serie A,9.1,10,4,6,4,0,0,9,0.0,9,16,7,9,7,17,22,0
Grégoire Defrel,MTQ,"FW,MF",32,Sassuolo,Serie A,8.4,17,8,7,5,5,7,15,46.7,8,10,0,10,3,20,9,0
Samu Castillejo,ESP,"FW,MF",29,Sassuolo,Serie A,6.0,12,10,5,5,2,7,19,36.8,12,16,1,15,1,13,3,0
Cristian Volpato,ITA,"MF,FW",20,Sassuolo,Serie A,7.2,16,8,9,6,1,9,25,36.0,16,7,0,7,1,17,5,0
Pedro Obiang,EQG,MF,32,Sassuolo,Serie A,5.0,8,4,3,4,1,2,10,20.0,8,6,4,2,8,16,10,0
Luca Lipani,ITA,MF,19,Sassuolo,Serie A,4.3,9,7,4,3,2,3,11,27.3,8,9,2,7,6,15,7,0
Marash Kumbulla,ALB,DF,24,Sassuolo,Serie A,4.0,3,2,2,1,0,1,2,50.0,1,8,6,2,0,3,22,0
Alessio Cragno,ITA,GK,29,Sassuolo,Serie A,3.0,0,0,0,0,0,0,0,0.0,0,0,0,0,0,0,3,1
Filippo Missori,ITA,DF,20,Sassuolo,Serie A,3.0,6,3,2,4,0,4,11,36.4,7,3,2,1,4,10,8,0
Maxime Lopez,FRA,MF,26,Sassuolo,Serie A,1.6,2,1,1,1,0,1,2,50.0,1,1,1,0,2,4,0,0
Samuele Mulattieri,ITA,"FW,MF",23,Sassuolo,Serie A,5.1,1,1,0,0,1,1,2,50.0,1,7,2,5,1,2,2,0
Emil Ceide,NOR,"FW,MF",22,Sassuolo,Serie A,2.0,2,2,1,1,0,1,1,100.0,0,6,1,5,0,2,0,0
Kevin Miranda,ITA,DF,21,Sassuolo,Serie A,0.2,0,0,0,0,0,0,0,0.0,0,0,0,0,0,0,1,0
Justin Kumi,ITA,FW,19,Sassuolo,Serie A,0.0,0,0,0,0,0,0,0,0.0,0,0,0,0,0,0,0,0
Antonio Candreva,ITA,"MF,FW",37,Salernitana,Serie A,30.6,18,13,8,8,2,9,25,36.0,16,9,0,9,7,25,23,0
Domagoj Bradarić,CRO,DF,24,Salernitana,Serie A,30.5,29,20,13,10,6,15,25,60.0,10,22,7,15,32,61,62,1
Lassana Coulibaly,MLI,MF,28,Salernitana,Serie A,23.1,47,32,20,21,6,22,49,44.9,27,23,5,18,16,63,29,0
Lorenzo Pirola,ITA,DF,22,Salernitana,Serie A,22.1,39,23,25,14,0,15,28,53.6,13,46,30,16,25,64,93,1
Loum Tchaouna,FRA,"FW,MF",20,Salernitana,Serie A,23.3,20,10,5,13,2,10,20,50.0,10,20,1,19,4,24,16,1
Guillermo Ochoa,MEX,GK,38,Salernitana,Serie A,21.0,0,0,0,0,0,0,1,0.0,1,0,0,0,0,0,9,1
Giulio Maggiore,ITA,MF,26,Salernitana,Serie A,20.0,49,29,26,22,1,20,42,47.6,22,27,5,22,24,73,38,0
Norbert Gyömbér,SVK,DF,31,Salernitana,Serie A,19.6,36,18,30,6,0,20,26,76.9,6,33,23,10,23,59,77,2
Grigoris Kastanos,CYP,"MF,DF",26,Salernitana,Serie A,16.4,23,14,8,9,6,9,20,45.0,11,13,4,9,8,31,9,0
Pasquale Mazzocchi,ITA,DF,28,Salernitana,Serie A,14.1,25,19,14,10,1,16,29,55.2,13,14,6,8,5,30,31,0
Federico Fazio,ARG,DF,37,Salernitana,Serie A,15.1,18,11,14,4,0,8,14,57.1,6,22,19,3,17,35,99,1
Toma Bašić,CRO,MF,27,Salernitana,Serie A,12.9,20,13,10,9,1,10,27,37.0,17,18,6,12,14,34,29,0
Benoît Costil,FRA,GK,36,Salernitana,Serie A,13.0,2,1,1,1,0,2,3,66.7,1,0,0,0,0,2,5,1
Boulaye Dia,SEN,"FW,MF",27,Salernitana,Serie A,12.7,4,2,2,2,0,1,3,33.3,2,5,0,5,3,7,7,0
Chukwubuikem Ikwuemesi,NGA,FW,22,Salernitana,Serie A,11.8,3,1,0,2,1,2,6,33.3,4,1,1,0,1,4,8,0
Matteo Lovato,ITA,DF,24,Salernitana,Serie A,10.5,27,14,17,8,2,16,24,66.7,8,14,7,7,18,45,41,1
Niccolò Pierozzi,ITA,DF,22,Salernitana,Serie A,9.7,17,11,13,4,0,11,22,50.0,11,24,7,17,11,28,36,0
Mateusz Łęgowski,POL,MF,21,Salernitana,Serie A,12.7,23,12,8,12,3,11,26,42.3,15,13,2,11,7,30,16,0
Junior Sambia,FRA,"DF,MF",27,Salernitana,Serie A,11.5,12,5,8,1,3,6,11,54.5,5,15,7,8,11,23,28,0
Alessandro Zanoli,ITA,DF,23,Salernitana,Serie A,10.2,16,13,9,7,0,7,12,58.3,5,10,2,8,1,17,17,0
Flavius Daniliuc,AUT,DF,23,Salernitana,Serie A,8.3,19,11,12,5,2,9,19,47.4,10,13,4,9,8,27,15,0
Jovane Cabral,CPV,"MF,FW",25,Salernitana,Serie A,7.5,13,9,4,7,2,3,9,33.3,6,3,0,3,1,14,4,0
Emil Bohinen,NOR,MF,25,Salernitana,Serie A,5.9,8,6,5,3,0,2,10,20.0,8,8,2,6,14,22,6,1
Agustín Martegani,ARG,MF,24,Salernitana,Serie A,8.1,13,7,7,3,3,6,18,33.3,12,4,1,3,4,17,7,1
Simeon Nwankwo,NGA,FW,32,Salernitana,Serie A,7.6,6,3,0,2,4,1,3,33.3,2,7,0,7,0,6,4,0
Kostas Manolas,GRE,DF,32,Salernitana,Serie A,5.4,9,5,6,3,0,6,8,75.0,2,10,7,3,2,11,20,0
Marco Pellegrino,ARG,DF,21,Salernitana,Serie A,6.1,8,6,4,3,1,5,10,50.0,5,11,6,5,10,18,28,0
Triantafyllos Pasaridīs,GRE,DF,27,Salernitana,Serie A,5.0,11,7,9,2,0,9,14,64.3,5,7,3,4,3,14,19,0
Vincenzo Fiorillo,ITA,GK,34,Salernitana,Serie A,4.0,0,0,0,0,0,0,0,0.0,0,0,0,0,0,0,0,1
Erik Botheim,NOR,"FW,MF",24,Salernitana,Serie A,3.5,2,0,2,0,0,0,1,0.0,1,3,0,3,0,2,2,0
Jérôme Boateng,GER,DF,35,Salernitana,Serie A,2.6,0,0,0,0,0,0,0,0.0,0,6,5,1,4,4,21,0
Emanuel Vignato,ITA,"MF,FW",23,Salernitana,Serie A,3.5,10,7,4,5,1,5,6,83.3,1,1,0,1,1,11,7,0
Iron Gomis,FRA,MF,24,Salernitana,Serie A,1.5,4,1,2,2,0,0,1,0.0,1,2,0,2,2,6,2,0
Trivante Stewart,JAM,"FW,MF",24,Salernitana,Serie A,1.1,0,0,0,0,0,0,0,0.0,0,1,0,1,0,0,0,0
Dylan Bronn,TUN,"DF,MF",28,Salernitana,Serie A,0.6,0,0,0,0,0,0,1,0.0,1,2,0,2,0,0,4,0
Andres Sfait,ROU,"DF,MF",19,Salernitana,Serie A,0.3,1,1,1,0,0,1,2,50.0,1,0,0,0,0,1,0,0
Gerardo Fusco,ITA,FW,19,Salernitana,Serie A,0.2,0,0,0,0,0,0,0,0.0,0,0,0,0,0,0,0,0
Mamadou Coulibaly,SEN,DF,25,Salernitana,Serie A,0.0,0,0,0,0,0,0,0,0.0,0,0,0,0,0,0,0,0
Wéverton,BRA,GK,35,Palmeiras,Brazilian League,35.0,0,0,0,0,0,0,1,0.0,1,1,0,1,1,1,10,1
Gustavo Gómez,PAR,DF,29,Palmeiras,Brazilian League,30.7,59,28,33,22,4,34,59,57.6,25,24,12,12,28,87,110,1
Zé Rafael,BRA,MF,29,Palmeiras,Brazilian League,28.5,81,51,35,41,5,42,112,37.5,70,31,5,26,23,104,23,0
Raphael Veiga,BRA,MF,27,Palmeiras,Brazilian League,27.3,27,13,10,12,5,10,28,35.7,18,12,0,12,7,34,17,0
Joaquín Piquerez,URU,DF,24,Palmeiras,Brazilian League,28.1,45,33,21,18,6,27,63,42.9,36,35,6,29,29,74,47,0
Mayke,BRA,"DF,FW",30,Palmeiras,Brazilian League,27.8,53,31,24,23,6,29,42,69.0,13,28,8,20,43,96,37,0
Murilo Cerqueira,BRA,DF,25,Palmeiras,Brazilian League,24.1,29,21,15,13,1,16,29,55.2,13,25,17,8,28,57,79,0
Artur,BRA,FW,24,Palmeiras,Brazilian League,21.1,19,10,10,6,3,10,36,27.8,26,22,0,22,7,26,14,0
Luan Garcia,BRA,DF,29,Palmeiras,Brazilian League,20.2,12,6,6,5,1,6,12,50.0,6,22,19,3,26,38,67,0
Gabriel Menino,BRA,MF,22,Palmeiras,Brazilian League,17.7,37,24,18,15,4,18,43,41.9,25,28,4,24,15,52,14,0
Richard Ríos,COL,MF,22,Palmeiras,Brazilian League,20.6,45,33,19,21,5,19,59,32.2,40,39,3,36,19,64,23,1
Rony,BRA,FW,27,Palmeiras,Brazilian League,18.2,9,8,3,5,1,2,10,20.0,8,8,1,7,2,11,12,0
Endrick,BRA,FW,16,Palmeiras,Brazilian League,17.3,14,6,3,7,4,1,11,9.1,10,8,1,7,1,15,5,0
Marcos Rocha,BRA,DF,34,Palmeiras,Brazilian League,14.0,38,24,19,14,5,15,31,48.4,16,14,3,11,8,46,23,0
Breno,BRA,FW,27,Palmeiras,Brazilian League,15.2,17,11,4,9,4,7,13,53.8,6,8,0,8,4,21,3,0
Dudu,BRA,FW,31,Palmeiras,Brazilian League,12.0,5,4,2,2,1,3,10,30.0,7,7,0,7,6,11,1,0
Vanderlan,BRA,DF,20,Palmeiras,Brazilian League,10.1,29,18,23,4,2,13,16,81.3,3,7,1,6,12,41,23,0
Jhonatan Jowjow,BRA,"MF,FW",20,Palmeiras,Brazilian League,9.9,19,15,8,6,5,5,17,29.4,12,19,3,16,9,28,11,0
José López,ARG,"FW,MF",22,Palmeiras,Brazilian League,6.6,9,4,1,4,4,1,10,10.0,9,5,1,4,4,13,13,0
Kaiky Naves,BRA,"DF,FW",20,Palmeiras,Brazilian League,5.8,14,9,6,8,0,11,16,68.8,5,10,6,4,4,18,17,0
Luis Guilherme,BRA,"FW,MF",16,Palmeiras,Brazilian League,6.4,3,1,0,0,3,1,10,10.0,9,4,0,4,6,9,2,0
Fabinho,BRA,MF,20,Palmeiras,Brazilian League,6.5,25,20,6,14,5,11,18,61.1,7,11,4,7,7,32,8,0
García,BRA,DF,21,Palmeiras,Brazilian League,3.3,4,1,3,1,0,1,2,50.0,1,3,0,3,3,7,7,0
Marcelo Lomba,BRA,GK,36,Palmeiras,Brazilian League,3.0,0,0,0,0,0,0,0,0.0,0,0,0,0,0,0,0,1
Kevin,BRA,"FW,DF",20,Palmeiras,Brazilian League,2.6,6,4,4,1,1,4,5,80.0,1,2,0,2,3,9,2,0
Jailson Siqueira,BRA,"MF,DF",27,Palmeiras,Brazilian League,1.8,4,3,1,2,1,2,5,40.0,3,1,0,1,2,6,3,0
Rafael Navarro,BRA,FW,22,Palmeiras,Brazilian League,1.4,0,0,0,0,0,0,0,0.0,0,4,0,4,1,1,1,0
Bruno Tabata,BRA,"MF,FW",25,Palmeiras,Brazilian League,1.4,1,1,0,1,0,0,3,0.0,3,0,0,0,0,1,2,0
Ian Custódio,BRA,DF,19,Palmeiras,Brazilian League,0.2,0,0,0,0,0,0,0,0.0,0,0,0,0,0,0,0,0
Giovani,BRA,FW,19,Palmeiras,Brazilian League,0.2,1,0,1,0,0,0,0,0.0,0,0,0,0,0,1,0,0
Estevão,BRA,DF,16,Palmeiras,Brazilian League,0.1,1,1,0,1,0,1,1,100.0,0,1,0,1,0,1,0,0
Eduard Atuesta,COL,MF,25,Palmeiras,Brazilian League,0.1,0,0,0,0,0,0,0,0.0,0,0,0,0,0,0,0,0
Kauan Santos,BRA,FW,18,Palmeiras,Brazilian League,0.0,0,0,0,0,0,0,0,0.0,0,0,0,0,0,0,0,0
Luis Suárez,URU,FW,36,Grêmio,Brazilian League,32.0,10,5,2,2,6,4,20,20.0,16,9,2,7,4,14,5,0
Gabriel Chapecó,BRA,GK,22,Grêmio,Brazilian League,31.0,1,0,1,0,0,1,3,33.3,2,0,0,0,1,2,9,2
Franco Cristaldo,ARG,"MF,FW",26,Grêmio,Brazilian League,23.7,33,18,13,15,5,17,52,32.7,35,31,0,31,12,45,7,0
Reinaldo,BRA,DF,33,Grêmio,Brazilian League,29.8,41,21,18,17,6,26,42,61.9,16,20,5,15,16,57,74,0
Mathías Villasanti,PAR,MF,26,Grêmio,Brazilian League,29.4,94,58,46,37,11,42,115,36.5,73,47,11,36,34,128,48,0
Walter Kannemann,ARG,DF,31,Grêmio,Brazilian League,26.2,50,33,30,18,2,27,52,51.9,25,36,16,20,45,95,116,0
Bruno Fabiano Alves,BRA,DF,31,Grêmio,Brazilian League,27.2,31,17,15,15,1,12,20,60.0,8,42,26,16,29,60,110,0
João Pedro,BRA,DF,26,Grêmio,Brazilian League,23.1,34,17,15,15,4,14,32,43.8,18,24,8,16,13,47,45,1
Felipe Carballo,URU,MF,26,Grêmio,Brazilian League,17.1,31,16,13,16,2,14,49,28.6,35,14,2,12,18,49,22,1
Bitelo,BRA,"MF,FW",23,Grêmio,Brazilian League,17.2,29,21,14,11,4,15,39,38.5,24,26,6,20,20,49,12,0
Bruno Uvini,BRA,DF,31,Grêmio,Brazilian League,16.1,16,11,11,4,1,10,19,52.6,9,28,19,9,22,38,67,0
João Pedro Pepê,BRA,MF,25,Grêmio,Brazilian League,15.5,41,31,24,15,2,16,34,47.1,18,15,6,9,16,57,26,0
Fábio,BRA,"DF,MF",32,Grêmio,Brazilian League,9.7,26,18,14,10,2,13,35,37.1,22,12,5,7,9,35,27,0
João Pedro,ITA,FW,30,Grêmio,Brazilian League,6.8,5,4,1,3,1,1,5,20.0,4,7,2,5,4,9,7,0
Everton,BRA,"FW,MF",25,Grêmio,Brazilian League,13.5,14,7,3,10,1,6,21,28.6,15,10,3,7,12,26,7,0
Rodrigo Ely,BRA,DF,29,Grêmio,Brazilian League,7.4,6,2,5,1,0,1,2,50.0,1,6,6,0,3,9,46,0
Vinícius,BRA,FW,31,Grêmio,Brazilian League,7.3,3,1,1,2,0,2,10,20.0,8,5,0,5,7,10,5,0
Nathan,BRA,"MF,FW",26,Grêmio,Brazilian League,7.6,11,6,4,3,4,3,10,30.0,7,15,2,13,8,19,6,0
Ferreira,BRA,"FW,MF",25,Grêmio,Brazilian League,12.7,18,13,9,9,0,8,27,29.6,19,8,0,8,7,25,9,0
Pedro Geromel,BRA,DF,37,Grêmio,Brazilian League,5.2,6,4,4,2,0,2,6,33.3,4,5,3,2,8,14,38,0
Gustavo Martins Santos,BRA,"DF,MF",20,Grêmio,Brazilian League,7.7,21,13,15,5,1,7,11,63.6,4,14,8,6,5,26,37,0
Cuiabano,BRA,"DF,MF",19,Grêmio,Brazilian League,5.4,15,7,8,6,1,3,9,33.3,6,7,2,5,11,26,16,0
Ronald,BRA,MF,19,Grêmio,Brazilian League,4.6,11,4,3,6,2,8,13,61.5,5,4,3,1,3,14,10,0
Lucas Besozzi,ARG,"FW,MF",20,Grêmio,Brazilian League,4.4,5,2,4,1,0,3,6,50.0,3,3,0,3,5,10,1,0
Diogo Barbosa,BRA,DF,30,Grêmio,Brazilian League,4.3,4,4,1,3,0,3,9,33.3,6,5,3,2,5,9,14,0
Caíque,BRA,GK,25,Grêmio,Brazilian League,4.0,0,0,0,0,0,0,0,0.0,0,0,0,0,0,0,0,1
Lucas Milla,BRA,MF,20,Grêmio,Brazilian League,3.4,10,4,3,6,1,5,14,35.7,9,10,4,6,4,14,6,0
Thomas Luciano,BRA,DF,21,Grêmio,Brazilian League,3.5,9,7,7,2,0,8,15,53.3,7,5,3,2,7,16,13,0
Lucas Silva,BRA,MF,29,Grêmio,Brazilian League,2.5,10,6,5,5,0,4,7,57.1,3,1,0,1,1,11,3,0
Nathan Fernandes,BRA,"FW,MF",17,Grêmio,Brazilian League,4.2,4,1,1,1,2,1,3,33.3,2,3,0,3,1,5,1,0
Adriel,BRA,GK,22,Grêmio,Brazilian League,2.0,0,0,0,0,0,0,0,0.0,0,0,0,0,0,0,0,0
Andre Martins,BRA,"FW,MF",21,Grêmio,Brazilian League,4.1,9,9,2,5,2,4,7,57.1,3,6,1,5,1,10,5,0
Zinho,BRA,"FW,MF",19,Grêmio,Brazilian League,2.7,2,2,1,0,1,0,8,0.0,8,1,0,1,1,3,1,0
Josué,BRA,MF,17,Grêmio,Brazilian League,1.3,2,0,1,1,0,0,1,0.0,1,3,1,2,6,8,5,0
Brenno,BRA,GK,23,Grêmio,Brazilian League,1.0,0,0,0,0,0,0,0,0.0,0,0,0,0,0,0,0,0
Wesley,BRA,DF,19,Grêmio,Brazilian League,1.0,3,2,2,1,0,2,3,66.7,1,0,0,0,1,4,0,1
Juan Iturbe,PAR,"FW,MF",29,Grêmio,Brazilian League,0.8,5,5,4,1,0,2,5,40.0,3,1,0,1,2,7,3,0
Luan Vieira,BRA,"FW,MF",29,Grêmio,Brazilian League,0.6,1,1,0,1,0,0,1,0.0,1,2,2,0,0,1,0,0
Darlan Mendes,BRA,MF,24,Grêmio,Brazilian League,0.5,2,1,2,0,0,0,4,0.0,4,0,0,0,0,2,1,0
Gustavinho,BRA,"FW,MF",21,Grêmio,Brazilian League,0.4,0,0,0,0,0,0,0,0.0,0,0,0,0,0,0,0,0
Freddy Noguera,PAR,FW,19,Grêmio,Brazilian League,0.3,0,0,0,0,0,0,0,0.0,0,0,0,0,0,0,0,0
Nata,BRA,"FW,DF",21,Grêmio,Brazilian League,0.2,0,0,0,0,0,0,0,0.0,0,0,0,0,0,0,1,0
Lian,BRA,MF,17,Grêmio,Brazilian League,0.1,0,0,0,0,0,0,0,0.0,0,0,0,0,0,0,0,0
João Araújo,BRA,MF,17,Grêmio,Brazilian League,0.1,2,1,1,0,1,2,2,100.0,0,0,0,0,0,2,0,0
Everson,BRA,GK,32,Atlético Mineiro,Brazilian League,36.0,0,0,0,0,0,0,0,0.0,0,1,0,1,1,1,18,0
Paulinho,BRA,"FW,MF",22,Atlético Mineiro,Brazilian League,33.2,43,31,14,24,5,18,37,48.6,19,25,1,24,16,59,17,0
Hulk,BRA,FW,36,Atlético Mineiro,Brazilian League,32.7,28,21,6,14,8,9,22,40.9,13,12,3,9,1,29,37,0
Jemerson,BRA,DF,30,Atlético Mineiro,Brazilian League,27.5,30,20,19,10,1,16,33,48.5,17,31,24,7,31,61,104,1
Guilherme Arana,BRA,DF,25,Atlético Mineiro,Brazilian League,26.5,42,29,25,16,1,15,25,60.0,10,31,10,21,32,74,56,0
Otávio,BRA,MF,28,Atlético Mineiro,Brazilian League,25.6,75,40,33,35,7,34,84,40.5,50,41,16,25,27,102,34,0
Mauricio Lemos,URU,DF,27,Atlético Mineiro,Brazilian League,24.6,41,29,30,9,2,27,35,77.1,8,31,25,6,41,82,120,0
Federico Zaracho,ARG,"MF,FW",24,Atlético Mineiro,Brazilian League,21.6,71,42,27,37,7,27,92,29.3,65,29,4,25,31,102,22,0
Cristian Pavón,ARG,"FW,MF",27,Atlético Mineiro,Brazilian League,21.5,33,28,13,11,9,17,58,29.3,41,23,0,23,19,52,9,0
Renzo Saravia,ARG,DF,29,Atlético Mineiro,Brazilian League,19.0,61,39,29,25,7,38,74,51.4,36,35,7,28,17,78,48,0
Rodrigo Battaglia,ARG,MF,31,Atlético Mineiro,Brazilian League,19.2,39,29,15,22,2,20,37,54.1,17,22,9,13,12,51,22,1
Mariano,BRA,DF,36,Atlético Mineiro,Brazilian League,17.4,48,31,30,16,2,34,50,68.0,16,11,4,7,20,68,33,1
Igor Gomes,BRA,"MF,FW",23,Atlético Mineiro,Brazilian League,15.3,20,14,12,6,2,14,29,48.3,15,17,4,13,11,31,9,0
Edenílson,BRA,"MF,FW",33,Atlético Mineiro,Brazilian League,15.2,21,12,11,7,3,15,26,57.7,11,20,2,18,18,39,22,1
Rubens,BRA,"DF,MF",21,Atlético Mineiro,Brazilian League,15.0,81,49,47,22,12,30,55,54.5,25,16,3,13,19,100,58,0
Bruno Fuchs,BRA,DF,23,Atlético Mineiro,Brazilian League,12.1,13,6,11,2,0,4,8,50.0,4,11,5,6,16,29,53,0
Hyoran,BRA,"MF,FW",29,Atlético Mineiro,Brazilian League,7.7,15,8,5,6,4,9,26,34.6,17,13,2,11,3,18,6,0
Alan Franco,ECU,"MF,FW",24,Atlético Mineiro,Brazilian League,9.3,26,14,11,10,5,8,18,44.4,10,12,4,8,15,41,9,0
Igor Rabello,BRA,DF,27,Atlético Mineiro,Brazilian League,7.7,17,12,13,4,0,11,23,47.8,12,12,8,4,9,26,40,0
Pedrinho,BRA,"MF,FW",24,Atlético Mineiro,Brazilian League,7.0,13,5,4,7,2,4,5,80.0,1,6,0,6,1,14,2,0
Eduardo Vargas,CHI,FW,33,Atlético Mineiro,Brazilian League,5.2,3,1,1,2,0,3,12,25.0,9,4,0,4,0,3,1,0
Nathan Silva,BRA,DF,25,Atlético Mineiro,Brazilian League,4.0,3,2,3,0,0,2,2,100.0,0,3,2,1,0,3,14,0
Patrick,BRA,"MF,FW",30,Atlético Mineiro,Brazilian League,6.2,28,19,9,10,9,11,26,42.3,15,11,1,10,6,34,9,0
Alan Kardec,BRA,"FW,MF",34,Atlético Mineiro,Brazilian League,2.9,0,0,0,0,0,0,0,0.0,0,1,0,1,1,1,1,0
Matheus Mendes,BRA,GK,23,Atlético Mineiro,Brazilian League,2.0,0,0,0,0,0,0,0,0.0,0,0,0,0,0,0,2,0
Réver,BRA,"DF,FW",38,Atlético Mineiro,Brazilian League,1.3,0,0,0,0,0,0,0,0.0,0,2,2,0,1,1,11,0
Dodô,BRA,DF,30,Atlético Mineiro,Brazilian League,0.7,0,0,0,0,0,0,0,0.0,0,1,0,1,1,1,0,0
Alisson,BRA,"MF,DF",17,Atlético Mineiro,Brazilian League,0.5,2,2,0,1,1,0,0,0.0,0,1,0,1,0,2,1,0
Isaac,BRA,FW,18,Atlético Mineiro,Brazilian League,0.2,1,1,0,0,1,1,1,100.0,0,0,0,0,0,1,0,0
Paulo Vitor,BRA,MF,18,Atlético Mineiro,Brazilian League,0.2,0,0,0,0,0,0,2,0.0,2,0,0,0,1,1,0,0
Carlos Eduardo,BRA,"MF,FW",18,Atlético Mineiro,Brazilian League,0.1,1,1,0,1,0,0,0,0.0,0,0,0,0,0,1,0,0
Fabrício Bruno,BRA,DF,26,Flamengo,Brazilian League,34.0,48,28,29,18,1,27,35,77.1,8,40,26,14,25,73,148,1
Léo Pereira,BRA,DF,27,Flamengo,Brazilian League,29.4,46,29,21,24,1,30,52,57.7,22,45,30,15,29,75,85,1
Gerson,BRA,MF,25,Flamengo,Brazilian League,29.9,40,22,19,16,5,17,46,37.0,29,27,7,20,15,55,30,0
Ayrton Lucas,BRA,DF,25,Flamengo,Brazilian League,28.8,62,45,31,21,10,37,68,54.4,31,21,5,16,14,76,52,0
Wesley,BRA,DF,19,Flamengo,Brazilian League,27.9,74,48,42,26,6,32,69,46.4,37,24,10,14,40,114,64,1
Pedro,BRA,FW,25,Flamengo,Brazilian League,23.9,18,13,2,10,6,4,14,28.6,10,17,0,17,8,26,15,0
Thiago Maia,BRA,MF,25,Flamengo,Brazilian League,23.3,49,31,21,24,4,27,61,44.3,34,23,12,11,29,78,38,1
Erick Pulgar,CHI,MF,29,Flamengo,Brazilian League,22.2,42,26,14,25,3,23,66,34.8,43,29,10,19,25,67,30,1
Giorgian De Arrascaeta,URU,"MF,FW",28,Flamengo,Brazilian League,20.5,36,24,10,18,8,12,34,35.3,22,12,1,11,7,43,14,0
Everton Soares,BRA,"FW,MF",26,Flamengo,Brazilian League,19.3,32,22,8,10,14,12,33,36.4,21,26,6,20,11,43,11,0
Matheus Cunha,BRA,GK,21,Flamengo,Brazilian League,17.6,0,0,0,0,0,0,0,0.0,0,1,0,1,0,0,10,3
Gabriel Barbosa,BRA,FW,26,Flamengo,Brazilian League,17.1,3,1,1,1,1,1,15,6.7,14,1,0,1,2,5,0,0
Everton Ribeiro,BRA,"FW,MF",33,Flamengo,Brazilian League,16.4,21,12,8,10,3,10,39,25.6,29,9,3,6,11,32,5,0
Agustín Rossi,ARG,GK,27,Flamengo,Brazilian League,15.0,0,0,0,0,0,0,0,0.0,0,0,0,0,0,0,3,0
Bruno Henrique,BRA,"FW,MF",32,Flamengo,Brazilian League,17.1,31,21,11,10,10,13,28,46.4,15,21,3,18,3,34,21,0
Victor Hugo,BRA,"MF,FW",18,Flamengo,Brazilian League,14.2,31,19,5,22,4,16,36,44.4,20,11,1,10,13,44,9,0
David Luiz,BRA,DF,35,Flamengo,Brazilian League,11.0,13,9,8,4,1,6,12,50.0,6,13,11,2,10,23,56,0
Luiz Araújo,BRA,"FW,MF",26,Flamengo,Brazilian League,8.7,19,16,8,6,5,7,19,36.8,12,13,1,12,7,26,10,0
Matheuzinho,BRA,DF,22,Flamengo,Brazilian League,6.9,20,9,12,6,2,12,20,60.0,8,12,4,8,7,27,15,0
Filipe Luís,BRA,DF,37,Flamengo,Brazilian League,5.9,18,9,11,6,1,8,9,88.9,1,5,3,2,11,29,13,0
Santos,BRA,GK,32,Flamengo,Brazilian League,5.4,0,0,0,0,0,0,0,0.0,0,0,0,0,0,0,3,2
Matheus França,BRA,"MF,FW",18,Flamengo,Brazilian League,4.1,7,6,2,2,3,1,8,12.5,7,6,0,6,5,12,2,0
Allan,BRA,MF,25,Flamengo,Brazilian League,5.4,10,5,4,5,1,3,16,18.8,13,5,1,4,9,19,4,0
Pablo,BRA,DF,31,Flamengo,Brazilian League,4.7,4,3,4,0,0,0,0,0.0,0,3,1,2,7,11,35,1
Guillermo Varela,URU,DF,29,Flamengo,Brazilian League,2.6,1,1,1,0,0,0,0,0.0,0,3,1,2,5,6,5,0
Arturo Vidal,CHI,"MF,DF",35,Flamengo,Brazilian League,2.8,5,5,3,2,0,5,12,41.7,7,2,1,1,2,7,5,0
Marinho,BRA,"FW,DF",32,Flamengo,Brazilian League,0.9,2,2,0,1,1,0,3,0.0,3,2,1,1,0,2,0,0
Igor,BRA,MF,19,Flamengo,Brazilian League,0.9,2,1,0,2,0,1,4,25.0,3,0,0,0,3,5,0,0
Rodrigo Caio,BRA,"MF,DF",29,Flamengo,Brazilian League,0.7,3,2,2,1,0,2,2,100.0,0,1,1,0,0,3,0,0
Pedrinho,BRA,FW,19,Flamengo,Brazilian League,0.2,0,0,0,0,0,0,0,0.0,0,0,0,0,1,1,1,0
Matheus Gonçalves,BRA,"FW,MF",17,Flamengo,Brazilian League,0.2,0,0,0,0,0,0,2,0.0,2,1,0,1,0,0,0,0
André Inácio,BRA,FW,20,Flamengo,Brazilian League,0.2,2,2,2,0,0,2,3,66.7,1,0,0,0,0,2,1,0
Lucas Perri,BRA,GK,25,Botafogo (RJ),Brazilian League,37.5,0,0,0,0,0,0,1,0.0,1,0,0,0,0,0,19,3
Víctor Cuesta,ARG,DF,34,Botafogo (RJ),Brazilian League,35.0,46,31,22,19,5,22,36,61.1,14,37,26,11,58,104,123,1
Adryelson,BRA,DF,24,Botafogo (RJ),Brazilian League,33.3,34,20,23,10,1,17,26,65.4,9,43,30,13,61,95,202,2
Marlon Freitas,BRA,MF,27,Botafogo (RJ),Brazilian League,32.3,41,30,22,18,1,20,49,40.8,29,42,12,30,40,81,60,0
Carlos Eduardo,BRA,MF,33,Botafogo (RJ),Brazilian League,29.7,18,11,4,13,1,9,28,32.1,19,12,0,12,13,31,19,0
Tchê Tchê,BRA,"MF,DF",30,Botafogo (RJ),Brazilian League,29.5,32,19,14,15,3,12,33,36.4,21,16,3,13,13,45,25,0
Tiquinho Soares,BRA,FW,32,Botafogo (RJ),Brazilian League,27.1,18,10,3,8,7,9,19,47.4,10,15,3,12,3,21,29,0
Júnior Santos,BRA,FW,28,Botafogo (RJ),Brazilian League,24.0,37,24,16,13,8,18,33,54.5,15,33,5,28,12,49,21,1
João Victor Santos Sá,BRA,FW,28,Botafogo (RJ),Brazilian League,23.6,62,37,19,33,10,30,66,45.5,36,28,6,22,30,92,17,0
Leonel Di Plácido,ARG,DF,29,Botafogo (RJ),Brazilian League,26.2,79,51,46,28,5,54,119,45.4,65,41,7,34,48,127,56,0
Fernando Marçal,BRA,DF,33,Botafogo (RJ),Brazilian League,18.1,37,16,17,16,4,16,34,47.1,18,17,3,14,38,75,48,0
Hugo,BRA,DF,21,Botafogo (RJ),Brazilian League,15.5,56,31,33,18,5,27,51,52.9,24,11,1,10,24,80,37,0
Luis Henrique,BRA,"FW,MF",21,Botafogo (RJ),Brazilian League,15.3,5,3,2,2,1,2,8,25.0,6,17,0,17,4,9,9,0
Danilo Barbosa,BRA,"MF,DF",26,Botafogo (RJ),Brazilian League,11.2,18,9,10,5,3,5,12,41.7,7,16,7,9,16,34,37,0
Gabriel,BRA,MF,29,Botafogo (RJ),Brazilian League,9.6,33,20,14,19,0,16,37,43.2,21,9,1,8,16,49,12,0
Rafael,BRA,DF,32,Botafogo (RJ),Brazilian League,5.4,25,12,11,12,2,15,28,53.6,13,9,2,7,4,29,18,0
Lucas Fernandes,BRA,MF,25,Botafogo (RJ),Brazilian League,5.3,1,1,1,0,0,1,5,20.0,4,5,2,3,3,4,8,0
Philipe Sampaio,BRA,DF,28,Botafogo (RJ),Brazilian League,5.5,10,7,7,3,0,5,7,71.4,2,3,2,1,6,16,33,0
Gustavo Sauer,BRA,"FW,MF",29,Botafogo (RJ),Brazilian League,2.9,6,4,2,1,3,4,11,36.4,7,2,1,1,3,9,1,0
Diego Costa,ESP,FW,34,Botafogo (RJ),Brazilian League,5.7,7,5,2,3,2,0,1,0.0,1,4,0,4,3,10,4,0
Matias Segovia,PAR,FW,20,Botafogo (RJ),Brazilian League,7.2,22,18,11,11,0,16,33,48.5,17,4,1,3,8,30,7,0
Janderson,BRA,"FW,MF",23,Botafogo (RJ),Brazilian League,4.6,8,5,2,3,3,2,5,40.0,3,3,0,3,2,10,3,0
JP Galvão,BRA,DF,21,Botafogo (RJ),Brazilian League,2.2,8,5,5,3,0,6,11,54.5,5,3,1,2,3,11,9,0
Bastos,ANG,DF,31,Botafogo (RJ),Brazilian League,1.3,4,2,1,2,1,2,3,66.7,1,4,1,3,0,4,4,0
Carlos Alberto,BRA,"FW,MF",20,Botafogo (RJ),Brazilian League,3.3,3,0,1,1,1,2,5,40.0,3,5,2,3,1,4,4,0
Matheus Nascimento,BRA,"FW,MF",18,Botafogo (RJ),Brazilian League,1.1,1,1,0,1,0,0,0,0.0,0,2,0,2,0,1,0,0
Luis Segovia,ECU,DF,25,Botafogo (RJ),Brazilian League,1.1,0,0,0,0,0,0,0,0.0,0,0,0,0,0,0,6,0
Daniel Borges,BRA,DF,29,Botafogo (RJ),Brazilian League,0.5,3,2,3,0,0,2,4,50.0,2,2,0,2,1,4,3,0
Gatito Fernández,PAR,GK,34,Botafogo (RJ),Brazilian League,0.5,0,0,0,0,0,0,0,0.0,0,0,0,0,0,0,1,0
Diego Hernández,URU,FW,22,Botafogo (RJ),Brazilian League,0.5,2,1,0,1,1,1,6,16.7,5,0,0,0,0,2,0,0
Kayque,BRA,MF,22,Botafogo (RJ),Brazilian League,0.3,1,1,0,0,1,0,0,0.0,0,0,0,0,1,2,0,0
Mateo Ponte,URU,DF,19,Botafogo (RJ),Brazilian League,0.2,1,0,0,1,0,1,1,100.0,0,1,0,1,1,2,0,0
Lucas Piazon,BRA,FW,29,Botafogo (RJ),Brazilian League,0.2,0,0,0,0,0,0,0,0.0,0,0,0,0,0,0,0,0
Breno,BRA,MF,22,Botafogo (RJ),Brazilian League,0.1,0,0,0,0,0,0,0,0.0,0,1,0,1,0,0,0,0
Newton,BRA,MF,22,Botafogo (RJ),Brazilian League,0.1,0,0,0,0,0,0,1,0.0,1,0,0,0,0,0,0,0
Rai,BRA,MF,20,Botafogo (RJ),Brazilian League,0.0,0,0,0,0,0,0,0,0.0,0,0,0,0,0,0,0,0
Cleiton Schwengber,BRA,GK,25,Red Bull Bragantino,Brazilian League,33.0,0,0,0,0,0,0,1,0.0,1,0,0,0,2,2,19,2
Juninho Capixaba,BRA,DF,25,Red Bull Bragantino,Brazilian League,31.9,69,54,25,28,16,35,88,39.8,53,45,12,33,79,148,85,3
Lucas Evangelista,BRA,MF,27,Red Bull Bragantino,Brazilian League,30.2,51,28,20,22,9,15,46,32.6,31,31,6,25,26,77,20,0
Matheus Fernandes,BRA,MF,24,Red Bull Bragantino,Brazilian League,26.0,106,63,40,52,14,45,93,48.4,48,36,10,26,32,138,23,1
Eduardo Sasha,BRA,"FW,MF",30,Red Bull Bragantino,Brazilian League,24.8,15,5,1,11,3,4,12,33.3,8,8,2,6,10,25,15,0
Vitinho,BRA,"FW,MF",23,Red Bull Bragantino,Brazilian League,22.8,35,21,12,18,5,10,43,23.3,33,28,1,27,11,46,10,0
Jadsom,BRA,MF,21,Red Bull Bragantino,Brazilian League,21.1,41,21,11,24,6,19,43,44.2,24,37,7,30,27,68,25,0
Helinho,BRA,FW,22,Red Bull Bragantino,Brazilian League,15.4,24,16,8,11,5,8,19,42.1,11,18,0,18,8,32,11,0
Leonardo Realpe,ECU,DF,21,Red Bull Bragantino,Brazilian League,18.7,24,10,16,7,1,13,25,52.0,12,10,7,3,25,49,69,0
Leo Ortiz,BRA,DF,27,Red Bull Bragantino,Brazilian League,17.8,18,11,13,5,0,9,15,60.0,6,21,18,3,30,48,75,1
José Hurtado,ECU,DF,21,Red Bull Bragantino,Brazilian League,18.0,36,26,16,17,3,25,47,53.2,22,19,6,13,21,57,34,0
Aderlan Silva,BRA,DF,32,Red Bull Bragantino,Brazilian League,15.8,54,31,30,21,3,31,70,44.3,39,21,2,19,26,80,26,0
Eric Ramires,BRA,MF,22,Red Bull Bragantino,Brazilian League,15.3,18,10,3,12,3,9,35,25.7,26,27,1,26,12,30,7,0
Luan Patrick,BRA,DF,21,Red Bull Bragantino,Brazilian League,12.4,9,6,5,4,0,5,12,41.7,7,12,10,2,17,26,33,1
Luan Cândido,BRA,DF,21,Red Bull Bragantino,Brazilian League,12.0,19,12,12,5,2,7,13,53.8,6,24,8,16,13,32,45,0
Eduardo Santos,BRA,DF,25,Red Bull Bragantino,Brazilian League,11.3,15,9,10,4,1,10,13,76.9,3,19,15,4,14,29,51,1
Thiago Borbas,URU,FW,20,Red Bull Bragantino,Brazilian League,15.9,13,9,3,7,3,3,15,20.0,12,14,0,14,2,15,8,0
Henry Mosquera,COL,"FW,MF",21,Red Bull Bragantino,Brazilian League,11.8,16,11,6,7,3,9,15,60.0,6,13,4,9,1,17,3,0
Natan,BRA,DF,21,Red Bull Bragantino,Brazilian League,9.3,6,5,5,1,0,4,7,57.1,3,15,10,5,9,15,30,1
Bruninho,BRA,"FW,MF",19,Red Bull Bragantino,Brazilian League,7.9,4,4,0,2,2,2,12,16.7,10,11,0,11,2,6,2,0
Marcos Vinicios Sorriso,BRA,"FW,DF",21,Red Bull Bragantino,Brazilian League,10.4,22,15,5,11,6,5,13,38.5,8,18,0,18,8,30,6,0
Lucão,BRA,GK,21,Red Bull Bragantino,Brazilian League,5.0,0,0,0,0,0,0,0,0.0,0,0,0,0,0,0,5,0
Gustavinho,BRA,"MF,FW",18,Red Bull Bragantino,Brazilian League,7.4,13,5,5,1,7,6,23,26.1,17,8,2,6,7,20,5,0
Matheus Gonçalves,BRA,"FW,MF",17,Red Bull Bragantino,Brazilian League,5.1,7,3,2,1,4,6,11,54.5,5,6,0,6,0,7,2,0
Alerrandro,BRA,"FW,MF",23,Red Bull Bragantino,Brazilian League,4.5,2,2,1,1,0,0,1,0.0,1,3,0,3,0,2,6,0
Lucão,BRA,DF,24,Red Bull Bragantino,Brazilian League,2.2,3,1,3,0,0,1,1,100.0,0,0,0,0,5,8,6,0
Guilherme,BRA,"DF,MF",20,Red Bull Bragantino,Brazilian League,2.9,7,4,3,2,2,4,4,100.0,0,4,1,3,3,10,11,0
Ignacio Laquintana,URU,FW,23,Red Bull Bragantino,Brazilian League,2.0,4,3,0,3,1,0,1,0.0,1,1,0,1,1,5,0,0
Talisson,BRA,FW,20,Red Bull Bragantino,Brazilian League,1.7,4,1,2,1,1,2,2,100.0,0,2,1,1,2,6,2,0
Raul,BRA,"MF,DF",26,Red Bull Bragantino,Brazilian League,1.2,3,0,2,0,1,2,3,66.7,1,2,1,1,1,4,2,0
Yani Quintero,COL,MF,20,Red Bull Bragantino,Brazilian League,1.1,5,4,2,3,0,1,2,50.0,1,3,0,3,1,6,0,0
Cipriano,BRA,DF,20,Red Bull Bragantino,Brazilian League,0.8,1,1,1,0,0,1,1,100.0,0,0,0,0,2,3,11,0
Lucas Cunha,BRA,DF,26,Red Bull Bragantino,Brazilian League,0.8,0,0,0,0,0,0,1,0.0,1,1,1,0,1,1,1,1
Nathan Camargo,BRA,MF,17,Red Bull Bragantino,Brazilian League,0.1,1,1,1,0,0,1,1,100.0,0,0,0,0,0,1,0,0
Bruno Praxedes,BRA,MF,20,Red Bull Bragantino,Brazilian League,0.1,0,0,0,0,0,0,0,0.0,0,0,0,0,0,0,0,0
Fábio,BRA,GK,42,Fluminense,Brazilian League,35.0,0,0,0,0,0,0,1,0.0,1,0,0,0,0,0,15,2
André,BRA,"MF,DF",21,Fluminense,Brazilian League,29.4,57,37,28,26,3,27,50,54.0,23,27,14,13,31,88,36,2
Germán Cano,ARG,FW,34,Fluminense,Brazilian League,27.4,14,9,1,12,1,7,24,29.2,17,15,6,9,6,20,11,2
Lima,BRA,"MF,FW",26,Fluminense,Brazilian League,28.1,38,20,9,24,5,16,50,32.0,34,31,9,22,21,59,22,0
Jhon Arias,COL,"FW,MF",25,Fluminense,Brazilian League,26.5,54,31,25,21,8,25,60,41.7,35,47,2,45,9,63,18,1
Nino,BRA,DF,25,Fluminense,Brazilian League,23.9,11,6,10,1,0,5,8,62.5,3,18,14,4,22,33,96,2
Samuel Xavier,BRA,DF,32,Fluminense,Brazilian League,23.4,29,18,12,11,6,20,30,66.7,10,27,12,15,16,45,32,0
Ganso,BRA,MF,33,Fluminense,Brazilian League,19.3,22,17,9,8,5,11,28,39.3,17,13,3,10,6,28,5,0
Martinelli,BRA,"MF,DF",21,Fluminense,Brazilian League,20.9,31,24,12,12,7,15,26,57.7,11,35,18,17,13,44,27,0
Keno,BRA,"FW,MF",33,Fluminense,Brazilian League,17.9,31,15,11,14,6,16,31,51.6,15,11,1,10,10,41,18,0
Marcelo,BRA,DF,34,Fluminense,Brazilian League,14.7,26,19,7,12,7,15,29,51.7,14,13,4,9,12,38,17,1
Felipe Melo,BRA,DF,39,Fluminense,Brazilian League,11.0,12,10,4,7,1,5,11,45.5,6,12,7,5,8,20,44,0
Guga,BRA,DF,24,Fluminense,Brazilian League,16.8,36,21,21,13,2,22,40,55.0,18,16,8,8,14,50,38,0
John Kennedy,BRA,"FW,MF",20,Fluminense,Brazilian League,15.2,15,9,5,7,3,9,19,47.4,10,12,1,11,3,18,10,0
Alexsander,BRA,"MF,DF",19,Fluminense,Brazilian League,13.3,34,19,15,15,4,16,34,47.1,18,20,3,17,10,44,12,0
Marlon,BRA,DF,27,Fluminense,Brazilian League,10.4,11,5,7,3,1,8,10,80.0,2,12,9,3,9,20,30,0
Diogo Barbosa,BRA,DF,30,Fluminense,Brazilian League,12.4,16,11,7,7,2,8,20,40.0,12,5,1,4,10,26,28,0
David Braz,BRA,DF,35,Fluminense,Brazilian League,9.6,11,8,5,4,2,6,10,60.0,4,11,6,5,8,19,50,1
Thiago dos Santos,BRA,"DF,MF",33,Fluminense,Brazilian League,9.1,17,14,12,5,0,10,19,52.6,9,14,8,6,16,33,34,0
Lelê,BRA,"FW,MF",25,Fluminense,Brazilian League,12.7,16,11,7,6,3,3,8,37.5,5,14,1,13,3,19,8,0
Leonardo Fernández,URU,"MF,FW",24,Fluminense,Brazilian League,7.3,11,5,3,5,3,4,15,26.7,11,10,1,9,4,15,3,0
Danielzinho,BRA,MF,27,Fluminense,Brazilian League,6.8,17,9,9,6,2,11,17,64.7,6,9,4,5,9,26,6,0
Yony González,COL,"FW,MF",28,Fluminense,Brazilian League,6.4,9,5,5,2,2,6,7,85.7,1,8,4,4,2,11,12,0
Gabriel Pirani,BRA,"MF,FW",20,Fluminense,Brazilian League,4.4,8,5,4,1,3,2,6,33.3,4,6,2,4,2,10,5,0
Manoel,BRA,DF,32,Fluminense,Brazilian League,3.2,4,3,2,2,0,4,5,80.0,1,5,4,1,2,6,14,0
Pedro Rangel,BRA,GK,22,Fluminense,Brazilian League,2.0,0,0,0,0,0,0,0,0.0,0,0,0,0,0,0,1,0
Felipe Vieira,BRA,DF,22,Fluminense,Brazilian League,2.3,3,1,2,1,0,2,2,100.0,0,2,1,1,4,7,7,0
Vitor Mendes,BRA,DF,23,Fluminense,Brazilian League,1.2,0,0,0,0,0,0,1,0.0,1,1,1,0,1,1,13,0
Giovanni,BRA,"MF,DF",21,Fluminense,Brazilian League,1.1,0,0,0,0,0,0,2,0.0,2,1,1,0,1,1,0,0
Vitor Eudes,BRA,GK,24,Fluminense,Brazilian League,1.0,0,0,0,0,0,0,0,0.0,0,0,0,0,0,0,0,0
Justen,BRA,DF,19,Fluminense,Brazilian League,0.6,2,1,2,0,0,1,2,50.0,1,1,0,1,2,4,4,0
Alan Carvalho,CHN,MF,33,Fluminense,Brazilian League,0.5,0,0,0,0,0,0,1,0.0,1,2,0,2,0,0,1,0
Isaac,BRA,"MF,DF",18,Fluminense,Brazilian League,1.5,8,4,4,0,4,3,5,60.0,2,2,0,2,3,11,2,0
João Neto,BRA,"MF,DF",19,Fluminense,Brazilian League,0.6,1,1,0,0,1,1,1,100.0,0,0,0,0,0,1,1,0
Arthur,BRA,"DF,FW",18,Fluminense,Brazilian League,0.2,2,1,1,0,1,2,2,100.0,0,0,0,0,0,2,0,0
Alexandre Jesus,BRA,DF,21,Fluminense,Brazilian League,0.1,0,0,0,0,0,0,1,0.0,1,0,0,0,1,1,1,0
Rafael Monteiro,BRA,MF,18,Fluminense,Brazilian League,0.0,0,0,0,0,0,0,0,0.0,0,0,0,0,0,0,0,0
Bento,BRA,GK,23,Ath Paranaense,Brazilian League,33.0,0,0,0,0,0,0,2,0.0,2,0,0,0,1,1,18,1
Thiago Heleno,BRA,DF,34,Ath Paranaense,Brazilian League,30.9,41,26,28,12,1,27,39,69.2,12,35,19,16,41,82,138,1
Erick,BRA,MF,25,Ath Paranaense,Brazilian League,27.8,48,27,18,26,4,21,44,47.7,23,33,12,21,42,90,32,0
Vitor Bueno,BRA,"MF,FW",28,Ath Paranaense,Brazilian League,23.1,16,7,6,7,3,5,18,27.8,13,16,2,14,6,22,1,0
Fernandinho,BRA,MF,37,Ath Paranaense,Brazilian League,21.5,26,15,10,13,3,16,33,48.5,17,19,7,12,16,42,27,0
Agustín Canobbio,URU,"FW,MF",24,Ath Paranaense,Brazilian League,23.5,59,39,19,24,16,30,65,46.2,35,48,3,45,8,67,18,0
Tomás Cuello,ARG,"MF,FW",22,Ath Paranaense,Brazilian League,22.8,54,25,22,27,5,29,51,56.9,22,19,2,17,37,91,29,1
Vitor Roque,BRA,FW,17,Ath Paranaense,Brazilian League,19.0,19,10,8,8,3,7,18,38.9,11,12,2,10,2,21,2,0
Cacá,BRA,DF,23,Ath Paranaense,Brazilian League,18.8,27,16,23,4,0,16,25,64.0,9,23,15,8,18,45,69,1
Lucas Esquivel,ARG,DF,21,Ath Paranaense,Brazilian League,18.3,34,27,15,14,5,13,27,48.1,14,27,7,20,22,56,50,0
Hugo Moura,BRA,MF,25,Ath Paranaense,Brazilian League,14.7,41,19,21,19,1,14,45,31.1,31,31,4,27,19,60,27,0
Pablo,BRA,FW,30,Ath Paranaense,Brazilian League,15.5,18,10,4,11,3,7,16,43.8,9,11,1,10,8,26,19,0
Christian,BRA,"MF,FW",22,Ath Paranaense,Brazilian League,15.1,23,13,5,15,3,8,19,42.1,11,15,1,14,10,33,9,1
Mádson,BRA,"DF,MF",31,Ath Paranaense,Brazilian League,14.8,12,4,5,7,0,5,9,55.6,4,12,5,7,11,23,41,0
Bruno Zapelli,ARG,"MF,FW",20,Ath Paranaense,Brazilian League,12.7,16,7,6,8,2,13,22,59.1,9,17,1,16,7,23,3,0
Khellven,BRA,DF,21,Ath Paranaense,Brazilian League,11.1,14,11,6,8,0,11,21,52.4,10,9,5,4,16,30,29,0
Zé Ivaldo,BRA,DF,25,Ath Paranaense,Brazilian League,11.3,17,13,13,4,0,10,14,71.4,4,7,5,2,16,33,45,0
Pedro Henrique,BRA,DF,27,Ath Paranaense,Brazilian League,9.5,8,5,6,2,0,1,6,16.7,5,21,14,7,12,20,30,0
Alex Santana,BRA,MF,27,Ath Paranaense,Brazilian League,11.1,15,11,5,7,3,9,19,47.4,10,10,7,3,11,26,8,0
Kaique Rocha,BRA,DF,21,Ath Paranaense,Brazilian League,7.2,6,3,3,2,1,3,4,75.0,1,8,3,5,13,19,46,0
Matheus Felipe,BRA,DF,24,Ath Paranaense,Brazilian League,5.9,5,3,5,0,0,2,6,33.3,4,10,5,5,6,11,22,0
Willian,BRA,"FW,MF",36,Ath Paranaense,Brazilian League,6.4,9,7,0,7,2,2,8,25.0,6,3,0,3,1,10,0,0
Fernando,BRA,DF,23,Ath Paranaense,Brazilian League,5.3,11,9,7,3,1,7,9,77.8,2,1,0,1,8,19,10,0
Arturo Vidal,CHI,MF,35,Ath Paranaense,Brazilian League,4.2,11,8,3,6,2,2,7,28.6,5,2,1,1,6,17,4,0
Rômulo,BRA,"FW,MF",20,Ath Paranaense,Brazilian League,5.7,15,8,5,8,2,5,16,31.3,11,5,0,5,5,20,8,0
Leonardo Linck,BRA,GK,21,Ath Paranaense,Brazilian League,5.0,0,0,0,0,0,0,0,0.0,0,0,0,0,0,0,2,1
David Terans,URU,"MF,FW",28,Ath Paranaense,Brazilian League,4.4,3,1,0,2,1,1,5,20.0,4,4,0,4,1,4,0,0
Vinicius Kaue,BRA,"DF,MF",19,Ath Paranaense,Brazilian League,3.8,7,2,4,3,0,4,8,50.0,4,6,1,5,3,10,12,0
Pedrinho,BRA,"DF,MF",20,Ath Paranaense,Brazilian League,4.0,6,4,1,5,0,3,8,37.5,5,10,0,10,9,15,10,0
Léo Cittadini,BRA,"MF,FW",28,Ath Paranaense,Brazilian League,2.2,4,4,2,1,1,2,5,40.0,3,1,1,0,2,6,2,0
Thiago,BRA,"FW,MF",22,Ath Paranaense,Brazilian League,2.5,5,3,3,2,0,3,7,42.9,4,1,0,1,1,6,0,0
Luciano Arriagada,CHI,"FW,MF",20,Ath Paranaense,Brazilian League,2.1,2,1,1,0,1,2,4,50.0,2,0,0,0,0,2,1,0
Bruno Peres,BRA,"DF,MF",32,Ath Paranaense,Brazilian League,1.7,3,1,2,1,0,2,3,66.7,1,1,1,0,0,3,4,0
Marcelo Cirino,BRA,"FW,MF",31,Ath Paranaense,Brazilian League,1.1,2,0,0,2,0,0,1,0.0,1,2,1,1,0,2,0,0
Lucas Belezi,BRA,DF,19,Ath Paranaense,Brazilian League,0.5,1,1,1,0,0,1,1,100.0,0,2,1,1,0,1,0,0
Reinaldo,BRA,FW,21,Ath Paranaense,Brazilian League,0.2,1,1,0,1,0,0,0,0.0,0,0,0,0,0,1,0,0
Chiqueti,BRA,MF,17,Ath Paranaense,Brazilian League,0.2,0,0,0,0,0,0,0,0.0,0,0,0,0,0,0,1,0
Danielzinho,BRA,FW,20,Ath Paranaense,Brazilian League,0.0,0,0,0,0,0,0,0,0.0,0,0,0,0,0,0,0,0
Dudu,BRA,MF,17,Ath Paranaense,Brazilian League,0.0,0,0,0,0,0,0,0,0.0,0,0,0,0,0,0,0,0
Bryan García,ECU,MF,22,Ath Paranaense,Brazilian League,0.0,0,0,0,0,0,0,0,0.0,0,0,0,0,0,0,0,0
Fabricio Bustos,ARG,DF,26,Internacional,Brazilian League,27.8,68,48,38,19,11,39,58,67.2,19,35,11,24,16,84,70,0
Alan Patrick,BRA,"MF,FW",31,Internacional,Brazilian League,27.2,23,8,8,11,4,14,44,31.8,30,20,2,18,9,32,7,0
Wanderson,BRA,"FW,MF",28,Internacional,Brazilian League,26.0,35,24,12,14,9,15,41,36.6,26,19,3,16,16,51,13,0
Gabriel Mercado,ARG,DF,35,Internacional,Brazilian League,24.2,32,18,22,9,1,18,33,54.5,15,21,12,9,23,55,87,0
Vitão,BRA,DF,22,Internacional,Brazilian League,22.7,16,14,10,6,0,9,23,39.1,14,26,16,10,16,32,104,0
Renê,BRA,DF,30,Internacional,Brazilian League,25.4,53,33,28,24,1,33,58,56.9,25,30,5,25,36,89,90,1
Mauricio,BRA,"FW,MF",21,Internacional,Brazilian League,19.6,19,11,7,10,2,12,36,33.3,24,14,2,12,10,29,9,0
Johnny Cardoso,USA,MF,21,Internacional,Brazilian League,17.9,38,23,14,18,6,19,28,67.9,9,30,14,16,31,69,44,1
Sergio Rochet,URU,GK,29,Internacional,Brazilian League,19.0,0,0,0,0,0,0,1,0.0,1,0,0,0,0,0,3,5
Enner Valencia,ECU,FW,33,Internacional,Brazilian League,16.0,4,3,1,3,0,0,4,0.0,4,7,2,5,2,6,10,0
Luiz Adriano,BRA,FW,35,Internacional,Brazilian League,14.8,12,7,0,6,6,2,7,28.6,5,9,2,7,9,21,18,0
Carlos de Pena,URU,"MF,FW",30,Internacional,Brazilian League,15.8,26,13,5,17,4,12,36,33.3,24,13,2,11,21,47,20,0
Charles Aránguiz,CHI,MF,33,Internacional,Brazilian League,14.1,33,16,13,14,6,18,39,46.2,21,12,2,10,10,43,10,0
Igor Gomes,BRA,DF,21,Internacional,Brazilian League,16.3,34,25,23,11,0,22,40,55.0,18,18,7,11,15,49,63,0
Pedro Henrique,BRA,"FW,MF",32,Internacional,Brazilian League,14.1,27,20,15,6,6,8,16,50.0,8,11,0,11,5,32,8,0
Nicolás Hernández,COL,DF,25,Internacional,Brazilian League,14.4,16,6,12,3,1,13,18,72.2,5,18,7,11,9,25,67,2
Romulo,BRA,"MF,DF",22,Internacional,Brazilian League,13.5,26,17,8,13,5,15,24,62.5,9,18,4,14,17,43,31,0
Bruno Henrique,BRA,MF,33,Internacional,Brazilian League,11.7,15,7,3,11,1,5,19,26.3,14,12,0,12,5,20,12,0
Keiller,BRA,GK,26,Internacional,Brazilian League,10.0,0,0,0,0,0,0,1,0.0,1,0,0,0,0,0,2,1
John,BRA,GK,26,Internacional,Brazilian League,9.0,0,0,0,0,0,0,0,0.0,0,0,0,0,1,1,7,0
Gabriel,BRA,MF,30,Internacional,Brazilian League,8.5,18,13,9,8,1,11,31,35.5,20,11,3,8,12,30,7,0
Gustavo Campanharo,BRA,MF,30,Internacional,Brazilian League,7.7,26,16,12,10,4,12,32,37.5,20,10,1,9,12,38,16,0
Dalbert Henrique,BRA,DF,29,Internacional,Brazilian League,5.5,18,12,10,5,3,13,15,86.7,2,5,0,5,6,24,8,0
Matheus Dias,BRA,"MF,FW",25,Internacional,Brazilian League,4.5,17,8,10,6,1,11,19,57.9,8,10,0,10,7,24,8,0
Rodrigo Moledo,BRA,DF,35,Internacional,Brazilian League,5.3,2,2,1,1,0,0,3,0.0,3,10,8,2,3,5,35,0
Lucca Holanda,BRA,FW,19,Internacional,Brazilian League,6.1,11,5,1,6,4,5,17,29.4,12,5,2,3,4,15,2,0
Alexandre Alemão,BRA,FW,24,Internacional,Brazilian League,3.8,5,5,1,3,1,1,5,20.0,4,5,1,4,1,6,2,0
Thauan Lara,BRA,"DF,MF",19,Internacional,Brazilian League,3.7,7,6,4,2,1,4,9,44.4,5,4,2,2,4,11,9,0
Hugo Mallo,ESP,DF,31,Internacional,Brazilian League,3.6,7,3,7,0,0,4,8,50.0,4,8,3,5,6,13,10,0
Gabriel Baralhas,BRA,MF,24,Internacional,Brazilian League,2.6,7,5,3,4,0,5,8,62.5,3,4,1,3,5,12,2,0
Gabriel Barros,BRA,"FW,MF",21,Internacional,Brazilian League,2.0,2,1,1,1,0,0,0,0.0,0,0,0,0,2,4,2,0
Jean Dias,BRA,"FW,MF",32,Internacional,Brazilian League,3.6,1,1,1,0,0,1,6,16.7,5,2,0,2,2,3,3,0
João Dalla Corte,BRA,DF,16,Internacional,Brazilian League,0.2,1,0,0,0,1,0,0,0.0,0,0,0,0,1,2,0,0
Estevão,BRA,MF,20,Internacional,Brazilian League,0.1,2,1,2,0,0,2,2,100.0,0,0,0,0,0,2,0,0
Lucas Ramos,BRA,FW,22,Internacional,Brazilian League,0.0,0,0,0,0,0,0,0,0.0,0,0,0,0,0,0,0,0
João Ricardo Riedi,BRA,GK,34,Fortaleza,Brazilian League,31.9,0,0,0,0,0,0,0,0.0,0,0,0,0,1,1,5,3
Titi,BRA,DF,34,Fortaleza,Brazilian League,31.6,48,35,30,16,2,25,43,58.1,18,29,18,11,34,82,116,1
Caio Alexandre,BRA,MF,23,Fortaleza,Brazilian League,29.2,76,42,31,39,6,43,102,42.2,59,51,7,44,24,100,22,0
Emanuel Brítez,ARG,DF,30,Fortaleza,Brazilian League,30.7,37,25,24,10,3,23,46,50.0,23,37,26,11,31,68,147,0
Bruno Pacheco,BRA,DF,31,Fortaleza,Brazilian League,29.7,69,45,38,25,6,39,66,59.1,27,26,3,23,39,108,57,0
Guilherme Tinga,BRA,DF,29,Fortaleza,Brazilian League,28.7,54,31,33,15,6,29,68,42.6,39,28,14,14,41,95,105,0
Tomas Pochettino,ARG,"MF,FW",26,Fortaleza,Brazilian League,22.1,44,22,11,28,5,24,62,38.7,38,29,6,23,17,61,22,0
Juan Martín Lucero,ARG,FW,31,Fortaleza,Brazilian League,23.0,13,7,3,4,6,5,17,29.4,12,11,3,8,4,17,12,1
Thiago Galhardo,BRA,"FW,MF",33,Fortaleza,Brazilian League,20.8,14,11,6,6,2,6,20,30.0,14,18,3,15,8,22,21,0
José Welison,BRA,MF,27,Fortaleza,Brazilian League,18.6,49,30,20,25,4,18,34,52.9,16,24,5,19,23,72,24,0
Yago Pikachu,BRA,"FW,MF",30,Fortaleza,Brazilian League,19.5,20,14,9,9,2,8,28,28.6,20,22,3,19,13,33,13,0
Calebe,BRA,"MF,FW",22,Fortaleza,Brazilian League,16.4,17,10,6,7,4,7,24,29.2,17,12,1,11,6,23,3,0
Guilherme,BRA,"FW,MF",27,Fortaleza,Brazilian League,15.7,28,13,14,8,6,12,26,46.2,14,18,3,15,16,44,20,0
Marinho,BRA,"FW,MF",32,Fortaleza,Brazilian League,12.7,15,8,7,5,3,6,24,25.0,18,17,0,17,3,18,5,0
Marcelo,BRA,DF,27,Fortaleza,Brazilian League,12.0,18,12,10,7,1,9,17,52.9,8,16,11,5,17,35,46,0
Lucas Sasha,BRA,MF,32,Fortaleza,Brazilian League,11.3,58,40,30,27,1,29,66,43.9,37,21,2,19,27,85,22,0
Hércules,BRA,MF,22,Fortaleza,Brazilian League,8.6,27,18,9,15,3,10,28,35.7,18,16,2,14,5,32,9,0
Imanol Machuca,ARG,FW,23,Fortaleza,Brazilian League,7.5,18,10,5,9,4,9,18,50.0,9,11,0,11,3,21,1,0
Gonzalo Escobar,ARG,DF,25,Fortaleza,Brazilian League,6.4,18,14,5,8,5,10,15,66.7,5,8,2,6,15,33,16,0
Pedro Borges,BRA,"MF,FW",25,Fortaleza,Brazilian League,6.3,16,12,7,7,2,7,12,58.3,5,7,2,5,4,20,12,1
Lucas Crispim,BRA,"MF,DF",28,Fortaleza,Brazilian League,5.4,7,5,3,3,1,3,10,30.0,7,4,3,1,3,10,7,0
Fernando Miguel,BRA,GK,37,Fortaleza,Brazilian League,5.1,1,0,1,0,0,1,1,100.0,0,0,0,0,1,2,1,1
Moises,BRA,"MF,FW",26,Fortaleza,Brazilian League,4.1,3,3,1,1,1,1,9,11.1,8,1,0,1,3,6,1,0
Luis Eduardo Marques dos Santos,BRA,DF,25,Fortaleza,Brazilian League,4.3,12,7,7,2,3,5,8,62.5,3,14,3,11,6,18,10,0
Tobias Figueiredo,POR,DF,28,Fortaleza,Brazilian League,3.8,5,1,3,2,0,3,3,100.0,0,2,1,1,2,7,13,1
Silvio Romero,ARG,FW,34,Fortaleza,Brazilian League,4.4,2,2,0,1,1,1,3,33.3,2,3,0,3,0,2,4,0
Romarinho,BRA,"FW,MF",28,Fortaleza,Brazilian League,3.2,1,1,0,1,0,0,6,0.0,6,1,0,1,1,2,0,0
Brayan Ceballos,COL,DF,21,Fortaleza,Brazilian League,2.3,2,2,1,1,0,0,0,0.0,0,3,1,2,2,4,15,0
Maurício Kozlinski,BRA,GK,31,Fortaleza,Brazilian League,1.0,0,0,0,0,0,0,0,0.0,0,0,0,0,0,0,1,0
Vinícius Zanocelo,BRA,"MF,FW",22,Fortaleza,Brazilian League,0.9,1,1,1,0,0,1,4,25.0,3,2,1,1,3,4,3,0
Pedro Rocha Neves,BRA,FW,28,Fortaleza,Brazilian League,0.4,1,0,0,1,0,0,1,0.0,1,0,0,0,0,1,0,0
Kauan,BRA,FW,17,Fortaleza,Brazilian League,0.1,0,0,0,0,0,0,1,0.0,1,0,0,0,0,0,0,0
Rafael Pires,BRA,GK,33,São Paulo,Brazilian League,33.0,2,2,2,0,0,2,3,66.7,1,1,0,1,1,3,11,0
Pablo Maia,BRA,MF,21,São Paulo,Brazilian League,28.7,62,36,19,38,5,33,76,43.4,43,36,13,23,18,80,31,1
Alisson,BRA,"MF,FW",29,São Paulo,Brazilian League,23.9,47,32,15,26,6,25,65,38.5,40,31,11,20,27,74,34,1
Lucas Beraldo,BRA,DF,19,São Paulo,Brazilian League,24.0,28,21,19,8,1,18,27,66.7,9,36,23,13,24,52,89,2
Luciano,BRA,"MF,FW",29,São Paulo,Brazilian League,23.5,27,19,10,15,2,12,23,52.2,11,15,0,15,4,31,10,0
Caio Paulista,BRA,DF,24,São Paulo,Brazilian League,23.1,28,19,13,12,3,15,35,42.9,20,19,3,16,20,48,22,0
Rafinha,BRA,DF,37,São Paulo,Brazilian League,22.5,41,26,26,12,3,27,46,58.7,19,17,9,8,16,57,34,1
Wellington Rato,BRA,"FW,MF",30,São Paulo,Brazilian League,19.6,23,13,14,8,1,14,30,46.7,16,17,3,14,6,29,26,0
Diego,BRA,DF,23,São Paulo,Brazilian League,19.4,21,11,13,8,0,12,22,54.5,10,27,14,13,18,39,99,0
Michel Araujo,URU,"FW,MF",26,São Paulo,Brazilian League,19.6,36,23,15,17,4,20,48,41.7,28,27,2,25,11,47,18,1
Robert Arboleda,ECU,DF,31,São Paulo,Brazilian League,19.1,32,21,20,11,1,19,23,82.6,4,27,24,3,13,45,71,2
Rodrigo Nestor,BRA,"MF,FW",22,São Paulo,Brazilian League,16.1,23,15,6,16,1,11,35,31.4,24,11,0,11,11,34,5,0
Jonathan Calleri,ARG,FW,29,São Paulo,Brazilian League,15.0,7,4,1,1,5,3,8,37.5,5,7,1,6,5,12,15,0
Juan Santos,BRA,FW,20,São Paulo,Brazilian League,14.2,19,14,9,9,1,6,13,46.2,7,12,2,10,6,25,13,0
Gabriel Neves,URU,MF,25,São Paulo,Brazilian League,10.7,24,14,6,12,6,10,39,25.6,29,19,2,17,3,27,15,0
Alan Franco,ARG,DF,26,São Paulo,Brazilian League,12.5,14,10,9,3,2,11,16,68.8,5,10,8,2,13,27,37,0
Nathan Mendes,BRA,DF,20,São Paulo,Brazilian League,13.1,21,14,11,7,3,10,16,62.5,6,15,3,12,18,39,22,0
Welington,BRA,DF,21,São Paulo,Brazilian League,10.4,16,13,10,3,3,11,18,61.1,7,10,3,7,3,19,25,0
Lucas Moura,BRA,"FW,MF",30,São Paulo,Brazilian League,9.6,6,0,1,4,1,2,13,15.4,11,7,1,6,7,13,8,0
James Rodríguez,COL,"MF,FW",31,São Paulo,Brazilian League,7.1,8,5,0,4,4,5,11,45.5,6,3,0,3,0,8,1,0
Luan Silva,BRA,MF,23,São Paulo,Brazilian League,6.8,13,5,6,6,1,6,13,46.2,7,8,2,6,9,22,6,0
David,BRA,"FW,MF",27,São Paulo,Brazilian League,8.1,6,2,2,1,3,2,8,25.0,6,8,1,7,0,6,2,0
Marcos Paulo,BRA,"FW,MF",21,São Paulo,Brazilian League,5.9,7,7,1,3,3,3,14,21.4,11,11,2,9,6,13,2,0
Jandrei,BRA,GK,29,São Paulo,Brazilian League,5.0,0,0,0,0,0,0,0,0.0,0,0,0,0,0,0,3,0
Patryck,BRA,DF,20,São Paulo,Brazilian League,4.2,6,4,4,1,1,3,6,50.0,3,5,1,4,7,13,13,0
Jhegson Méndez,ECU,MF,25,São Paulo,Brazilian League,4.1,6,4,2,4,0,1,5,20.0,4,4,0,4,6,12,2,0
Raí Ramos,BRA,DF,28,São Paulo,Brazilian League,3.1,5,4,4,1,0,5,7,71.4,2,2,1,1,1,6,7,0
Erison,BRA,"FW,MF",23,São Paulo,Brazilian League,4.3,3,0,0,2,1,1,2,50.0,1,1,0,1,0,3,2,0
Matheus Belém,BRA,DF,19,São Paulo,Brazilian League,1.9,0,0,0,0,0,0,1,0.0,1,2,2,0,2,2,5,0
Rodrigo,BRA,"MF,FW",18,São Paulo,Brazilian League,2.6,3,3,1,2,0,2,9,22.2,7,2,0,2,3,6,4,0
Alexandre Pato,BRA,"FW,MF",33,São Paulo,Brazilian League,1.8,1,0,1,0,0,1,2,50.0,1,0,0,0,0,1,1,0
Talles Costa,BRA,"MF,FW",20,São Paulo,Brazilian League,1.5,4,1,3,0,1,1,1,100.0,0,2,1,1,2,6,0,0
João Moreira,POR,DF,18,São Paulo,Brazilian League,0.8,1,1,1,0,0,1,1,100.0,0,0,0,0,1,2,0,0
William Gomes,BRA,FW,16,São Paulo,Brazilian League,0.8,3,3,3,0,0,1,2,50.0,1,2,0,2,1,4,0,0
Pedro Vilhena,BRA,FW,20,São Paulo,Brazilian League,0.2,0,0,0,0,0,0,0,0.0,0,0,0,0,0,0,0,0
Talles Wander,BRA,"FW,MF",19,São Paulo,Brazilian League,0.2,0,0,0,0,0,0,1,0.0,1,0,0,0,0,0,1,0
Felipe Negrucci,BRA,MF,18,São Paulo,Brazilian League,0.2,0,0,0,0,0,0,0,0.0,0,0,0,0,0,0,1,0
Nahuel Ferraresi,VEN,FW,24,São Paulo,Brazilian League,0.0,0,0,0,0,0,0,1,0.0,1,0,0,0,0,0,1,0
Marllon Borges,BRA,DF,30,Cuiabá,Brazilian League,36.0,50,34,31,18,1,23,44,52.3,21,38,21,17,27,77,151,0
Walter,BRA,GK,35,Cuiabá,Brazilian League,35.0,0,0,0,0,0,0,0,0.0,0,0,0,0,2,2,9,1
Deyverson,BRA,FW,31,Cuiabá,Brazilian League,32.3,12,9,3,5,4,8,19,42.1,11,14,5,9,8,20,39,0
Raniele,BRA,"MF,DF",26,Cuiabá,Brazilian League,32.1,74,41,30,39,5,30,76,39.5,46,52,28,24,37,111,99,0
Matheus Alexandre,BRA,DF,23,Cuiabá,Brazilian League,33.1,86,58,56,25,5,55,102,53.9,47,37,5,32,42,128,74,1
Alan Empereur,BRA,DF,28,Cuiabá,Brazilian League,32.8,23,15,20,3,0,18,37,48.6,19,28,15,13,27,50,116,1
Rikelme,BRA,DF,19,Cuiabá,Brazilian League,26.0,61,46,39,15,7,39,78,50.0,39,33,7,26,40,101,87,0
Denilson,BRA,MF,21,Cuiabá,Brazilian League,21.2,47,30,13,26,8,20,41,48.8,21,23,7,16,13,60,2,0
Jonathan Cafu,BRA,"FW,MF",31,Cuiabá,Brazilian League,19.0,33,21,10,17,6,10,33,30.3,23,20,0,20,10,43,10,0
Clayson,BRA,"FW,MF",27,Cuiabá,Brazilian League,18.2,19,10,10,6,3,12,39,30.8,27,18,2,16,8,27,6,2
Fernando Sobral,BRA,MF,28,Cuiabá,Brazilian League,21.1,70,45,39,22,9,32,70,45.7,38,45,5,40,15,85,15,0
Allyson Aires dos Santos,BRA,DF,32,Cuiabá,Brazilian League,12.6,18,14,13,5,0,9,13,69.2,4,16,11,5,8,26,64,1
Wellington Silva,BRA,FW,30,Cuiabá,Brazilian League,14.8,23,15,10,8,5,12,30,40.0,18,19,0,19,6,29,8,0
Pablo Ceppelini,URU,MF,31,Cuiabá,Brazilian League,11.1,14,6,6,7,1,6,33,18.2,27,10,1,9,9,23,10,0
Filipe Augusto,BRA,MF,29,Cuiabá,Brazilian League,11.8,26,15,13,10,3,15,36,41.7,21,18,11,7,7,33,24,0
Isidro Pitta,PAR,FW,23,Cuiabá,Brazilian League,9.1,2,1,0,1,1,0,3,0.0,3,2,1,1,2,4,5,0
Lucas Mineiro,BRA,MF,26,Cuiabá,Brazilian League,6.8,10,3,1,4,5,3,10,30.0,7,9,5,4,4,14,6,0
Derik Lacerda,BRA,"FW,MF",23,Cuiabá,Brazilian League,7.3,13,10,9,3,1,8,16,50.0,8,6,1,5,3,16,4,0
Patric Calmon PK,BRA,DF,28,Cuiabá,Brazilian League,5.8,12,9,8,1,3,7,13,53.8,6,9,1,8,9,21,19,0
Emerson Negueba,BRA,FW,22,Cuiabá,Brazilian League,5.4,7,4,2,4,1,2,5,40.0,3,8,0,8,3,10,5,0
Matheusinho,BRA,DF,24,Cuiabá,Brazilian League,4.8,11,8,9,2,0,8,16,50.0,8,3,1,2,5,16,14,0
Ronald,BRA,MF,25,Cuiabá,Brazilian League,6.5,21,9,9,10,2,8,26,30.8,18,4,0,4,9,30,7,0
Iury de Castilho,BRA,FW,27,Cuiabá,Brazilian League,4.4,5,3,2,3,0,1,13,7.7,12,4,0,4,1,6,2,0
Uendel,BRA,DF,34,Cuiabá,Brazilian League,4.0,2,1,1,0,1,0,1,0.0,1,4,1,3,0,2,9,0
João Carlos,BRA,GK,34,Cuiabá,Brazilian League,3.0,0,0,0,0,0,0,0,0.0,0,0,0,0,0,0,0,0
Nicolás Quagliata,URU,"FW,MF",23,Cuiabá,Brazilian League,2.6,3,2,3,0,0,2,12,16.7,10,7,0,7,0,3,1,0
Pablinho,BRA,FW,19,Cuiabá,Brazilian League,0.4,3,2,0,3,0,1,3,33.3,2,1,0,1,0,3,0,0
Rafael Gava,BRA,MF,29,Cuiabá,Brazilian League,0.2,0,0,0,0,0,0,0,0.0,0,1,0,1,0,0,0,0
Vitão,BRA,DF,22,Cuiabá,Brazilian League,0.1,0,0,0,0,0,0,1,0.0,1,1,1,0,0,0,1,0
Ricardo Cerqueira,BRA,MF,20,Cuiabá,Brazilian League,0.1,0,0,0,0,0,0,0,0.0,0,0,0,0,0,0,0,0
Cássio,BRA,GK,35,Corinthians,Brazilian League,36.8,0,0,0,0,0,0,1,0.0,1,1,0,1,0,0,11,1
Gil,BRA,DF,35,Corinthians,Brazilian League,32.0,46,30,34,12,0,26,41,63.4,15,53,36,17,27,73,126,0
Yuri Alberto,BRA,FW,21,Corinthians,Brazilian League,30.2,23,14,6,8,9,9,22,40.9,13,23,2,21,3,26,17,0
Maycon,BRA,MF,25,Corinthians,Brazilian League,26.7,43,26,20,17,6,22,57,38.6,35,39,5,34,33,76,36,0
Fagner,BRA,DF,33,Corinthians,Brazilian League,23.3,43,27,29,8,6,24,44,54.5,20,23,11,12,17,60,66,0
Fábio Santos,BRA,DF,37,Corinthians,Brazilian League,18.6,24,15,13,9,2,17,31,54.8,14,24,12,12,19,43,57,0
Bruno Méndez,URU,DF,23,Corinthians,Brazilian League,18.3,39,22,22,15,2,23,40,57.5,17,23,11,12,22,61,72,0
Matheus Bidu,BRA,DF,23,Corinthians,Brazilian League,18.4,27,20,18,6,3,13,22,59.1,9,24,6,18,31,58,56,0
Giuliano de Paula,BRA,"MF,FW",32,Corinthians,Brazilian League,18.1,34,16,9,20,5,14,44,31.8,30,15,3,12,13,47,20,0
Fausto Vera,ARG,MF,22,Corinthians,Brazilian League,15.3,26,12,13,10,3,14,46,30.4,32,28,10,18,16,42,30,0
Renato Augusto,BRA,MF,34,Corinthians,Brazilian League,14.2,17,8,5,10,2,3,11,27.3,8,7,2,5,8,25,10,0
Roger Guedes,BRA,"FW,MF",26,Corinthians,Brazilian League,15.0,6,3,1,2,3,1,2,50.0,1,11,1,10,1,7,11,0
Lucas Veríssimo,BRA,DF,27,Corinthians,Brazilian League,14.5,19,11,11,6,2,11,14,78.6,3,17,11,6,10,29,76,0
Gabriel Moscardo,BRA,MF,17,Corinthians,Brazilian League,12.6,37,22,20,15,2,18,40,45.0,22,29,9,20,20,57,28,0
Caetano,BRA,DF,23,Corinthians,Brazilian League,13.4,12,8,10,2,0,5,8,62.5,3,19,14,5,19,31,61,1
Angel Romero,PAR,FW,30,Corinthians,Brazilian League,13.3,26,14,13,11,2,16,40,40.0,24,14,0,14,5,31,17,0
Murillo,BRA,DF,20,Corinthians,Brazilian League,12.9,16,9,7,9,0,4,11,36.4,7,31,22,9,16,32,65,1
Ruan Oliveira Ferreira,BRA,"MF,FW",22,Corinthians,Brazilian League,9.8,23,13,12,10,1,13,36,36.1,23,13,1,12,8,31,13,1
Adson,BRA,"FW,MF",22,Corinthians,Brazilian League,9.5,33,26,22,8,3,12,21,57.1,9,16,2,14,8,41,1,0
Wesley Ribeiro,BRA,"FW,MF",17,Corinthians,Brazilian League,9.6,15,11,8,5,2,9,22,40.9,13,8,0,8,6,21,4,0
Budiga Roni,BRA,MF,23,Corinthians,Brazilian League,7.5,23,13,12,11,0,10,26,38.5,16,15,6,9,6,29,12,0
Matías Rojas,PAR,"MF,FW",27,Corinthians,Brazilian League,7.0,7,4,1,5,1,3,10,30.0,7,7,1,6,1,8,4,0
Pedrinho Santos,BRA,"FW,MF",16,Corinthians,Brazilian League,6.9,9,4,7,2,0,6,14,42.9,8,6,2,4,5,14,3,0
Guilherme Biro,BRA,"FW,MF",18,Corinthians,Brazilian League,6.4,8,4,5,2,1,3,14,21.4,11,12,0,12,3,11,2,0
Matheus Araújo,BRA,"MF,FW",20,Corinthians,Brazilian League,6.5,12,7,3,4,5,4,18,22.2,14,12,3,9,9,21,6,0
Felipe Augusto,BRA,"FW,MF",18,Corinthians,Brazilian League,3.6,5,2,3,2,0,2,10,20.0,8,10,2,8,1,6,2,0
Víctor Cantillo,COL,MF,29,Corinthians,Brazilian League,3.0,7,6,4,3,0,3,10,30.0,7,7,2,5,6,13,11,0
Du Queiroz,BRA,"MF,DF",23,Corinthians,Brazilian League,2.0,2,1,1,1,0,1,5,20.0,4,0,0,0,3,5,4,0
Léo Mana,BRA,DF,18,Corinthians,Brazilian League,1.5,2,2,1,0,1,1,2,50.0,1,4,1,3,2,4,2,0
Gustavo Mosquito,BRA,"FW,MF",25,Corinthians,Brazilian League,3.4,7,5,2,3,2,3,7,42.9,4,2,1,1,1,8,10,0
Paulinho,BRA,"MF,FW",34,Corinthians,Brazilian League,1.6,4,3,2,2,0,3,5,60.0,2,4,1,3,1,5,4,0
Giovane,BRA,FW,19,Corinthians,Brazilian League,1.5,0,0,0,0,0,0,0,0.0,0,3,0,3,0,0,2,0
Carlos Miguel,BRA,GK,24,Corinthians,Brazilian League,1.2,0,0,0,0,0,0,0,0.0,0,0,0,0,0,0,0,0
Fabián Balbuena,PAR,DF,31,Corinthians,Brazilian League,1.0,1,0,1,0,0,1,1,100.0,0,0,0,0,3,4,5,1
Júnior Moraes,UKR,DF,35,Corinthians,Brazilian League,0.0,1,1,0,0,1,0,0,0.0,0,0,0,0,0,1,0,0
Rafael Cabral,BRA,GK,32,Cruzeiro,Brazilian League,37.0,0,0,0,0,0,0,1,0.0,1,1,0,1,0,0,7,0
Luciano Castán,BRA,DF,33,Cruzeiro,Brazilian League,35.7,29,18,21,7,1,19,26,73.1,7,26,20,6,29,58,145,1
Marlon,BRA,DF,25,Cruzeiro,Brazilian League,35.5,114,72,70,35,9,74,123,60.2,49,47,4,43,49,163,92,1
William,BRA,DF,27,Cruzeiro,Brazilian League,29.4,64,38,36,17,11,31,84,36.9,53,53,4,49,49,113,58,1
Bruno Nascimento,BRA,"FW,MF",25,Cruzeiro,Brazilian League,31.3,36,23,12,14,10,11,28,39.3,17,29,0,29,8,44,22,0
Neris,BRA,DF,30,Cruzeiro,Brazilian League,23.5,31,18,19,10,2,21,30,70.0,9,17,9,8,35,66,98,1
Mateus Vital,BRA,MF,24,Cruzeiro,Brazilian League,20.9,24,14,8,14,2,10,24,41.7,14,14,1,13,7,31,4,0
Machado,BRA,MF,27,Cruzeiro,Brazilian League,25.3,38,23,13,16,9,12,29,41.4,17,18,5,13,33,71,25,2
Wesley,BRA,"FW,MF",23,Cruzeiro,Brazilian League,19.7,36,23,12,20,4,17,47,36.2,30,17,0,17,12,48,9,0
Jussa,BRA,MF,26,Cruzeiro,Brazilian League,19.6,34,23,9,23,2,18,28,64.3,10,15,4,11,15,49,33,0
Lucas Silva,BRA,MF,29,Cruzeiro,Brazilian League,16.4,28,18,8,14,6,15,22,68.2,7,12,1,11,9,37,5,1
Arthur,BRA,"FW,MF",24,Cruzeiro,Brazilian League,15.0,9,7,5,4,0,3,9,33.3,6,17,0,17,5,14,3,0
Lucas Oliveira,BRA,DF,26,Cruzeiro,Brazilian League,14.6,16,10,12,4,0,7,17,41.2,10,30,19,11,21,37,66,0
Gilberto,BRA,FW,33,Cruzeiro,Brazilian League,12.1,11,8,3,5,3,3,9,33.3,6,7,3,4,1,12,6,0
Matheus Pereira,POR,"FW,MF",26,Cruzeiro,Brazilian League,11.4,6,4,0,4,2,4,17,23.5,13,7,0,7,6,12,3,0
Nikão,BRA,"FW,MF",30,Cruzeiro,Brazilian League,8.9,15,10,7,8,0,8,13,61.5,5,8,1,7,6,21,4,0
Ian Luccas,BRA,MF,19,Cruzeiro,Brazilian League,5.3,15,7,6,5,4,4,10,40.0,6,2,0,2,5,20,11,0
Helibelton Palacios,COL,DF,29,Cruzeiro,Brazilian League,7.0,14,12,5,8,1,7,15,46.7,8,11,0,11,5,19,20,0
Rafael Elias,BRA,FW,23,Cruzeiro,Brazilian League,6.0,8,5,0,3,5,2,5,40.0,3,3,0,3,1,9,3,0
Neto Moura,BRA,MF,26,Cruzeiro,Brazilian League,5.5,9,3,3,5,1,4,23,17.4,19,4,0,4,7,16,3,0
Ramiro Benetti,BRA,MF,29,Cruzeiro,Brazilian League,4.5,7,6,1,5,1,1,7,14.3,6,4,1,3,1,8,1,0
Richard,BRA,MF,28,Cruzeiro,Brazilian League,3.8,9,6,4,5,0,3,4,75.0,1,6,0,6,7,16,5,0
João Wellington,BRA,MF,19,Cruzeiro,Brazilian League,4.1,5,4,4,1,0,2,3,66.7,1,4,0,4,1,6,10,0
Kaiki,BRA,"DF,FW",19,Cruzeiro,Brazilian League,2.5,7,6,3,3,1,2,3,66.7,1,2,1,1,5,12,6,0
Wallisson Luiz,BRA,MF,25,Cruzeiro,Brazilian League,4.4,15,11,5,8,2,4,12,33.3,8,3,0,3,7,22,3,0
Henrique Dourado,BRA,FW,33,Cruzeiro,Brazilian League,3.8,3,2,0,1,2,0,3,0.0,3,1,1,0,0,3,1,0
Stênio Toledo,BRA,"FW,MF",19,Cruzeiro,Brazilian League,3.2,7,7,3,4,0,2,3,66.7,1,2,0,2,3,10,1,0
Robert,BRA,"MF,FW",17,Cruzeiro,Brazilian League,2.1,5,2,4,1,0,3,8,37.5,5,4,0,4,1,6,2,0
João Marcelo,BRA,DF,22,Cruzeiro,Brazilian League,1.8,3,3,2,1,0,1,1,100.0,0,2,2,0,4,7,9,0
Igor Marques,BRA,DF,24,Cruzeiro,Brazilian League,1.3,5,2,2,3,0,2,5,40.0,3,3,1,2,1,6,4,0
Anderson,BRA,GK,24,Cruzeiro,Brazilian League,1.0,0,0,0,0,0,0,0,0.0,0,0,0,0,0,0,0,0
Rafael Bilu,BRA,FW,23,Cruzeiro,Brazilian League,1.0,2,0,0,1,1,0,0,0.0,0,3,0,3,1,3,0,0
Reynaldo Cesar Moraes,BRA,DF,26,Cruzeiro,Brazilian League,0.7,0,0,0,0,0,0,0,0.0,0,0,0,0,0,0,3,0
Fernando Henrique,BRA,MF,21,Cruzeiro,Brazilian League,1.5,4,2,0,4,0,1,1,100.0,0,3,1,2,1,5,1,0
Paulo Vitor,BRA,"MF,DF",23,Cruzeiro,Brazilian League,1.4,2,2,0,2,0,0,2,0.0,2,2,1,1,0,2,1,0
Daniel Jr,BRA,MF,20,Cruzeiro,Brazilian League,0.3,0,0,0,0,0,0,1,0.0,1,0,0,0,0,0,0,0
João Pedro,BRA,FW,19,Cruzeiro,Brazilian League,0.1,0,0,0,0,0,0,0,0.0,0,0,0,0,0,0,0,0
Luis,BRA,FW,17,Cruzeiro,Brazilian League,0.1,2,1,0,2,0,1,1,100.0,0,1,0,1,1,3,1,0
Léo Jardim,BRA,GK,27,Vasco da Gama,Brazilian League,38.0,1,0,1,0,0,0,0,0.0,0,0,0,0,0,1,11,0
Lucas Piton,BRA,DF,22,Vasco da Gama,Brazilian League,36.5,45,25,24,18,3,20,48,41.7,28,27,7,20,40,85,89,0
Léo Pelé,BRA,DF,26,Vasco da Gama,Brazilian League,30.2,26,17,14,11,1,12,19,63.2,7,26,14,12,14,40,125,1
Gabriel Chaves,BRA,"FW,MF",21,Vasco da Gama,Brazilian League,29.0,42,26,20,17,5,16,52,30.8,36,32,0,32,13,55,16,0
Zé Gabriel,BRA,MF,24,Vasco da Gama,Brazilian League,21.5,43,20,24,16,3,24,55,43.6,31,22,5,17,18,61,45,0
José Luis Rodríguez Bebanz,URU,DF,25,Vasco da Gama,Brazilian League,22.2,49,31,29,17,3,25,56,44.6,31,24,8,16,30,79,56,2
Pablo Vegetti,ARG,FW,34,Vasco da Gama,Brazilian League,19.9,7,5,1,4,2,2,18,11.1,16,18,8,10,4,11,35,0
Gary Medel,CHI,"DF,MF",35,Vasco da Gama,Brazilian League,19.2,22,5,13,8,1,10,29,34.5,19,26,20,6,20,42,77,1
Paulinho,BRA,MF,26,Vasco da Gama,Brazilian League,18.2,42,23,18,19,5,15,37,40.5,22,26,3,23,16,58,16,0
Bruno Praxedes,BRA,MF,20,Vasco da Gama,Brazilian League,14.9,34,26,18,11,5,16,35,45.7,19,19,4,15,12,46,13,0
Jair,BRA,MF,28,Vasco da Gama,Brazilian League,17.7,40,24,18,18,4,24,57,42.1,33,29,3,26,15,55,15,0
Robson Bambu,BRA,DF,25,Vasco da Gama,Brazilian League,14.2,21,13,15,5,1,13,28,46.4,15,27,16,11,12,33,70,1
Maicon,BRA,DF,34,Vasco da Gama,Brazilian League,13.9,19,13,15,4,0,9,13,69.2,4,23,17,6,17,36,84,0
Alex Teixeira,BRA,"FW,MF",33,Vasco da Gama,Brazilian League,12.6,9,6,2,6,1,2,4,50.0,2,5,0,5,1,10,4,0
Paulo Henrique,BRA,DF,26,Vasco da Gama,Brazilian League,9.5,31,21,12,15,4,17,30,56.7,13,11,4,7,9,40,25,0
Pedro Raul,BRA,FW,26,Vasco da Gama,Brazilian League,9.3,3,2,0,1,2,1,6,16.7,5,7,3,4,5,8,11,0
Dimitri Payet,FRA,"MF,FW",35,Vasco da Gama,Brazilian League,8.9,7,5,4,3,0,6,14,42.9,8,4,0,4,2,9,0,0
Figueiredo,BRA,"FW,MF",21,Vasco da Gama,Brazilian League,7.3,8,5,5,2,1,2,17,11.8,15,9,0,9,6,14,9,0
Luca Orellano,ARG,"FW,MF",22,Vasco da Gama,Brazilian League,6.9,14,7,7,5,2,8,18,44.4,10,10,1,9,3,17,3,0
Manuel Capasso,ARG,DF,26,Vasco da Gama,Brazilian League,6.2,8,4,6,2,0,3,9,33.3,6,11,8,3,8,16,20,0
Andrey Santos,BRA,MF,18,Vasco da Gama,Brazilian League,4.7,15,7,9,4,2,5,22,22.7,17,5,1,4,11,26,7,1
Sergio Antonio De Luiz Junior,BRA,"MF,DF",27,Vasco da Gama,Brazilian League,4.0,7,5,3,3,1,2,2,100.0,0,8,0,8,0,7,3,0
Matías Galarza,PAR,MF,20,Vasco da Gama,Brazilian League,4.5,15,7,10,4,1,7,17,41.2,10,10,2,8,6,21,3,0
Rossi,BRA,"MF,FW",29,Vasco da Gama,Brazilian League,4.4,4,2,2,2,0,3,5,60.0,2,3,0,3,4,8,3,0
Miranda,BRA,DF,23,Vasco da Gama,Brazilian League,4.3,4,3,2,2,0,3,5,60.0,2,2,1,1,4,8,19,0
Rodrigo Alves,BRA,MF,20,Vasco da Gama,Brazilian League,3.9,11,5,7,4,0,6,14,42.9,8,1,0,1,3,14,5,1
Sebastián Ferreira,PAR,"FW,MF",24,Vasco da Gama,Brazilian League,4.9,8,3,1,3,4,1,5,20.0,4,2,0,2,0,8,1,0
Erick Marcus,BRA,"MF,FW",18,Vasco da Gama,Brazilian League,4.4,10,5,0,6,4,6,10,60.0,4,1,0,1,4,14,5,0
Mateus Cocão,BRA,MF,20,Vasco da Gama,Brazilian League,3.9,13,7,6,7,0,3,9,33.3,6,9,3,6,3,16,4,0
Rayan Vitor,BRA,"FW,MF",16,Vasco da Gama,Brazilian League,2.9,2,1,0,2,0,0,2,0.0,2,1,0,1,0,2,2,0
Cauan Barros,BRA,MF,18,Vasco da Gama,Brazilian League,2.6,6,3,0,5,1,4,12,33.3,8,3,0,3,1,7,9,0
José Vitor,BRA,DF,20,Vasco da Gama,Brazilian League,1.2,0,0,0,0,0,0,1,0.0,1,4,2,2,0,0,4,0
Gabriel Carabajal,ARG,MF,31,Vasco da Gama,Brazilian League,1.4,1,1,0,1,0,1,2,50.0,1,0,0,0,2,3,0,0
Eguinaldo,BRA,"FW,MF",18,Vasco da Gama,Brazilian League,0.7,2,1,0,0,2,0,0,0.0,0,1,1,0,0,2,0,0
Rwan,BRA,"MF,FW",21,Vasco da Gama,Brazilian League,0.4,1,1,0,1,0,0,0,0.0,0,0,0,0,0,1,0,0
Gabriel Dias,BRA,DF,28,Vasco da Gama,Brazilian League,0.1,1,1,1,0,0,0,0,0.0,0,0,0,0,0,1,4,0
Paulo Victor,BRA,DF,21,Vasco da Gama,Brazilian League,0.1,0,0,0,0,0,0,0,0.0,0,0,0,0,0,0,0,0
Marcos Felipe,BRA,GK,26,Bahia,Brazilian League,37.0,3,3,3,0,0,3,6,50.0,3,0,0,0,1,4,24,1
Thaciano,BRA,"MF,FW",27,Bahia,Brazilian League,32.1,49,25,15,28,6,24,55,43.6,31,41,8,33,26,75,27,0
Kanu,BRA,DF,25,Bahia,Brazilian League,32.3,34,25,26,5,3,21,39,53.8,18,38,18,20,47,81,103,1
Rezende,BRA,"MF,DF",28,Bahia,Brazilian League,30.1,96,60,54,40,2,29,70,41.4,41,68,10,58,62,158,69,1
Cauly Oliveira Souza,BRA,"MF,FW",27,Bahia,Brazilian League,28.3,23,12,2,18,3,6,23,26.1,17,17,1,16,13,36,6,0
Vitor Hugo,BRA,DF,31,Bahia,Brazilian League,23.7,38,24,29,9,0,18,24,75.0,6,21,12,9,32,70,82,0
Everaldo Stum,BRA,FW,31,Bahia,Brazilian League,24.2,11,8,2,5,4,5,11,45.5,6,10,2,8,2,13,16,0
Nicolás Acevedo,URU,MF,23,Bahia,Brazilian League,21.9,73,46,24,43,6,40,85,47.1,45,31,1,30,26,99,22,1
Gilberto,BRA,DF,29,Bahia,Brazilian League,20.6,45,28,19,21,5,24,54,44.4,30,26,6,20,18,63,26,2
Ademir Santos,BRA,"FW,MF",27,Bahia,Brazilian League,19.3,32,20,6,16,10,13,37,35.1,24,17,1,16,8,40,3,0
Yago,BRA,MF,27,Bahia,Brazilian League,15.1,45,25,15,18,12,23,54,42.6,31,22,2,20,16,61,14,1
Biel,BRA,"FW,MF",21,Bahia,Brazilian League,15.1,17,11,5,10,2,5,23,21.7,18,17,3,14,14,31,8,0
Camilo Cándido,URU,DF,27,Bahia,Brazilian League,13.8,24,16,16,5,3,8,23,34.8,15,14,1,13,23,47,23,0
Gabriel,BRA,DF,21,Bahia,Brazilian League,10.9,20,9,14,5,1,14,20,70.0,6,11,8,3,30,50,66,1
David Duarte,BRA,DF,28,Bahia,Brazilian League,9.6,8,5,4,4,0,6,8,75.0,2,8,6,2,11,19,50,1
Cicinho,BUL,DF,34,Bahia,Brazilian League,8.4,24,16,9,12,3,11,18,61.1,7,12,3,9,5,29,26,1
Rafael Ratão,BRA,"FW,MF",27,Bahia,Brazilian League,8.7,25,17,11,11,3,13,29,44.8,16,7,0,7,2,27,3,0
Vinicius Mingotti,BRA,FW,23,Bahia,Brazilian League,7.3,6,5,3,2,1,1,4,25.0,3,2,1,1,2,8,4,0
Vítor Jacaré,BRA,"DF,MF",23,Bahia,Brazilian League,9.5,22,19,13,6,3,15,36,41.7,21,16,2,14,11,33,20,0
Jhoanner Chávez,ECU,"DF,MF",20,Bahia,Brazilian League,6.5,14,9,3,11,0,10,21,47.6,11,6,0,6,7,21,14,0
Luciano Juba,BRA,"DF,MF",23,Bahia,Brazilian League,7.2,14,9,8,5,1,9,15,60.0,6,5,0,5,9,23,14,0
Matheus Bahia,BRA,"DF,MF",23,Bahia,Brazilian League,5.5,16,7,8,5,3,7,18,38.9,11,8,0,8,8,24,15,0
Kayky Chagas,BRA,"FW,MF",19,Bahia,Brazilian League,4.6,8,4,4,4,0,4,13,30.8,9,7,0,7,2,10,2,0
Ryan Carlos,BRA,DF,20,Bahia,Brazilian League,6.4,7,6,5,2,0,4,12,33.3,8,9,2,7,8,15,11,1
Raul Bicalho,BRA,DF,23,Bahia,Brazilian League,3.6,6,1,5,1,0,4,5,80.0,1,3,3,0,1,7,12,0
Arthur Sales,BRA,"FW,MF",20,Bahia,Brazilian League,3.2,3,3,0,0,3,0,1,0.0,1,3,0,3,0,3,1,0
Lucas Mugni,ARG,"MF,FW",31,Bahia,Brazilian League,4.0,6,5,4,2,0,1,11,9.1,10,3,0,3,4,10,2,0
Léo Cittadini,BRA,MF,28,Bahia,Brazilian League,1.5,6,3,1,4,1,0,4,0.0,4,2,0,2,3,9,0,0
André,BRA,DF,19,Bahia,Brazilian League,1.4,2,1,1,1,0,2,2,100.0,0,4,1,3,1,3,3,1
Danilo Fernandes,BRA,GK,34,Bahia,Brazilian League,0.4,0,0,0,0,0,0,0,0.0,0,0,0,0,0,0,0,0
Diego Rosa,BRA,"MF,DF",20,Bahia,Brazilian League,2.7,16,10,6,9,1,9,14,64.3,5,2,0,2,5,21,5,0
Danielzinho,BRA,"FW,MF",27,Bahia,Brazilian League,0.9,1,1,0,1,0,1,3,33.3,2,1,0,1,0,1,0,0
Mateus Claus,BRA,GK,28,Bahia,Brazilian League,0.6,0,0,0,0,0,0,0,0.0,0,0,0,0,0,0,0,0
Marcos Victor,BRA,DF,21,Bahia,Brazilian League,0.1,0,0,0,0,0,0,0,0.0,0,0,0,0,0,0,0,0
Patrick Verhon,BRA,FW,18,Bahia,Brazilian League,0.0,0,0,0,0,0,0,0,0.0,0,0,0,0,0,0,0,0
João Paulo,BRA,GK,27,Santos,Brazilian League,35.7,1,1,1,0,0,1,1,100.0,0,0,0,0,0,1,15,1
Joaquim,BRA,DF,24,Santos,Brazilian League,30.3,61,45,46,14,1,38,51,74.5,13,39,24,15,46,107,183,1
Marcos Leonardo,BRA,FW,19,Santos,Brazilian League,28.8,7,3,1,4,2,2,6,33.3,4,11,5,6,2,9,24,0
Lucas Lima,BRA,"MF,FW",32,Santos,Brazilian League,24.5,60,41,19,35,6,26,72,36.1,46,27,4,23,3,63,9,0
Messias,BRA,DF,28,Santos,Brazilian League,26.6,22,15,16,6,0,16,21,76.2,5,32,23,9,36,58,164,1
Rodrigo Fernández,URU,MF,27,Santos,Brazilian League,22.4,57,29,26,25,6,38,98,38.8,60,40,11,29,17,74,28,0
Lucas Braga,BRA,"DF,FW",26,Santos,Brazilian League,22.1,29,21,19,8,2,17,40,42.5,23,22,4,18,11,40,23,0
Jean Lucas,BRA,MF,24,Santos,Brazilian League,20.1,32,22,15,12,5,16,41,39.0,25,16,2,14,14,46,16,1
Dodi,BRA,MF,26,Santos,Brazilian League,19.1,43,25,17,24,2,15,34,44.1,19,25,7,18,22,65,28,0
Stiven Mendoza,COL,"FW,MF",30,Santos,Brazilian League,18.6,25,13,5,13,7,13,26,50.0,13,20,0,20,11,36,5,0
Dodô,BRA,DF,30,Santos,Brazilian League,15.8,20,15,11,7,2,12,23,52.2,11,18,5,13,29,49,44,1
Yeferson Soteldo,VEN,"FW,MF",25,Santos,Brazilian League,17.3,16,9,5,9,2,5,16,31.3,11,10,0,10,6,22,7,0
Tomás Rincón,VEN,MF,35,Santos,Brazilian League,13.2,31,16,8,19,4,14,34,41.2,20,16,1,15,25,56,26,0
João Othavio Basso,BRA,DF,26,Santos,Brazilian League,12.8,20,10,14,4,2,11,23,47.8,12,9,6,3,23,43,57,0
Gabriel Inocêncio,BRA,DF,28,Santos,Brazilian League,14.2,52,31,30,13,9,28,48,58.3,20,26,8,18,15,67,40,1
Kevyson,BRA,DF,18,Santos,Brazilian League,10.8,30,23,18,11,1,13,22,59.1,9,8,3,5,22,52,22,1
João Lucas,BRA,DF,24,Santos,Brazilian League,9.0,21,15,9,10,2,11,19,57.9,8,16,3,13,15,36,22,0
Nonato,BRA,MF,24,Santos,Brazilian League,7.3,21,15,6,13,2,10,22,45.5,12,14,3,11,14,35,3,0
Lucas,BRA,DF,21,Santos,Brazilian League,6.8,14,8,10,4,0,7,20,35.0,13,11,3,8,6,20,20,0
Nathan,BRA,DF,21,Santos,Brazilian League,5.5,14,13,10,3,1,10,19,52.6,9,4,0,4,8,22,8,0
Julio Furch,ARG,"FW,MF",33,Santos,Brazilian League,6.8,7,5,2,3,2,1,6,16.7,5,3,0,3,2,9,9,0
Ângelo Borges,BRA,"FW,MF",18,Santos,Brazilian League,6.0,10,8,2,5,3,5,10,50.0,5,11,0,11,5,15,1,0
Alex,BRA,DF,23,Santos,Brazilian League,5.1,9,7,8,0,1,2,4,50.0,2,3,2,1,7,16,10,0
Deivid Washington,BRA,FW,17,Santos,Brazilian League,4.7,4,1,0,1,3,2,8,25.0,6,4,0,4,1,5,3,0
Guilherme Camacho,BRA,MF,32,Santos,Brazilian League,5.0,15,9,7,7,1,6,16,37.5,10,14,4,10,5,20,11,0
Maximiliano Silvera,URU,"MF,FW",25,Santos,Brazilian League,5.0,10,8,2,8,0,3,8,37.5,5,8,0,8,1,11,2,0
Eduardo Gabriel,BRA,DF,26,Santos,Brazilian League,3.0,1,0,1,0,0,1,1,100.0,0,5,4,1,6,7,20,0
Daniel Ruiz Rivera,COL,"FW,MF",21,Santos,Brazilian League,2.7,7,3,3,2,2,4,8,50.0,4,4,0,4,1,8,1,0
Vladimir,BRA,GK,33,Santos,Brazilian League,2.3,0,0,0,0,0,0,1,0.0,1,0,0,0,0,0,0,1
Sandry,BRA,MF,20,Santos,Brazilian League,2.1,6,3,4,1,1,2,6,33.3,4,4,3,1,2,8,0,0
Alison,BRA,MF,29,Santos,Brazilian League,1.5,3,1,1,2,0,1,4,25.0,3,5,2,3,3,6,5,0
Luan Dias,BRA,"MF,FW",25,Santos,Brazilian League,2.1,8,6,2,5,1,1,8,12.5,7,3,1,2,1,9,0,0
Júnior Caiçara,BRA,DF,33,Santos,Brazilian League,1.9,5,3,3,1,1,3,7,42.9,4,2,1,1,2,7,8,0
Lucas Barbosa,BRA,"FW,MF",21,Santos,Brazilian League,1.1,12,5,3,9,0,6,11,54.5,5,8,3,5,2,14,3,0
Felipe Jonatan,BRA,DF,24,Santos,Brazilian League,1.0,0,0,0,0,0,0,1,0.0,1,2,0,2,0,0,0,0
Alfredo Morelos,COL,"FW,MF",26,Santos,Brazilian League,0.9,1,1,1,0,0,0,0,0.0,0,0,0,0,1,2,0,0
Bruno Mezenga,BRA,"FW,MF",34,Santos,Brazilian League,1.9,3,1,0,2,1,1,2,50.0,1,3,0,3,0,3,3,0
Weslley Patati,BRA,"FW,MF",19,Santos,Brazilian League,1.5,5,2,1,3,1,3,9,33.3,6,3,0,3,4,9,1,0
Maicon,BRA,DF,34,Santos,Brazilian League,0.5,0,0,0,0,0,0,0,0.0,0,0,0,0,1,1,6,0
Ed Carlos,BRA,"MF,FW",21,Santos,Brazilian League,0.4,1,1,1,0,0,0,1,0.0,1,0,0,0,0,1,1,0
Miguel Terceros,BOL,"MF,FW",18,Santos,Brazilian League,0.4,0,0,0,0,0,0,0,0.0,0,1,0,1,1,1,0,0
Jair Paula,BRA,DF,17,Santos,Brazilian League,0.4,0,0,0,0,0,0,0,0.0,0,0,0,0,0,0,2,0
Vinicius,BRA,MF,23,Santos,Brazilian League,0.3,0,0,0,0,0,0,0,0.0,0,0,0,0,0,0,0,0
Cadu,BRA,DF,20,Santos,Brazilian League,0.2,0,0,0,0,0,0,0,0.0,0,0,0,0,0,0,0,0
Ivonei,BRA,MF,20,Santos,Brazilian League,0.0,0,0,0,0,0,0,1,0.0,1,0,0,0,0,0,0,0
Luiz Felipe,BRA,DF,29,Santos,Brazilian League,0.0,0,0,0,0,0,0,0,0.0,0,0,0,0,0,0,0,0
Tadeu,BRA,GK,30,Goiás,Brazilian League,35.0,1,0,1,0,0,1,3,33.3,2,0,0,0,0,1,17,2
Maguinho,BRA,DF,30,Goiás,Brazilian League,31.7,50,32,28,16,6,25,52,48.1,27,42,21,21,39,89,86,1
Bruno Melo,BRA,DF,30,Goiás,Brazilian League,32.1,21,13,15,5,1,8,18,44.4,10,24,15,9,17,38,132,2
Everton Morelli,BRA,MF,25,Goiás,Brazilian League,28.7,69,48,37,27,5,32,58,55.2,26,28,6,22,28,97,43,1
Lucas Halter,BRA,DF,22,Goiás,Brazilian League,28.7,39,31,32,5,2,26,41,63.4,15,38,24,14,38,77,134,2
Willian,BRA,MF,29,Goiás,Brazilian League,24.4,54,31,21,29,4,24,50,48.0,26,30,15,15,50,104,61,1
Guilherme,BRA,MF,31,Goiás,Brazilian League,20.6,27,16,12,10,5,13,28,46.4,15,21,7,14,12,39,14,1
Julián Palacios,ARG,"FW,MF",23,Goiás,Brazilian League,18.1,27,16,4,13,10,9,45,20.0,36,13,0,13,12,39,6,0
Anderson,BRA,"FW,MF",24,Goiás,Brazilian League,14.3,24,16,11,10,3,15,26,57.7,11,8,0,8,3,27,5,0
Sander,BRA,DF,32,Goiás,Brazilian League,17.1,38,24,19,18,1,25,42,59.5,17,19,5,14,23,61,47,0
Hugo,BRA,DF,25,Goiás,Brazilian League,15.8,32,18,17,11,4,16,22,72.7,6,20,4,16,21,53,63,0
Allano,BRA,FW,27,Goiás,Brazilian League,13.7,38,20,25,10,3,26,49,53.1,23,17,1,16,12,50,14,0
Vinícius,BRA,FW,29,Goiás,Brazilian League,13.0,18,13,7,8,3,8,20,40.0,12,8,1,7,12,30,24,0
Zé Ricardo,BRA,MF,23,Goiás,Brazilian League,11.9,25,14,12,10,3,9,28,32.1,19,20,9,11,15,40,13,1
João Magno,BRA,FW,25,Goiás,Brazilian League,10.9,5,4,1,3,1,1,5,20.0,4,9,1,8,2,7,18,0
Dieguinho,BRA,"DF,FW",27,Goiás,Brazilian League,12.0,24,18,12,9,3,8,25,32.0,17,6,1,5,12,36,20,0
Sidimar,BRA,DF,30,Goiás,Brazilian League,11.2,14,6,10,3,1,3,7,42.9,4,13,11,2,11,25,80,0
Matheus Peixoto,BRA,FW,27,Goiás,Brazilian League,9.8,9,5,3,3,3,4,6,66.7,2,7,2,5,4,13,13,0
Matheus Babi,BRA,FW,25,Goiás,Brazilian League,9.8,7,4,1,4,2,4,11,36.4,7,6,1,5,1,8,10,0
Raphael Guzzo,POR,MF,28,Goiás,Brazilian League,6.4,7,3,1,3,3,2,8,25.0,6,9,4,5,2,9,10,0
Luis Oyama,BRA,MF,26,Goiás,Brazilian League,6.2,7,5,1,6,0,1,10,10.0,9,8,2,6,8,15,4,0
Bruno Araújo dos Santos,BRA,DF,29,Goiás,Brazilian League,5.0,10,6,7,2,1,6,11,54.5,5,7,2,5,7,17,19,0
EDU,BRA,DF,22,Goiás,Brazilian League,4.8,4,2,2,1,1,2,4,50.0,2,8,5,3,4,8,32,0
Diego Gonçalves,BRA,"FW,MF",28,Goiás,Brazilian League,4.0,3,3,3,0,0,3,12,25.0,9,8,1,7,2,5,3,1
Alesson,BRA,"FW,MF",23,Goiás,Brazilian League,7.3,17,10,12,3,2,12,27,44.4,15,5,1,4,1,18,7,0
Marcelo Rangel,BRA,GK,34,Goiás,Brazilian League,3.0,0,0,0,0,0,0,0,0.0,0,0,0,0,0,0,0,0
Apodi,BRA,"FW,MF",36,Goiás,Brazilian League,4.2,5,4,3,1,1,3,4,75.0,1,2,1,1,2,7,8,0
Higor Meritão,BRA,MF,28,Goiás,Brazilian League,2.5,8,2,4,3,1,4,12,33.3,8,4,0,4,3,11,6,0
Pedro Oliveira,BRA,"FW,MF",18,Goiás,Brazilian League,2.2,5,5,0,4,1,1,3,33.3,2,2,1,1,0,5,1,0
Matheus Santos,BRA,"FW,MF",24,Goiás,Brazilian League,2.2,2,1,1,1,0,1,9,11.1,8,1,1,0,1,3,1,0
Gabriel Novaes,BRA,FW,23,Goiás,Brazilian League,1.1,1,1,0,1,0,1,5,20.0,4,2,1,1,0,1,2,0
Dodô,BRA,"MF,FW",21,Goiás,Brazilian League,3.6,4,4,1,2,1,2,6,33.3,4,1,0,1,1,5,2,0
Philippe Costa,BRA,FW,22,Goiás,Brazilian League,1.2,0,0,0,0,0,0,1,0.0,1,0,0,0,0,0,1,0
Breno Herculano,BRA,"FW,MF",23,Goiás,Brazilian League,0.9,0,0,0,0,0,0,0,0.0,0,1,0,1,0,0,1,0
Xavier,BRA,DF,22,Goiás,Brazilian League,0.7,5,4,3,2,0,2,4,50.0,2,0,0,0,1,6,1,0
Lucas Emmanuel,BRA,FW,22,Goiás,Brazilian League,0.6,1,0,0,0,1,0,1,0.0,1,1,0,1,0,1,0,0
Mina,BRA,DF,19,Goiás,Brazilian League,0.5,2,0,2,0,0,0,0,0.0,0,0,0,0,0,2,0,0
Simioni,BRA,MF,19,Goiás,Brazilian League,0.5,2,1,0,2,0,1,1,100.0,0,0,0,0,2,4,2,0
Fellipe Bastos,BRA,MF,32,Goiás,Brazilian League,0.4,1,0,1,0,0,1,1,100.0,0,1,1,0,1,2,0,0
Halerrandrio dos Santos,BRA,MF,16,Goiás,Brazilian League,0.3,2,2,2,0,0,1,2,50.0,1,1,0,1,0,2,0,0
Denzel,BRA,FW,20,Goiás,Brazilian League,0.3,0,0,0,0,0,0,0,0.0,0,0,0,0,0,0,0,0
Jhonny Lucas,BRA,MF,22,Goiás,Brazilian League,0.2,0,0,0,0,0,0,0,0.0,0,1,0,1,0,0,0,0
Gabriel,BRA,GK,30,Coritiba,Brazilian League,30.7,2,1,2,0,0,2,2,100.0,0,0,0,0,0,2,20,2
Robson,BRA,"MF,FW",31,Coritiba,Brazilian League,26.1,52,29,23,23,6,20,56,35.7,36,28,5,23,20,72,28,1
Natanael,BRA,DF,21,Coritiba,Brazilian League,27.8,91,63,55,29,7,54,87,62.1,33,39,10,29,31,122,70,1
Marcelino Moreno,ARG,MF,28,Coritiba,Brazilian League,25.6,32,19,11,19,2,8,27,29.6,19,15,2,13,13,45,5,0
Bruno Gomes,BRA,MF,21,Coritiba,Brazilian League,24.4,56,28,19,26,11,33,76,43.4,43,23,2,21,33,89,18,0
Benjamín Kuscevic,CHI,DF,26,Coritiba,Brazilian League,22.5,41,26,27,12,2,27,47,57.4,20,44,28,16,38,79,111,0
Henrique,BRA,DF,36,Coritiba,Brazilian League,22.5,16,5,10,6,0,11,22,50.0,11,29,21,8,18,34,129,2
Jamerson,BRA,"DF,FW",24,Coritiba,Brazilian League,21.0,50,32,32,14,4,29,43,67.4,14,27,6,21,28,78,51,0
Sebastián Gómez,COL,MF,26,Coritiba,Brazilian League,15.9,23,14,8,10,5,13,34,38.2,21,18,3,15,15,38,12,0
Victor Luis,BRA,DF,29,Coritiba,Brazilian League,17.4,27,21,16,9,2,15,31,48.4,16,25,11,14,27,54,41,0
Matheus Bianqui,BRA,MF,25,Coritiba,Brazilian League,15.8,44,25,11,30,3,17,36,47.2,19,34,10,24,20,64,33,0
Andrey Ramos do Nascimento,BRA,MF,24,Coritiba,Brazilian League,12.5,37,21,18,16,3,14,35,40.0,21,19,3,16,20,57,23,0
Willian Farias,BRA,MF,33,Coritiba,Brazilian League,10.7,15,10,3,11,1,7,15,46.7,8,12,4,8,23,38,15,1
Thalisson Gabriel,BRA,DF,21,Coritiba,Brazilian League,10.5,9,8,8,1,0,6,15,40.0,9,10,6,4,11,20,58,1
Islam Slimani,ALG,FW,34,Coritiba,Brazilian League,9.1,2,0,0,1,1,0,6,0.0,6,6,1,5,0,2,14,0
Kaio,BRA,"MF,FW",18,Coritiba,Brazilian League,9.8,22,16,12,4,6,9,28,32.1,19,9,3,6,7,29,5,0
Bruno Viana,BRA,DF,27,Coritiba,Brazilian League,9.0,11,6,7,4,0,5,8,62.5,3,14,8,6,12,23,40,0
Alef Manga,BRA,"FW,MF",28,Coritiba,Brazilian League,8.9,10,7,4,3,3,5,8,62.5,3,4,0,4,3,13,5,0
Diogo,BRA,"FW,MF",26,Coritiba,Brazilian League,8.4,18,13,9,7,2,7,14,50.0,7,8,0,8,4,22,6,0
Liziero,BRA,MF,24,Coritiba,Brazilian League,6.5,15,10,4,11,0,9,23,39.1,14,8,3,5,8,23,9,0
Zé Roberto,BRA,"FW,MF",29,Coritiba,Brazilian League,5.8,5,4,1,3,1,0,5,0.0,5,4,1,3,1,6,6,0
Thiago Dombroski,BRA,DF,20,Coritiba,Brazilian League,5.6,2,2,1,1,0,1,4,25.0,3,4,2,2,6,8,28,0
Jean Pedroso,BRA,DF,19,Coritiba,Brazilian League,6.5,10,9,8,2,0,5,15,33.3,10,8,3,5,8,18,13,1
Diogo Batista,BRA,"DF,MF",19,Coritiba,Brazilian League,5.9,13,5,8,2,3,8,17,47.1,9,10,2,8,2,15,19,0
Rodrigo Pinho,BRA,FW,31,Coritiba,Brazilian League,4.3,5,1,1,4,0,0,8,0.0,8,6,2,4,1,6,4,0
Maurício Garcez,BRA,"MF,FW",25,Coritiba,Brazilian League,6.6,12,7,4,5,3,6,8,75.0,2,5,1,4,0,12,11,0
Fransérgio,BRA,MF,32,Coritiba,Brazilian League,5.9,11,4,5,5,1,6,10,60.0,4,6,2,4,5,16,13,0
Luan Polli,BRA,GK,29,Coritiba,Brazilian League,4.3,0,0,0,0,0,0,0,0.0,0,0,0,0,0,0,3,3
Andreas Samaris,GRE,MF,33,Coritiba,Brazilian League,2.0,4,2,1,2,1,3,7,42.9,4,3,0,3,4,8,3,0
Gabriel Boschilia,BRA,"MF,FW",26,Coritiba,Brazilian League,3.8,12,5,3,8,1,7,13,53.8,6,5,1,4,1,13,3,0
Hayner,BRA,"DF,MF",27,Coritiba,Brazilian League,3.4,5,4,3,2,0,2,3,66.7,1,5,1,4,1,6,9,0
Jhon Chancellor,VEN,DF,31,Coritiba,Brazilian League,3.4,6,4,6,0,0,4,4,100.0,0,5,4,1,2,8,21,0
Pedro Luccas,BRA,GK,19,Coritiba,Brazilian League,3.0,0,0,0,0,0,0,0,0.0,0,0,0,0,0,0,1,0
Edu,BRA,"FW,MF",29,Coritiba,Brazilian League,3.6,0,0,0,0,0,0,1,0.0,1,3,0,3,0,0,2,0
Júnior Urso,BRA,MF,33,Coritiba,Brazilian League,3.3,4,3,3,1,0,3,7,42.9,4,2,0,2,2,6,4,0
Reynaldo Cesar Moraes,BRA,DF,26,Coritiba,Brazilian League,2.7,4,3,4,0,0,1,2,50.0,1,2,2,0,7,11,19,0
Maurício Antônio,BRA,DF,30,Coritiba,Brazilian League,2.0,0,0,0,0,0,0,0,0.0,0,5,4,1,5,5,18,0
Marcos Vinicius,BRA,"DF,MF",25,Coritiba,Brazilian League,1.9,4,4,1,3,0,1,2,50.0,1,0,0,0,4,8,6,0
William Pottker,BRA,"FW,MF",29,Coritiba,Brazilian League,1.3,2,2,1,1,0,0,1,0.0,1,1,1,0,1,3,1,0
Gabriel Silva,BRA,"FW,MF",20,Coritiba,Brazilian League,1.0,3,2,0,3,0,1,1,100.0,0,0,0,0,1,4,0,0
Gustavo Vilar,BRA,DF,22,Coritiba,Brazilian League,1.0,0,0,0,0,0,0,0,0.0,0,0,0,0,1,1,3,0
Lucas Barbosa,BRA,"MF,FW",21,Coritiba,Brazilian League,1.1,4,2,1,2,1,1,2,50.0,1,2,0,2,2,6,3,0
Jesé,ESP,MF,29,Coritiba,Brazilian League,1.1,0,0,0,0,0,0,1,0.0,1,1,0,1,0,0,0,0
Lucas Ronier,BRA,"FW,MF",18,Coritiba,Brazilian League,0.6,1,1,1,0,0,1,2,50.0,1,1,0,1,0,1,0,0
Wesley Pombo,BRA,MF,20,Coritiba,Brazilian League,0.6,2,0,0,1,1,2,3,66.7,1,0,0,0,0,2,0,0
Ruan Lucas,BRA,"MF,FW",18,Coritiba,Brazilian League,0.3,0,0,0,0,0,0,2,0.0,2,2,0,2,0,0,0,0
Eberth,BRA,FW,19,Coritiba,Brazilian League,0.3,0,0,0,0,0,0,0,0.0,0,1,0,1,0,0,0,0
Juninho,BRA,MF,35,América (MG),Brazilian League,32.5,44,26,14,23,7,15,51,29.4,36,32,7,25,31,75,43,0
Leandro Emmanuel Martínez,ARG,MF,28,América (MG),Brazilian League,28.2,60,40,20,36,4,25,92,27.2,67,51,11,40,31,91,21,1
Felipe Azevedo,BRA,"FW,MF",36,América (MG),Brazilian League,19.4,17,10,7,5,5,11,26,42.3,15,16,3,13,10,27,17,0
Iago Maidana,BRA,DF,26,América (MG),Brazilian League,24.0,32,15,22,9,1,12,22,54.5,10,31,21,10,32,64,107,0
Danilo Avelar,BRA,DF,33,América (MG),Brazilian League,22.0,35,22,15,18,2,17,31,54.8,14,20,10,10,35,70,72,0
Gonzalo Mastriani,URU,FW,29,América (MG),Brazilian League,19.9,11,7,0,6,5,6,20,30.0,14,11,3,8,1,12,11,0
Marlon,BRA,DF,28,América (MG),Brazilian League,18.6,37,26,20,16,1,22,36,61.1,14,32,6,26,31,68,49,0
Ricardo Silva,BRA,DF,30,América (MG),Brazilian League,17.9,25,17,19,6,0,18,28,64.3,10,28,17,11,28,53,91,1
Eder,BRA,DF,27,América (MG),Brazilian League,17.4,23,14,14,7,2,15,21,71.4,6,34,21,13,19,42,99,1
Lucas Kal,BRA,MF,26,América (MG),Brazilian League,13.7,17,7,13,3,1,10,31,32.3,21,13,5,8,15,32,24,0
Matheus Cavichioli,BRA,GK,36,América (MG),Brazilian League,15.0,1,1,1,0,0,1,2,50.0,1,0,0,0,1,2,8,2
Rodriguinho,BRA,"DF,MF",19,América (MG),Brazilian League,13.9,24,16,17,7,0,13,38,34.2,25,18,2,16,9,33,21,0
Everaldo,BRA,"FW,MF",28,América (MG),Brazilian League,13.7,22,16,12,8,2,12,28,42.9,16,12,0,12,6,28,5,0
Ale,BRA,MF,32,América (MG),Brazilian League,15.8,38,16,17,19,2,12,37,32.4,25,21,5,16,28,66,24,0
Martín Benítez,ARG,"MF,FW",28,América (MG),Brazilian League,12.4,11,7,5,3,3,4,14,28.6,10,7,0,7,6,17,3,0
Breno Cascardo,BRA,MF,19,América (MG),Brazilian League,12.9,31,19,11,16,4,13,43,30.2,30,20,1,19,10,41,11,0
Jori,BRA,GK,26,América (MG),Brazilian League,11.0,1,1,1,0,0,1,2,50.0,1,0,0,0,0,1,9,0
Mateus Pasinato,BRA,GK,30,América (MG),Brazilian League,10.0,0,0,0,0,0,0,1,0.0,1,0,0,0,0,0,6,2
Marcinho,BRA,DF,26,América (MG),Brazilian League,8.9,11,7,7,3,1,6,22,27.3,16,14,5,9,17,28,32,1
Aloísio dos Santos Gonçalves,CHN,"FW,MF",34,América (MG),Brazilian League,8.0,5,4,1,2,2,2,16,12.5,14,5,1,4,2,7,4,0
Daniel Borges,BRA,DF,29,América (MG),Brazilian League,8.9,18,12,9,7,2,8,14,57.1,6,9,3,6,14,32,30,0
Nicolas,BRA,DF,25,América (MG),Brazilian League,8.0,12,6,9,3,0,5,14,35.7,9,19,5,14,11,23,28,0
Mateus Henrique,BRA,DF,20,América (MG),Brazilian League,6.0,12,8,9,3,0,6,15,40.0,9,14,5,9,5,17,22,0
Júlio César,BRA,DF,19,América (MG),Brazilian League,6.6,9,7,6,3,0,7,9,77.8,2,15,10,5,4,13,41,0
Wanderson,BRA,DF,31,América (MG),Brazilian League,5.6,5,4,4,0,1,1,7,14.3,6,6,4,2,4,9,28,0
Rodrigo Varanda,BRA,"FW,MF",20,América (MG),Brazilian League,5.7,8,5,3,2,3,4,15,26.7,11,9,0,9,0,8,5,0
Renato Marques,BRA,"FW,MF",19,América (MG),Brazilian League,5.7,4,2,3,1,0,2,5,40.0,3,1,0,1,2,6,5,0
Pedrinho,BRA,"FW,MF",23,América (MG),Brazilian League,4.6,5,1,2,3,0,2,9,22.2,7,1,0,1,6,11,2,0
Esteban Burgos,ARG,DF,31,América (MG),Brazilian League,3.3,2,1,1,1,0,2,3,66.7,1,5,2,3,1,3,24,0
Oscar Méndez,URU,MF,28,América (MG),Brazilian League,2.9,8,6,0,8,0,4,10,40.0,6,3,1,2,4,12,11,0
Matheusinho,BRA,"MF,FW",24,América (MG),Brazilian League,2.5,5,3,3,1,1,1,3,33.3,2,4,0,4,1,6,0,0
Nino Paraíba,BRA,DF,37,América (MG),Brazilian League,2.2,2,2,0,2,0,0,2,0.0,2,2,0,2,4,6,2,0
Washington Aguerre,URU,GK,29,América (MG),Brazilian League,2.0,0,0,0,0,0,0,0,0.0,0,0,0,0,0,0,3,0
Henrique Almeida,BRA,FW,31,América (MG),Brazilian League,1.7,2,1,0,0,2,0,2,0.0,2,0,0,0,0,2,1,0
Paulinho Bóia,BRA,FW,24,América (MG),Brazilian League,1.5,2,2,0,2,0,2,3,66.7,1,0,0,0,0,2,0,0
Juan Cazares,ECU,"MF,FW",30,América (MG),Brazilian League,3.1,4,2,2,2,0,1,5,20.0,4,3,0,3,0,4,0,0
Adyson,BRA,"FW,MF",17,América (MG),Brazilian League,2.7,8,5,3,3,2,3,6,50.0,3,1,0,1,5,13,0,0
Mikael,BRA,FW,23,América (MG),Brazilian League,1.7,2,1,0,2,0,1,5,20.0,4,0,0,0,0,2,0,0
Arthur,BRA,DF,19,América (MG),Brazilian League,1.0,2,1,0,2,0,0,0,0.0,0,0,0,0,1,3,1,0
Wellington Paulista,BRA,FW,38,América (MG),Brazilian League,2.5,0,0,0,0,0,0,1,0.0,1,1,0,1,0,0,1,0
Mateus Gonçalves Martins,BRA,"MF,FW",28,América (MG),Brazilian League,0.7,2,2,0,1,1,1,1,100.0,0,1,0,1,0,2,1,0
Renato Kayser,BRA,"FW,MF",26,América (MG),Brazilian League,0.4,0,0,0,0,0,0,0,0.0,0,0,0,0,0,0,0,0
Ighor Gabryel,BRA,FW,20,América (MG),Brazilian League,0.3,0,0,0,0,0,0,0,0.0,0,0,0,0,0,0,1,0
Paulinho,BRA,DF,18,América (MG),Brazilian League,0.3,1,0,1,0,0,1,1,100.0,0,0,0,0,0,1,1,0
Jhow,BRA,DF,19,América (MG),Brazilian League,0.2,0,0,0,0,0,0,0,0.0,0,0,0,0,0,0,1,0
Yago Souza,BRA,MF,16,América (MG),Brazilian League,0.2,0,0,0,0,0,0,0,0.0,0,0,0,0,0,0,0,0
Lukáš Hrádecký,FIN,GK,33,Leverkusen,Bundesliga,33.0,0,0,0,0,0,0,1,0.0,1,1,0,1,0,0,10,2
Granit Xhaka,SUI,MF,30,Leverkusen,Bundesliga,31.3,29,21,11,14,4,9,30,30.0,21,29,8,21,19,48,42,0
Alex Grimaldo,ESP,DF,27,Leverkusen,Bundesliga,30.9,45,24,26,10,9,30,55,54.5,25,32,7,25,22,67,41,0
Jonathan Tah,GER,DF,27,Leverkusen,Bundesliga,29.2,19,9,10,7,2,5,16,31.3,11,28,23,5,23,42,97,1
Jeremie Frimpong,NED,DF,22,Leverkusen,Bundesliga,25.0,26,17,12,7,7,8,20,40.0,12,26,0,26,7,33,17,0
Florian Wirtz,GER,MF,20,Leverkusen,Bundesliga,26.4,27,18,7,14,6,9,29,31.0,20,36,2,34,9,36,3,0
Jonas Hofmann,GER,MF,31,Leverkusen,Bundesliga,24.5,20,14,6,9,5,10,24,41.7,14,18,0,18,8,28,6,0
Edmond Tapsoba,BFA,DF,24,Leverkusen,Bundesliga,23.2,34,25,17,15,2,17,24,70.8,7,21,10,11,24,58,52,3
Exequiel Palacios,ARG,MF,24,Leverkusen,Bundesliga,20.3,60,34,28,26,6,26,53,49.1,27,24,0,24,29,89,20,2
Odilon Kossonou,CIV,DF,22,Leverkusen,Bundesliga,20.1,30,20,11,12,7,15,26,57.7,11,27,3,24,27,57,43,1
Robert Andrich,GER,"MF,DF",28,Leverkusen,Bundesliga,18.8,30,18,8,14,8,13,24,54.2,11,15,4,11,20,50,17,0
Victor Boniface,NGA,FW,22,Leverkusen,Bundesliga,17.2,6,4,0,1,5,1,4,25.0,3,6,1,5,0,6,13,0
Piero Hincapié,ECU,DF,21,Leverkusen,Bundesliga,16.5,35,22,14,17,4,13,17,76.5,4,18,7,11,13,48,43,0
Josip Stanišić,CRO,DF,23,Leverkusen,Bundesliga,14.0,38,20,19,13,6,22,33,66.7,11,18,3,15,9,47,26,0
Patrik Schick,CZE,FW,27,Leverkusen,Bundesliga,11.8,6,4,0,3,3,1,5,20.0,4,2,0,2,1,7,7,0
Amine Adli,MAR,"MF,FW",23,Leverkusen,Bundesliga,10.0,16,7,2,10,4,7,17,41.2,10,10,2,8,6,22,5,0
Nathan Tella,NGA,"DF,MF",24,Leverkusen,Bundesliga,9.1,13,8,6,5,2,5,10,50.0,5,10,0,10,3,16,8,0
Adam Hložek,CZE,"MF,FW",21,Leverkusen,Bundesliga,5.1,10,4,2,4,4,3,7,42.9,4,4,1,3,2,12,1,0
Borja Iglesias,ESP,FW,30,Leverkusen,Bundesliga,2.8,1,0,0,1,0,0,1,0.0,1,2,0,2,1,2,1,0
Arthur,BRA,DF,20,Leverkusen,Bundesliga,2.0,4,3,2,0,2,2,2,100.0,0,1,1,0,0,4,7,0
Matej Kovar,CZE,GK,23,Leverkusen,Bundesliga,1.0,0,0,0,0,0,0,0,0.0,0,0,0,0,0,0,0,0
Nadiem Amiri,GER,MF,26,Leverkusen,Bundesliga,1.0,4,2,0,3,1,0,3,0.0,3,0,0,0,0,4,1,0
Gustavo Puerta,COL,"DF,MF",20,Leverkusen,Bundesliga,0.5,5,3,2,2,1,1,2,50.0,1,2,0,2,0,5,0,0
Noah Mbamba,BEL,MF,18,Leverkusen,Bundesliga,0.2,0,0,0,0,0,0,0,0.0,0,0,0,0,1,1,0,0
Chris Führich,GER,"FW,MF",25,Stuttgart,Bundesliga,28.5,30,19,6,14,10,16,37,43.2,21,31,0,31,7,37,7,0
Waldemar Anton,GER,DF,27,Stuttgart,Bundesliga,32.1,39,25,21,16,2,23,42,54.8,19,33,20,13,40,79,150,1
Atakan Karazor,GER,MF,26,Stuttgart,Bundesliga,29.1,72,44,23,38,11,29,60,48.3,31,37,8,29,27,99,43,0
Alexander Nübel,GER,GK,26,Stuttgart,Bundesliga,30.0,2,2,2,0,0,2,4,50.0,2,0,0,0,0,2,13,4
Angelo Stiller,GER,MF,22,Stuttgart,Bundesliga,29.9,55,33,15,34,6,24,42,57.1,18,41,13,28,28,83,25,2
Enzo Millot,FRA,"MF,FW",21,Stuttgart,Bundesliga,24.9,40,22,9,21,10,18,39,46.2,21,24,2,22,16,56,7,1
Hiroki Ito,JPN,DF,24,Stuttgart,Bundesliga,24.8,19,18,13,6,0,11,26,42.3,15,29,17,12,29,48,86,2
Serhou Guirassy,GUI,FW,27,Stuttgart,Bundesliga,24.5,6,3,1,4,1,2,5,40.0,3,8,1,7,6,12,29,0
Maximilian Mittelstädt,GER,DF,26,Stuttgart,Bundesliga,23.4,91,51,46,39,6,53,89,59.6,36,36,6,30,46,137,65,0
Deniz Undav,GER,"FW,MF",27,Stuttgart,Bundesliga,23.2,28,13,6,8,14,4,15,26.7,11,17,0,17,6,34,5,0
Jamie Leweling,GER,"FW,MF",22,Stuttgart,Bundesliga,16.9,18,10,4,6,8,5,17,29.4,12,21,1,20,5,23,13,0
Dan-Axel Zagadou,FRA,DF,24,Stuttgart,Bundesliga,16.1,21,14,16,5,0,4,8,50.0,4,23,18,5,20,41,78,1
Pascal Stenzel,GER,DF,27,Stuttgart,Bundesliga,11.8,18,8,7,9,2,10,30,33.3,20,22,8,14,15,33,26,0
Josha Vagnoman,GER,DF,22,Stuttgart,Bundesliga,13.1,28,18,15,11,2,15,30,50.0,15,11,5,6,2,30,16,1
Anthony Rouault,FRA,DF,22,Stuttgart,Bundesliga,11.2,21,12,14,5,2,13,21,61.9,8,14,8,6,8,29,28,0
Silas Katompa,COD,"FW,MF",24,Stuttgart,Bundesliga,10.0,5,3,3,2,0,3,12,25.0,9,9,0,9,0,5,4,0
Leonidas Stergiou,SUI,DF,21,Stuttgart,Bundesliga,6.6,15,8,7,7,1,9,13,69.2,4,8,1,7,5,20,13,0
Jeong Woo-yeong,KOR,"MF,FW",23,Stuttgart,Bundesliga,7.0,15,9,6,8,1,6,8,75.0,2,5,0,5,7,22,5,0
Fabian Bredlow,GER,GK,28,Stuttgart,Bundesliga,4.0,0,0,0,0,0,0,1,0.0,1,0,0,0,0,0,3,0
Mahmoud Dahoud,GER,MF,27,Stuttgart,Bundesliga,2.5,5,1,1,4,0,3,7,42.9,4,4,0,4,0,5,1,0
Lilian Egloff,GER,"MF,DF",20,Stuttgart,Bundesliga,1.2,4,1,3,1,0,2,4,50.0,2,3,1,2,1,5,0,0
Roberto Massimo,GER,"FW,DF",22,Stuttgart,Bundesliga,0.9,1,0,1,0,0,1,2,50.0,1,0,0,0,0,1,1,0
Borna Sosa,CRO,"FW,DF",25,Stuttgart,Bundesliga,0.5,0,0,0,0,0,0,1,0.0,1,0,0,0,0,0,0,0
Luca Raimund,GER,"FW,MF",18,Stuttgart,Bundesliga,0.3,3,1,2,1,0,0,0,0.0,0,2,0,2,0,3,0,0
Jovan Milošević,SRB,"FW,MF",18,Stuttgart,Bundesliga,0.3,0,0,0,0,0,0,0,0.0,0,0,0,0,0,0,0,0
Genki Haraguchi,JPN,MF,32,Stuttgart,Bundesliga,0.3,1,1,1,0,0,0,0,0.0,0,0,0,0,0,1,1,0
Samuele Di Benedetto,GER,MF,18,Stuttgart,Bundesliga,0.1,0,0,0,0,0,0,0,0.0,0,0,0,0,1,1,0,0
Harry Kane,ENG,FW,30,Bayern Munich,Bundesliga,31.5,13,9,4,4,5,6,18,33.3,12,12,4,8,6,19,14,0
Joshua Kimmich,GER,"MF,DF",28,Bayern Munich,Bundesliga,24.2,45,33,25,15,5,26,39,66.7,13,32,4,28,14,59,28,1
Leon Goretzka,GER,MF,28,Bayern Munich,Bundesliga,24.9,41,23,18,14,9,24,54,44.4,30,44,8,36,31,72,42,1
Leroy Sané,GER,FW,27,Bayern Munich,Bundesliga,23.7,15,8,6,6,3,4,19,21.1,15,12,0,12,7,22,3,0
Alphonso Davies,CAN,DF,22,Bayern Munich,Bundesliga,22.9,47,24,29,13,5,30,53,56.6,23,30,4,26,26,73,49,1
Manuel Neuer,GER,GK,37,Bayern Munich,Bundesliga,22.8,1,1,1,0,0,0,0,0.0,0,0,0,0,0,1,14,3
Kim Min-jae,KOR,DF,26,Bayern Munich,Bundesliga,21.9,37,24,21,11,5,12,24,50.0,12,29,19,10,45,82,70,2
Jamal Musiala,GER,"MF,FW",20,Bayern Munich,Bundesliga,19.5,40,25,9,21,10,14,36,38.9,22,25,1,24,16,56,5,0
Thomas Müller,GER,"MF,FW",33,Bayern Munich,Bundesliga,18.4,26,16,5,10,11,13,35,37.1,22,22,0,22,3,29,6,0
Dayot Upamecano,FRA,DF,24,Bayern Munich,Bundesliga,19.6,34,21,21,11,2,15,29,51.7,14,19,7,12,19,53,56,3
Konrad Laimer,AUT,"DF,MF",26,Bayern Munich,Bundesliga,19.7,56,36,25,20,11,22,52,42.3,30,42,6,36,18,74,13,2
Matthijs de Ligt,NED,DF,23,Bayern Munich,Bundesliga,15.4,15,12,4,8,3,6,11,54.5,5,14,10,4,19,34,52,0
Noussair Mazraoui,MAR,DF,25,Bayern Munich,Bundesliga,13.3,32,21,14,11,7,13,21,61.9,8,14,1,13,20,52,27,1
Kingsley Coman,FRA,FW,27,Bayern Munich,Bundesliga,12.4,12,7,5,3,4,9,17,52.9,8,15,1,14,2,14,5,0
Aleksandar Pavlovic,GER,MF,19,Bayern Munich,Bundesliga,13.6,28,16,10,14,4,17,33,51.5,16,13,3,10,17,45,12,0
Raphaël Guerreiro,POR,"DF,MF",29,Bayern Munich,Bundesliga,13.2,19,16,6,9,4,9,15,60.0,6,7,1,6,15,34,5,1
Eric Dier,ENG,DF,29,Bayern Munich,Bundesliga,13.0,11,8,5,5,1,5,6,83.3,1,20,12,8,10,21,48,1
Sven Ulreich,GER,GK,34,Bayern Munich,Bundesliga,11.0,1,0,1,0,0,1,1,100.0,0,0,0,0,0,1,3,2
Eric Maxim Choupo-Moting,CMR,"MF,FW",34,Bayern Munich,Bundesliga,8.0,17,12,8,5,4,6,14,42.9,8,5,0,5,7,24,7,0
Mathys Tel,FRA,"FW,MF",18,Bayern Munich,Bundesliga,11.7,12,2,3,4,5,4,6,66.7,2,11,0,11,6,18,6,0
Serge Gnabry,GER,"FW,MF",28,Bayern Munich,Bundesliga,4.8,8,5,0,5,3,2,13,15.4,11,5,0,5,3,11,2,0
Bryan Zaragoza,ESP,"FW,MF",22,Bayern Munich,Bundesliga,2.0,4,4,2,1,1,3,3,100.0,0,0,0,0,2,6,0,0
Lovro Zvonarek,CRO,"FW,MF",18,Bayern Munich,Bundesliga,1.8,0,0,0,0,0,0,5,0.0,5,3,0,3,0,0,2,0
Sacha Boey,FRA,DF,22,Bayern Munich,Bundesliga,1.2,2,0,2,0,0,1,2,50.0,1,1,0,1,1,3,2,0
Bouna Sarr,SEN,DF,31,Bayern Munich,Bundesliga,1.2,2,0,1,1,0,2,2,100.0,0,3,0,3,0,2,1,0
Frans Krätzig,GER,DF,20,Bayern Munich,Bundesliga,0.6,2,0,2,0,0,1,2,50.0,1,0,0,0,0,2,0,0
Matteo Perez Vinlöf,SWE,FW,17,Bayern Munich,Bundesliga,0.2,0,0,0,0,0,0,0,0.0,0,0,0,0,1,1,0,0
Ryan Gravenberch,NED,FW,21,Bayern Munich,Bundesliga,0.1,0,0,0,0,0,0,0,0.0,0,0,0,0,0,0,0,0
Jonathan Asp Jensen,DEN,FW,17,Bayern Munich,Bundesliga,0.0,0,0,0,0,0,0,0,0.0,0,0,0,0,0,0,1,0
Loïs Openda,BEL,FW,23,RB Leipzig,Bundesliga,30.0,3,3,0,1,2,0,6,0.0,6,19,3,16,5,8,14,0
Xavi Simons,NED,MF,20,RB Leipzig,Bundesliga,29.5,30,17,10,11,9,15,31,48.4,16,23,0,23,16,46,4,0
David Raum,GER,DF,25,RB Leipzig,Bundesliga,30.4,58,35,24,29,5,34,58,58.6,24,51,9,42,27,85,82,2
Xaver Schlager,AUT,MF,25,RB Leipzig,Bundesliga,27.5,81,50,35,38,8,21,53,39.6,32,41,8,33,19,100,27,0
Benjamin Henrichs,GER,DF,26,RB Leipzig,Bundesliga,28.1,68,39,32,26,10,27,58,46.6,31,49,4,45,33,101,37,0
Castello Lukeba,FRA,DF,20,RB Leipzig,Bundesliga,24.3,19,12,10,9,0,10,12,83.3,2,35,13,22,12,31,94,2
Mohamed Simakan,FRA,DF,23,RB Leipzig,Bundesliga,23.8,48,29,28,19,1,32,44,72.7,12,36,14,22,29,77,69,0
Janis Blaswich,GER,GK,32,RB Leipzig,Bundesliga,21.0,1,1,1,0,0,0,0,0.0,0,0,0,0,0,1,7,3
Amadou Haidara,MLI,MF,25,RB Leipzig,Bundesliga,17.0,42,27,24,16,2,23,41,56.1,18,28,6,22,21,63,37,0
Willi Orban,HUN,DF,30,RB Leipzig,Bundesliga,17.6,20,12,8,10,2,9,18,50.0,9,22,13,9,16,36,76,1
Benjamin Šeško,SVN,FW,20,RB Leipzig,Bundesliga,17.0,13,5,2,7,4,2,9,22.2,7,23,2,21,3,16,27,0
Dani Olmo,ESP,MF,25,RB Leipzig,Bundesliga,16.1,26,18,14,8,4,10,22,45.5,12,7,0,7,13,39,12,1
Lukas Klostermann,GER,DF,27,RB Leipzig,Bundesliga,16.0,15,10,7,7,1,4,13,30.8,9,25,12,13,13,28,64,1
Kevin Kampl,SVN,MF,32,RB Leipzig,Bundesliga,15.1,19,8,8,9,2,10,21,47.6,11,19,7,12,11,30,14,1
Péter Gulácsi,HUN,GK,33,RB Leipzig,Bundesliga,13.0,0,0,0,0,0,0,0,0.0,0,0,0,0,0,0,8,1
Yussuf Poulsen,DEN,FW,29,RB Leipzig,Bundesliga,13.5,13,8,1,9,3,4,14,28.6,10,13,3,10,4,17,15,0
Christoph Baumgartner,AUT,"MF,FW",23,RB Leipzig,Bundesliga,12.9,26,13,10,12,4,14,38,36.8,24,20,1,19,5,31,14,0
Nicolas Seiwald,AUT,MF,22,RB Leipzig,Bundesliga,8.0,33,18,16,15,2,16,25,64.0,9,12,2,10,8,41,15,0
Emil Forsberg,SWE,"MF,FW",31,RB Leipzig,Bundesliga,5.2,7,3,2,5,0,5,12,41.7,7,7,0,7,0,7,5,0
Elif Elmas,MKD,"MF,FW",23,RB Leipzig,Bundesliga,3.0,8,6,1,6,1,6,8,75.0,2,5,0,5,1,9,2,0
Timo Werner,GER,"FW,MF",27,RB Leipzig,Bundesliga,2.3,2,1,0,1,1,0,0,0.0,0,1,0,1,1,3,0,0
Fabio Carvalho,POR,MF,20,RB Leipzig,Bundesliga,1.8,3,1,0,2,1,1,3,33.3,2,8,0,8,0,3,1,0
Christopher Lenz,GER,"DF,MF",28,RB Leipzig,Bundesliga,0.5,2,1,2,0,0,1,1,100.0,0,0,0,0,2,4,2,0
El Chadaille Bitshiabu,FRA,"DF,MF",18,RB Leipzig,Bundesliga,0.4,1,0,1,0,0,0,0,0.0,0,0,0,0,1,2,4,0
Nuha Jatta,GAM,FW,17,RB Leipzig,Bundesliga,0.0,0,0,0,0,0,0,0,0.0,0,0,0,0,0,0,0,0
Jonathan Norbye,NOR,MF,16,RB Leipzig,Bundesliga,0.0,0,0,0,0,0,0,0,0.0,0,0,0,0,0,0,0,0
Nico Schlotterbeck,GER,DF,23,Dortmund,Bundesliga,31.8,70,50,36,27,7,41,65,63.1,24,52,25,27,45,115,101,3
Gregor Kobel,SUI,GK,25,Dortmund,Bundesliga,26.3,0,0,0,0,0,0,1,0.0,1,0,0,0,0,0,11,0
Niclas Füllkrug,GER,FW,30,Dortmund,Bundesliga,24.6,7,2,1,6,0,2,8,25.0,6,17,4,13,2,9,25,0
Julian Brandt,GER,"MF,FW",27,Dortmund,Bundesliga,24.7,17,14,8,8,1,10,27,37.0,17,20,3,17,8,25,18,0
Marcel Sabitzer,AUT,MF,29,Dortmund,Bundesliga,21.8,39,24,18,20,1,23,42,54.8,19,31,12,19,12,51,34,0
Emre Can,GER,"MF,DF",29,Dortmund,Bundesliga,21.7,63,45,37,23,3,28,48,58.3,20,30,7,23,22,85,41,2
Donyell Malen,NED,"FW,MF",24,Dortmund,Bundesliga,19.8,11,7,5,3,3,2,6,33.3,4,11,4,7,2,13,8,0
Julian Ryerson,NOR,DF,25,Dortmund,Bundesliga,19.6,41,23,26,11,4,27,47,57.4,20,31,7,24,10,51,35,3
Mats Hummels,GER,DF,34,Dortmund,Bundesliga,17.6,52,34,34,12,6,30,53,56.6,23,33,11,22,33,85,82,0
Marco Reus,GER,"MF,FW",34,Dortmund,Bundesliga,17.8,37,25,20,14,3,12,27,44.4,15,17,2,15,5,42,18,0
Ian Maatsen,NED,DF,21,Dortmund,Bundesliga,14.0,30,22,15,9,6,16,30,53.3,14,22,4,18,13,43,26,0
Niklas Süle,GER,DF,27,Dortmund,Bundesliga,16.8,18,10,14,3,1,11,16,68.8,5,25,14,11,25,43,58,2
Jamie Bynoe-Gittens,ENG,"FW,MF",18,Dortmund,Bundesliga,11.8,14,7,6,7,1,2,17,11.8,15,11,2,9,4,18,7,0
Salih Özcan,TUR,MF,25,Dortmund,Bundesliga,13.2,20,12,11,8,1,10,18,55.6,8,28,3,25,17,37,18,1
Marius Wolf,GER,DF,28,Dortmund,Bundesliga,13.0,20,12,8,11,1,11,23,47.8,12,12,2,10,8,28,20,0
Ramy Bensebaini,ALG,DF,28,Dortmund,Bundesliga,11.5,34,21,21,11,2,24,34,70.6,10,22,7,15,16,50,37,0
Jadon Sancho,ENG,"FW,MF",23,Dortmund,Bundesliga,10.5,5,4,1,3,1,0,4,0.0,4,11,0,11,4,9,6,0
Felix Nmecha,GER,MF,22,Dortmund,Bundesliga,11.3,19,13,7,8,4,11,22,50.0,11,18,5,13,11,30,19,0
Karim Adeyemi,GER,"FW,MF",21,Dortmund,Bundesliga,10.1,16,14,9,4,3,8,20,40.0,12,11,0,11,3,19,5,0
Alexander Meyer,GER,GK,32,Dortmund,Bundesliga,7.7,1,1,1,0,0,1,1,100.0,0,0,0,0,0,1,2,1
Thomas Meunier,BEL,DF,31,Dortmund,Bundesliga,6.5,5,1,3,2,0,3,13,23.1,10,8,2,6,4,9,22,0
Sébastien Haller,CIV,FW,29,Dortmund,Bundesliga,4.4,1,0,0,1,0,1,1,100.0,0,4,1,3,0,1,7,0
Youssoufa Moukoko,GER,FW,18,Dortmund,Bundesliga,6.9,4,1,2,2,0,3,7,42.9,4,4,1,3,2,6,4,0
Mateu Morey,ESP,DF,23,Dortmund,Bundesliga,1.2,2,2,1,1,0,2,4,50.0,2,3,1,2,1,3,3,0
Gio Reyna,USA,"MF,FW",20,Dortmund,Bundesliga,3.1,9,6,3,4,2,2,5,40.0,3,5,1,4,2,11,5,0
Antonios Papadopoulos,GER,DF,23,Dortmund,Bundesliga,1.3,6,3,6,0,0,6,7,85.7,1,3,2,1,2,8,7,0
Kjell-Arik Wätjen,GER,"MF,FW",17,Dortmund,Bundesliga,1.2,3,2,2,1,0,2,5,40.0,3,1,1,0,0,3,3,0
Ole Pohlmann,GER,MF,22,Dortmund,Bundesliga,0.6,1,0,0,1,0,1,2,50.0,1,0,0,0,0,1,1,0
Samuel Bamba,GER,FW,19,Dortmund,Bundesliga,0.5,1,1,1,0,0,1,2,50.0,1,0,0,0,0,1,1,0
Hendry Blank,GER,DF,18,Dortmund,Bundesliga,0.5,1,0,1,0,0,1,1,100.0,0,1,0,1,0,1,4,0
Julien Duranville,BEL,"FW,MF",17,Dortmund,Bundesliga,0.1,1,0,0,1,0,1,1,100.0,0,0,0,0,0,1,0,0
Thorgan Hazard,BEL,DF,30,Dortmund,Bundesliga,0.1,0,0,0,0,0,0,0,0.0,0,0,0,0,0,0,0,0
Willian Pacho,ECU,DF,21,Eint Frankfurt,Bundesliga,33.0,62,37,38,23,1,31,53,58.5,22,51,22,29,47,109,152,2
Kevin Trapp,GER,GK,33,Eint Frankfurt,Bundesliga,32.0,0,0,0,0,0,0,0,0.0,0,0,0,0,1,1,9,1
Robin Koch,GER,DF,27,Eint Frankfurt,Bundesliga,30.4,38,23,26,12,0,17,27,63.0,10,33,24,9,32,70,136,2
Tuta,BRA,DF,24,Eint Frankfurt,Bundesliga,28.9,63,33,38,19,6,39,59,66.1,20,29,12,17,36,99,99,0
Omar Marmoush,EGY,"FW,MF",24,Eint Frankfurt,Bundesliga,25.6,21,11,7,8,6,6,16,37.5,10,13,0,13,11,32,7,0
Junior Dina Ebimbe,FRA,"MF,DF",22,Eint Frankfurt,Bundesliga,21.7,44,29,15,17,12,18,41,43.9,23,28,7,21,9,53,39,1
Ellyes Skhiri,TUN,MF,28,Eint Frankfurt,Bundesliga,24.1,44,24,18,19,7,19,36,52.8,17,33,4,29,39,83,47,2
Ansgar Knauff,GER,"MF,DF",21,Eint Frankfurt,Bundesliga,23.4,43,26,17,16,10,17,31,54.8,14,40,3,37,20,63,15,0
Mario Götze,GER,MF,31,Eint Frankfurt,Bundesliga,23.0,51,34,18,25,8,28,62,45.2,34,19,3,16,14,65,10,0
Fares Chaïbi,ALG,"MF,FW",20,Eint Frankfurt,Bundesliga,21.2,27,17,7,12,8,8,18,44.4,10,37,1,36,5,32,19,0
Hugo Larsson,SWE,MF,19,Eint Frankfurt,Bundesliga,21.0,32,18,18,10,4,15,28,53.6,13,34,7,27,29,61,30,1
Aurélio Buta,POR,"DF,MF",26,Eint Frankfurt,Bundesliga,19.4,40,25,19,16,5,21,38,55.3,17,24,5,19,15,55,36,0
Philipp Max,GER,DF,29,Eint Frankfurt,Bundesliga,15.0,26,17,6,18,2,19,26,73.1,7,18,1,17,7,33,18,2
Niels Nkounkou,FRA,"DF,MF",22,Eint Frankfurt,Bundesliga,14.5,54,30,34,17,3,29,64,45.3,35,30,2,28,16,70,30,0
Hugo Ekitike,FRA,FW,21,Eint Frankfurt,Bundesliga,8.0,11,7,3,6,2,4,6,66.7,2,10,0,10,2,13,4,0
Sasa Kalajdzic,AUT,FW,26,Eint Frankfurt,Bundesliga,3.6,2,2,0,2,0,0,0,0.0,0,2,2,0,2,4,6,0
Donny van de Beek,NED,"MF,FW",26,Eint Frankfurt,Bundesliga,4.0,8,3,3,3,2,3,7,42.9,4,5,1,4,3,11,1,0
Hrvoje Smolčić,CRO,DF,22,Eint Frankfurt,Bundesliga,3.9,7,3,7,0,0,4,5,80.0,1,3,1,2,6,13,23,1
Jessic Ngankam,GER,FW,23,Eint Frankfurt,Bundesliga,3.1,3,2,1,1,1,0,0,0.0,0,0,0,0,0,3,1,0
Makoto Hasebe,JPN,"DF,MF",39,Eint Frankfurt,Bundesliga,2.4,4,2,2,2,0,3,6,50.0,3,2,1,1,2,6,5,0
Jens Grahl,GER,GK,34,Eint Frankfurt,Bundesliga,2.0,0,0,0,0,0,0,0,0.0,0,0,0,0,0,0,3,0
Randal Kolo Muani,FRA,FW,24,Eint Frankfurt,Bundesliga,1.7,0,0,0,0,0,0,0,0.0,0,0,0,0,0,0,1,0
Kristijan Jakić,CRO,"MF,FW",26,Eint Frankfurt,Bundesliga,2.2,3,3,1,2,0,1,3,33.3,2,1,0,1,2,5,2,0
Jean Mattéo Bahoya,FRA,"MF,FW",18,Eint Frankfurt,Bundesliga,2.0,3,1,0,3,0,1,4,25.0,3,2,0,2,1,4,1,0
Paxten Aaronson,USA,MF,19,Eint Frankfurt,Bundesliga,1.1,2,2,1,1,0,1,1,100.0,0,2,0,2,0,2,0,0
Nnamdi Collins,GER,DF,19,Eint Frankfurt,Bundesliga,1.0,0,0,0,0,0,0,0,0.0,0,0,0,0,2,2,4,0
Jesper Lindstrøm,DEN,FW,23,Eint Frankfurt,Bundesliga,0.9,1,1,1,0,0,0,0,0.0,0,0,0,0,0,1,0,0
Sebastian Rode,GER,MF,32,Eint Frankfurt,Bundesliga,0.7,6,4,0,5,1,4,6,66.7,2,0,0,0,1,7,1,0
Jens Petter Hauge,NOR,"MF,FW",23,Eint Frankfurt,Bundesliga,1.6,2,1,1,0,1,2,7,28.6,5,5,1,4,0,2,1,0
Nacho Ferri,ESP,"FW,MF",18,Eint Frankfurt,Bundesliga,0.8,3,3,1,2,0,2,3,66.7,1,0,0,0,0,3,2,0
Elias Baum,GER,"DF,MF",17,Eint Frankfurt,Bundesliga,0.3,1,0,0,0,1,0,0,0.0,0,3,2,1,0,1,1,0
Timothy Chandler,USA,"MF,DF",33,Eint Frankfurt,Bundesliga,0.2,0,0,0,0,0,0,0,0.0,0,0,0,0,0,0,0,0
Christopher Lenz,GER,DF,28,Eint Frankfurt,Bundesliga,0.1,1,1,0,1,0,1,1,100.0,0,0,0,0,0,1,1,0
Marko Mladenović,SRB,MF,18,Eint Frankfurt,Bundesliga,0.1,0,0,0,0,0,0,0,0.0,0,0,0,0,0,0,0,0
Oliver Baumann,GER,GK,33,Hoffenheim,Bundesliga,34.0,1,1,1,0,0,1,2,50.0,1,0,0,0,0,1,19,2
Maximilian Beier,GER,"FW,MF",20,Hoffenheim,Bundesliga,26.9,20,12,5,11,4,4,19,21.1,15,21,1,20,9,29,12,0
Pavel Kadeřábek,CZE,"DF,FW",31,Hoffenheim,Bundesliga,26.8,31,19,10,15,6,18,40,45.0,22,22,8,14,23,54,68,0
Ozan Kabak,TUR,DF,23,Hoffenheim,Bundesliga,25.4,48,35,32,14,2,19,33,57.6,14,43,21,22,46,94,106,2
Grischa Prömel,GER,MF,28,Hoffenheim,Bundesliga,23.8,32,18,11,15,6,14,32,43.8,18,22,6,16,22,54,36,0
Anton Stach,GER,MF,24,Hoffenheim,Bundesliga,25.8,73,42,40,27,6,33,63,52.4,30,38,12,26,72,145,67,1
Florian Grillitsch,AUT,"DF,MF",27,Hoffenheim,Bundesliga,25.5,54,28,31,19,4,22,54,40.7,32,41,20,21,52,106,90,2
Andrej Kramarić,CRO,"MF,FW",32,Hoffenheim,Bundesliga,24.4,11,2,5,4,2,6,13,46.2,7,14,2,12,10,21,12,2
Wout Weghorst,NED,FW,30,Hoffenheim,Bundesliga,22.0,13,6,4,7,2,9,15,60.0,6,25,8,17,6,19,24,0
John Brooks,USA,DF,30,Hoffenheim,Bundesliga,17.1,28,15,17,10,1,15,30,50.0,15,29,17,12,27,55,109,1
Ihlas Bebou,TOG,"FW,DF",29,Hoffenheim,Bundesliga,18.2,22,12,10,8,4,8,16,50.0,8,13,2,11,14,36,15,0
Marius Bülter,GER,"DF,FW",30,Hoffenheim,Bundesliga,15.0,18,11,9,5,4,12,23,52.2,11,17,3,14,10,28,20,0
Kevin Vogt,GER,DF,31,Hoffenheim,Bundesliga,14.7,14,10,7,7,0,8,13,61.5,5,16,13,3,9,23,54,0
Robert Skov,DEN,"DF,FW",27,Hoffenheim,Bundesliga,14.0,24,16,15,8,1,17,36,47.2,19,17,4,13,10,34,23,1
Umut Tohumcu,GER,MF,18,Hoffenheim,Bundesliga,11.2,16,12,9,7,0,6,19,31.6,13,11,1,10,6,22,12,0
Kevin Akpoguma,NGA,DF,28,Hoffenheim,Bundesliga,12.2,35,18,22,12,1,26,35,74.3,9,28,8,20,18,53,32,0
Stanley N'Soki,FRA,DF,24,Hoffenheim,Bundesliga,7.0,21,10,12,8,1,17,29,58.6,12,13,2,11,8,29,33,0
Tim Drexler,GER,DF,18,Hoffenheim,Bundesliga,6.4,16,9,12,4,0,8,17,47.1,9,12,8,4,8,24,14,0
Finn Ole Becker,GER,MF,23,Hoffenheim,Bundesliga,6.7,10,9,8,2,0,4,17,23.5,13,9,1,8,1,11,10,0
David Jurásek,CZE,DF,22,Hoffenheim,Bundesliga,5.5,14,11,13,1,0,7,17,41.2,10,7,2,5,3,17,22,1
Attila Szalai,HUN,DF,25,Hoffenheim,Bundesliga,3.2,3,1,3,0,0,1,4,25.0,3,6,2,4,1,4,7,0
Tom Bischof,GER,"MF,FW",18,Hoffenheim,Bundesliga,2.0,8,4,6,1,1,2,9,22.2,7,3,0,3,1,9,2,0
Angelo Stiller,GER,MF,22,Hoffenheim,Bundesliga,0.9,0,0,0,0,0,0,1,0.0,1,2,0,2,0,0,3,0
Mergim Berisha,GER,FW,25,Hoffenheim,Bundesliga,1.6,0,0,0,0,0,0,0,0.0,0,2,1,1,0,0,0,0
Dennis Geiger,GER,MF,25,Hoffenheim,Bundesliga,0.7,1,0,1,0,0,0,0,0.0,0,1,1,0,0,1,0,0
Julian Justvan,GER,"FW,MF",25,Hoffenheim,Bundesliga,0.5,1,0,1,0,0,1,2,50.0,1,1,0,1,0,1,0,0
Bambasé Conté,GER,"MF,FW",20,Hoffenheim,Bundesliga,0.5,3,3,2,0,1,1,1,100.0,0,0,0,0,0,3,0,0
Max Moerstedt,GER,"DF,FW",18,Hoffenheim,Bundesliga,0.1,0,0,0,0,0,0,1,0.0,1,0,0,0,0,0,0,0
Kasim Nuhu,GHA,DF,28,Hoffenheim,Bundesliga,0.1,0,0,0,0,0,0,0,0.0,0,0,0,0,0,0,0,0
Diadie Samassékou,MLI,MF,27,Hoffenheim,Bundesliga,0.0,0,0,0,0,0,0,0,0.0,0,0,0,0,1,1,0,0
Patrick Mainka,GER,DF,28,Heidenheim,Bundesliga,34.0,85,49,58,24,3,38,74,51.4,36,66,32,34,49,134,158,1
Kevin Müller,GER,GK,32,Heidenheim,Bundesliga,34.0,3,0,3,0,0,3,5,60.0,2,0,0,0,0,3,6,1
Tim Kleindienst,GER,FW,27,Heidenheim,Bundesliga,31.9,21,12,6,11,4,7,25,28.0,18,32,8,24,12,33,58,0
Eren Dinkçi,GER,"FW,MF",21,Heidenheim,Bundesliga,29.4,32,18,16,13,3,19,48,39.6,29,40,4,36,12,44,21,0
Jonas Föhrenbach,GER,DF,27,Heidenheim,Bundesliga,31.0,44,24,24,14,6,19,36,52.8,17,34,19,15,31,75,70,0
Jan-Niklas Beste,GER,"FW,MF",24,Heidenheim,Bundesliga,28.9,77,49,35,24,18,28,55,50.9,27,48,1,47,18,95,31,0
Omar Traoré,GER,DF,25,Heidenheim,Bundesliga,27.5,60,33,33,21,6,32,56,57.1,24,32,7,25,40,100,54,1
Lennard Maloney,USA,MF,23,Heidenheim,Bundesliga,25.4,43,26,14,24,5,25,59,42.4,34,33,9,24,25,68,88,0
Benedikt Gimber,GER,DF,26,Heidenheim,Bundesliga,22.5,40,24,25,14,1,19,35,54.3,16,27,17,10,16,56,101,1
Jan Schöppner,GER,MF,24,Heidenheim,Bundesliga,22.2,48,26,26,20,2,21,42,50.0,21,37,7,30,26,74,57,0
Marvin Pieringer,GER,"MF,FW",23,Heidenheim,Bundesliga,16.8,19,12,5,11,3,8,20,40.0,12,28,4,24,12,31,21,0
Norman Theuerkauf,GER,"MF,DF",36,Heidenheim,Bundesliga,14.0,24,16,13,7,4,13,22,59.1,9,16,6,10,14,38,21,0
Adrian Beck,GER,"MF,FW",26,Heidenheim,Bundesliga,10.8,22,13,8,12,2,9,24,37.5,15,17,0,17,4,26,15,0
Tim Siersleben,GER,DF,23,Heidenheim,Bundesliga,10.1,27,11,21,6,0,8,20,40.0,12,16,10,6,21,48,29,1
Kevin Sessa,GER,"MF,FW",23,Heidenheim,Bundesliga,11.2,17,10,9,6,2,7,16,43.8,9,12,1,11,4,21,17,0
Nikola Dovedan,AUT,"MF,FW",29,Heidenheim,Bundesliga,7.3,14,9,2,10,2,5,25,20.0,20,9,0,9,1,15,3,0
Marnon Busch,GER,DF,28,Heidenheim,Bundesliga,6.6,11,9,6,3,2,7,12,58.3,5,9,2,7,10,21,12,0
Denis Thomalla,GER,"MF,FW",30,Heidenheim,Bundesliga,5.0,9,6,4,4,1,5,11,45.5,6,3,2,1,4,13,13,0
Florian Pick,GER,"MF,FW",27,Heidenheim,Bundesliga,3.6,4,4,3,0,1,2,3,66.7,1,2,0,2,2,6,2,0
Stefan Schimmer,GER,"MF,FW",29,Heidenheim,Bundesliga,1.7,1,1,0,1,0,0,3,0.0,3,2,0,2,1,2,6,0
Christian Kühlwetter,GER,MF,27,Heidenheim,Bundesliga,0.1,0,0,0,0,0,0,0,0.0,0,0,0,0,0,0,0,0
Thomas Keller,GER,"MF,FW",23,Heidenheim,Bundesliga,0.0,0,0,0,0,0,0,0,0.0,0,0,0,0,0,0,0,0
Marvin Ducksch,GER,FW,29,Werder Bremen,Bundesliga,30.0,8,3,4,3,1,6,14,42.9,8,2,0,2,4,12,25,0
Mitchell Weiser,GER,"DF,MF",29,Werder Bremen,Bundesliga,29.3,64,38,29,25,10,31,53,58.5,22,36,6,30,20,84,43,0
Romano Schmid,AUT,"MF,FW",23,Werder Bremen,Bundesliga,28.9,35,20,7,22,6,14,46,30.4,32,36,7,29,11,46,17,2
Anthony Jung,GER,DF,31,Werder Bremen,Bundesliga,28.7,37,23,21,14,2,18,33,54.5,15,39,17,22,24,61,102,0
Michael Zetterer,GER,GK,28,Werder Bremen,Bundesliga,27.0,3,1,3,0,0,3,3,100.0,0,0,0,0,0,3,7,3
Jens Stage,DEN,MF,26,Werder Bremen,Bundesliga,25.9,52,22,21,23,8,18,50,36.0,32,42,23,19,23,75,55,0
Marco Friedl,AUT,DF,25,Werder Bremen,Bundesliga,24.4,53,32,38,15,0,36,48,75.0,12,45,29,16,35,88,129,0
Miloš Veljković,SRB,DF,27,Werder Bremen,Bundesliga,21.3,31,15,17,13,1,16,31,51.6,15,31,20,11,17,48,57,0
Senne Lynen,BEL,MF,24,Werder Bremen,Bundesliga,20.0,64,38,33,27,4,30,70,42.9,40,41,8,33,41,105,56,0
Felix Agu,GER,"DF,MF",23,Werder Bremen,Bundesliga,17.9,45,29,28,13,4,29,41,70.7,12,27,7,20,13,58,41,0
Leonardo Bittencourt,GER,MF,29,Werder Bremen,Bundesliga,17.5,42,18,20,17,5,15,39,38.5,24,18,1,17,13,55,6,0
Olivier Deman,BEL,DF,23,Werder Bremen,Bundesliga,15.2,28,15,21,4,3,18,38,47.4,20,24,8,16,14,42,49,1
Nick Woltemade,GER,"FW,MF",21,Werder Bremen,Bundesliga,13.2,34,23,7,20,7,15,21,71.4,6,12,0,12,5,39,17,0
Niklas Stark,GER,DF,28,Werder Bremen,Bundesliga,12.1,26,15,13,11,2,12,18,66.7,6,14,7,7,19,45,61,1
Rafael Borré,COL,FW,27,Werder Bremen,Bundesliga,11.0,10,7,2,4,4,5,16,31.3,11,8,2,6,2,12,10,0
Justin Njinmah,GER,FW,22,Werder Bremen,Bundesliga,11.3,5,1,2,2,1,3,9,33.3,6,9,1,8,2,7,6,0
Christian Groß,GER,"DF,MF",34,Werder Bremen,Bundesliga,8.9,21,16,11,9,1,11,25,44.0,14,17,6,11,13,34,28,1
Jiří Pavlenka,CZE,GK,31,Werder Bremen,Bundesliga,7.0,0,0,0,0,0,0,0,0.0,0,0,0,0,0,0,2,0
Amos Pieper,GER,DF,25,Werder Bremen,Bundesliga,6.6,14,11,8,6,0,7,13,53.8,6,12,7,5,9,23,36,1
Julián Malatini,ARG,DF,22,Werder Bremen,Bundesliga,6.7,18,13,12,3,3,16,24,66.7,8,8,1,7,13,31,26,0
Dawid Kownacki,POL,FW,26,Werder Bremen,Bundesliga,4.2,1,1,1,0,0,1,4,25.0,3,3,1,2,0,1,1,0
Niclas Füllkrug,GER,FW,30,Werder Bremen,Bundesliga,2.0,1,1,0,1,0,1,1,100.0,0,2,1,1,0,1,1,0
Skelly Alvero,FRA,MF,21,Werder Bremen,Bundesliga,1.4,6,4,1,5,0,3,3,100.0,0,3,1,2,1,7,1,0
Naby Keïta,GUI,"MF,DF",28,Werder Bremen,Bundesliga,1.2,1,1,1,0,0,0,1,0.0,1,2,0,2,2,3,1,0
Nicolai Rapp,GER,DF,26,Werder Bremen,Bundesliga,0.8,3,2,2,1,0,2,2,100.0,0,2,0,2,2,5,8,0
Oliver Burke,SCO,FW,26,Werder Bremen,Bundesliga,0.4,0,0,0,0,0,0,2,0.0,2,0,0,0,0,0,0,0
Isak Hansen-Aarøen,NOR,MF,18,Werder Bremen,Bundesliga,0.3,0,0,0,0,0,0,1,0.0,1,1,0,1,1,1,0,0
Leon Opitz,GER,"FW,DF",18,Werder Bremen,Bundesliga,0.2,2,2,1,1,0,2,3,66.7,1,0,0,0,0,2,0,0
Ilia Gruev,BUL,MF,23,Werder Bremen,Bundesliga,0.0,0,0,0,0,0,0,0,0.0,0,0,0,0,0,0,0,0
Joel Imasuen,USA,FW,18,Werder Bremen,Bundesliga,0.0,0,0,0,0,0,0,0,0.0,0,0,0,0,0,0,0,0
Noah Atubolu,GER,GK,21,Freiburg,Bundesliga,34.0,0,0,0,0,0,0,1,0.0,1,0,0,0,0,0,8,1
Maximilian Eggestein,GER,MF,26,Freiburg,Bundesliga,32.4,49,24,25,19,5,15,36,41.7,21,53,19,34,28,77,40,1
Vincenzo Grifo,ITA,"MF,FW",30,Freiburg,Bundesliga,25.8,31,20,14,11,6,14,31,45.2,17,22,1,21,15,46,20,0
Nicolas Höfler,GER,MF,33,Freiburg,Bundesliga,25.9,63,40,36,20,7,22,49,44.9,27,30,16,14,31,94,45,0
Lucas Höler,GER,"FW,MF",29,Freiburg,Bundesliga,25.6,32,24,14,10,8,4,23,17.4,19,19,4,15,15,47,35,0
Ritsu Doan,JPN,"DF,MF",25,Freiburg,Bundesliga,25.0,50,27,21,19,10,21,36,58.3,15,30,3,27,9,59,29,0
Manuel Gulde,GER,DF,32,Freiburg,Bundesliga,22.7,37,23,23,13,1,17,23,73.9,6,24,14,10,25,62,82,0
Matthias Ginter,GER,DF,29,Freiburg,Bundesliga,21.3,29,15,19,9,1,16,29,55.2,13,40,26,14,16,45,93,0
Lukas Kübler,GER,DF,30,Freiburg,Bundesliga,20.5,50,24,35,13,2,26,42,61.9,16,36,14,22,37,87,57,1
Roland Sallai,HUN,"MF,FW",26,Freiburg,Bundesliga,20.4,17,10,5,5,7,8,20,40.0,12,21,1,20,6,23,23,0
Kiliann Sildillia,FRA,DF,21,Freiburg,Bundesliga,20.1,43,19,28,8,7,26,42,61.9,16,33,15,18,22,65,64,0
Michael Gregoritsch,AUT,FW,29,Freiburg,Bundesliga,18.7,16,12,8,5,3,2,14,14.3,12,17,4,13,9,25,27,0
Merlin Röhl,GER,"MF,FW",21,Freiburg,Bundesliga,16.4,21,13,10,9,2,8,21,38.1,13,27,3,24,9,30,22,0
Philipp Lienhart,AUT,DF,27,Freiburg,Bundesliga,14.1,20,13,14,5,1,13,23,56.5,10,18,11,7,14,34,51,0
Christian Günter,GER,DF,30,Freiburg,Bundesliga,11.8,20,12,9,11,0,7,18,38.9,11,9,3,6,2,22,16,0
Yannik Keitel,GER,"DF,MF",23,Freiburg,Bundesliga,10.2,20,15,14,5,1,10,15,66.7,5,17,8,9,12,32,44,3
Jordy Makengo,FRA,DF,21,Freiburg,Bundesliga,11.4,17,11,11,5,1,6,10,60.0,4,16,4,12,11,28,37,0
Noah Weißhaupt,GER,"DF,FW",21,Freiburg,Bundesliga,8.4,9,4,6,0,3,5,11,45.5,6,8,1,7,8,17,12,0
Maximilian Philipp,GER,"FW,MF",29,Freiburg,Bundesliga,3.6,8,5,4,4,0,1,6,16.7,5,7,0,7,1,9,3,0
Junior Adamu,AUT,"FW,MF",22,Freiburg,Bundesliga,1.2,5,1,1,2,2,1,2,50.0,1,1,0,1,0,5,2,0
Florent Muslija,KVX,"MF,FW",25,Freiburg,Bundesliga,1.2,5,4,3,2,0,2,5,40.0,3,1,0,1,0,5,2,0
Attila Szalai,HUN,DF,25,Freiburg,Bundesliga,1.1,1,1,1,0,0,1,2,50.0,1,5,2,3,1,2,11,1
Kenneth Schmidt,GER,DF,21,Freiburg,Bundesliga,0.8,2,2,2,0,0,2,4,50.0,2,1,0,1,1,3,2,0
Maximilian Breunig,GER,FW,22,Freiburg,Bundesliga,0.1,0,0,0,0,0,0,0,0.0,0,1,0,1,0,0,0,0
Fabian Rüdlin,GER,MF,26,Freiburg,Bundesliga,0.1,1,0,0,0,1,0,0,0.0,0,0,0,0,0,1,0,0
Ohis Felix Uduokhai,GER,DF,25,Augsburg,Bundesliga,32.5,37,21,18,14,5,16,25,64.0,9,45,35,10,46,83,178,2
Ermedin Demirović,BIH,"FW,MF",25,Augsburg,Bundesliga,31.9,24,14,5,16,3,12,40,30.0,28,28,2,26,11,35,26,0
Finn Dahmen,GER,GK,25,Augsburg,Bundesliga,31.0,1,0,1,0,0,1,3,33.3,2,0,0,0,0,1,17,5
Phillip Tietz,GER,FW,26,Augsburg,Bundesliga,26.5,23,14,7,13,3,6,15,40.0,9,17,3,14,6,29,35,0
Jeffrey Gouweleeuw,NED,DF,32,Augsburg,Bundesliga,28.8,35,23,13,17,5,16,25,64.0,9,44,24,20,35,70,108,0
Ruben Vargas,SUI,"MF,FW",24,Augsburg,Bundesliga,21.8,23,10,6,10,7,10,25,40.0,15,19,4,15,7,30,17,0
Elvis Rexhbeçaj,GER,MF,25,Augsburg,Bundesliga,22.1,30,19,14,13,3,18,36,50.0,18,32,7,25,20,50,20,0
Kevin Mbabu,SUI,DF,28,Augsburg,Bundesliga,22.7,51,39,25,18,8,23,40,57.5,17,29,9,20,24,75,48,0
Mads Pedersen,DEN,DF,26,Augsburg,Bundesliga,19.8,64,39,31,27,6,24,44,54.5,20,20,3,17,19,83,46,0
Iago,BRA,DF,26,Augsburg,Bundesliga,18.0,36,17,22,10,4,17,33,51.5,16,39,8,31,18,54,43,0
Fredrik Jensen,FIN,"MF,FW",25,Augsburg,Bundesliga,14.9,23,11,9,8,6,14,28,50.0,14,30,1,29,12,35,21,0
Niklas Dorsch,GER,MF,25,Augsburg,Bundesliga,15.4,35,24,13,21,1,13,33,39.4,20,15,9,6,16,51,27,0
Arne Engels,BEL,"MF,DF",19,Augsburg,Bundesliga,15.6,33,18,15,14,4,12,29,41.4,17,23,1,22,15,48,21,0
Kristijan Jakić,CRO,MF,26,Augsburg,Bundesliga,11.7,28,14,14,10,4,15,33,45.5,18,13,1,12,20,48,15,0
Arne Maier,GER,MF,24,Augsburg,Bundesliga,11.1,14,9,5,8,1,5,14,35.7,9,19,2,17,6,20,11,0
Maximilian Bauer,GER,DF,23,Augsburg,Bundesliga,9.0,19,12,13,4,2,9,17,52.9,8,14,8,6,11,30,30,1
Tim Breithaupt,GER,MF,21,Augsburg,Bundesliga,7.0,20,11,11,9,0,13,21,61.9,8,15,3,12,8,28,10,0
Robert Gumny,POL,DF,25,Augsburg,Bundesliga,5.3,6,5,1,3,2,1,5,20.0,4,13,5,8,7,13,15,0
Sven Michel,GER,"FW,MF",33,Augsburg,Bundesliga,6.5,7,5,2,1,4,2,7,28.6,5,1,0,1,0,7,4,0
Patric Pfeiffer,GER,DF,23,Augsburg,Bundesliga,5.7,11,7,6,4,1,5,6,83.3,1,10,6,4,11,22,21,0
Dion Drena Beljo,CRO,"FW,MF",21,Augsburg,Bundesliga,6.5,0,0,0,0,0,0,2,0.0,2,8,1,7,1,1,4,0
Tomáš Koubek,CZE,GK,30,Augsburg,Bundesliga,3.0,0,0,0,0,0,0,0,0.0,0,0,0,0,0,0,1,1
Mergim Berisha,GER,FW,25,Augsburg,Bundesliga,1.4,0,0,0,0,0,0,0,0.0,0,1,0,1,0,0,3,0
Mert Kömür,GER,"MF,DF",18,Augsburg,Bundesliga,1.3,3,3,3,0,0,3,5,60.0,2,0,0,0,0,3,1,0
Pep Biel,ESP,"MF,FW",26,Augsburg,Bundesliga,3.2,4,3,0,2,2,1,3,33.3,2,2,1,1,2,6,2,0
Irvin Cardona,FRA,"MF,DF",25,Augsburg,Bundesliga,0.6,1,1,0,0,1,1,3,33.3,2,1,0,1,0,1,1,0
Masaya Okugawa,JPN,"FW,DF",27,Augsburg,Bundesliga,0.4,0,0,0,0,0,0,0,0.0,0,0,0,0,0,0,2,0
Nathanael Mbuku,FRA,FW,21,Augsburg,Bundesliga,0.1,0,0,0,0,0,0,0,0.0,0,1,0,1,0,0,0,0
Mahmut Kücüksahin,TUR,MF,19,Augsburg,Bundesliga,0.0,0,0,0,0,0,0,0,0.0,0,0,0,0,0,0,0,0
Jonas Wind,DEN,FW,24,Wolfsburg,Bundesliga,29.5,13,10,4,6,3,7,17,41.2,10,13,4,9,3,16,21,0
Maximilian Arnold,GER,MF,29,Wolfsburg,Bundesliga,27.8,51,31,15,27,9,28,57,49.1,29,23,4,19,24,75,60,0
Joakim Mæhle,DEN,"DF,MF",26,Wolfsburg,Bundesliga,27.2,62,39,33,18,11,41,64,64.1,23,43,5,38,29,91,65,0
Maxence Lacroix,FRA,DF,23,Wolfsburg,Bundesliga,26.2,48,29,28,18,2,29,41,70.7,12,35,12,23,24,72,121,0
Koen Casteels,BEL,GK,31,Wolfsburg,Bundesliga,25.0,2,1,2,0,0,2,3,66.7,1,0,0,0,0,2,16,5
Lovro Majer,CRO,"MF,FW",25,Wolfsburg,Bundesliga,23.4,39,18,17,22,0,12,31,38.7,19,20,1,19,12,51,13,0
Ridle Baku,GER,"DF,MF",25,Wolfsburg,Bundesliga,22.4,37,20,24,7,6,21,46,45.7,25,27,1,26,21,58,45,1
Moritz Jenz,GER,DF,24,Wolfsburg,Bundesliga,19.4,34,24,21,11,2,14,21,66.7,7,29,17,12,26,60,94,0
Mattias Svanberg,SWE,MF,24,Wolfsburg,Bundesliga,19.1,37,17,8,19,10,12,38,31.6,26,25,5,20,21,58,28,0
Cedric Zesiger,SUI,DF,25,Wolfsburg,Bundesliga,18.2,19,9,13,4,2,10,22,45.5,12,32,21,11,15,34,88,1
Yannick Gerhardt,GER,"MF,DF",29,Wolfsburg,Bundesliga,18.1,31,20,16,12,3,9,32,28.1,23,15,2,13,7,38,35,0
Sebastiaan Bornauw,BEL,DF,24,Wolfsburg,Bundesliga,15.9,26,12,19,7,0,13,19,68.4,6,21,12,9,18,44,81,0
Kevin Paredes,USA,"FW,MF",20,Wolfsburg,Bundesliga,15.9,42,21,22,13,7,20,34,58.8,14,27,2,25,23,65,26,0
Aster Vranckx,BEL,MF,20,Wolfsburg,Bundesliga,12.8,32,15,11,11,10,15,28,53.6,13,17,6,11,14,46,29,0
Václav Černý,CZE,"FW,MF",25,Wolfsburg,Bundesliga,10.2,8,3,3,4,1,2,14,14.3,12,13,0,13,8,16,6,0
Tiago Tomás,POR,"FW,MF",21,Wolfsburg,Bundesliga,11.5,5,2,3,0,2,1,6,16.7,5,13,0,13,3,8,9,0
Rogério,BRA,DF,25,Wolfsburg,Bundesliga,10.1,14,6,7,5,2,10,14,71.4,4,16,5,11,5,19,23,1
Pavao Pervan,AUT,GK,35,Wolfsburg,Bundesliga,9.0,0,0,0,0,0,0,0,0.0,0,0,0,0,0,0,4,0
Patrick Wimmer,AUT,"FW,MF",22,Wolfsburg,Bundesliga,6.5,14,5,5,5,4,8,18,44.4,10,14,0,14,3,17,7,0
Kevin Behrens,GER,FW,32,Wolfsburg,Bundesliga,6.8,2,1,0,1,1,0,2,0.0,2,9,0,9,3,5,6,0
Jakub Kamiński,POL,"FW,MF",21,Wolfsburg,Bundesliga,5.3,14,5,12,2,0,3,6,50.0,3,3,0,3,2,16,5,0
Kilian Fischer,GER,"DF,MF",22,Wolfsburg,Bundesliga,3.2,8,6,4,3,1,2,5,40.0,3,8,1,7,1,9,12,0
Nicolas Cozza,FRA,DF,24,Wolfsburg,Bundesliga,3.1,8,6,4,4,0,2,7,28.6,5,3,0,3,4,12,6,0
Amin Sarr,SWE,"FW,MF",22,Wolfsburg,Bundesliga,4.3,3,2,1,2,0,1,2,50.0,1,6,1,5,2,5,1,0
Lukas Nmecha,GER,FW,24,Wolfsburg,Bundesliga,0.5,1,1,0,0,1,0,0,0.0,0,1,0,1,0,1,0,0
Dženan Pejčinović,GER,FW,18,Wolfsburg,Bundesliga,0.4,0,0,0,0,0,0,0,0.0,0,1,0,1,0,0,0,0
Bennit Bröger,GER,FW,17,Wolfsburg,Bundesliga,0.1,0,0,0,0,0,0,0,0.0,0,0,0,0,0,0,0,0
Kofi Amoako,GER,MF,18,Wolfsburg,Bundesliga,0.0,0,0,0,0,0,0,0,0.0,0,0,0,0,0,0,0,0
Sepp van den Berg,NED,DF,21,Mainz 05,Bundesliga,31.5,38,23,20,15,3,15,26,57.7,11,66,36,30,43,81,159,2
Robin Zentner,GER,GK,28,Mainz 05,Bundesliga,30.0,2,2,2,0,0,2,5,40.0,3,1,0,1,1,3,19,1
Leandro Barreiro Martins,LUX,MF,23,Mainz 05,Bundesliga,29.0,65,40,19,37,9,30,50,60.0,20,45,16,29,36,101,53,0
Anthony Caci,FRA,DF,26,Mainz 05,Bundesliga,27.6,56,23,30,25,1,27,44,61.4,17,43,7,36,32,88,45,0
Dominik Kohr,GER,"DF,MF",29,Mainz 05,Bundesliga,24.3,65,42,36,25,4,36,57,63.2,21,27,6,21,43,108,58,0
Lee Jae-sung,KOR,"MF,FW",30,Mainz 05,Bundesliga,23.5,33,20,11,16,6,13,39,33.3,26,22,2,20,27,60,23,0
Phillipp Mwene,AUT,DF,29,Mainz 05,Bundesliga,22.2,34,15,15,16,3,16,33,48.5,17,27,3,24,17,51,47,0
Brajan Gruda,GER,"MF,FW",19,Mainz 05,Bundesliga,18.2,22,14,5,11,6,14,24,58.3,10,15,0,15,5,27,4,0
Jonathan Burkardt,GER,"FW,MF",23,Mainz 05,Bundesliga,17.1,12,8,2,6,4,4,11,36.4,7,16,3,13,3,15,2,0
Karim Onisiwo,AUT,"FW,MF",31,Mainz 05,Bundesliga,16.6,17,8,4,6,7,6,11,54.5,5,18,4,14,2,19,7,0
Ludovic Ajorque,FRA,FW,29,Mainz 05,Bundesliga,15.1,3,2,1,2,0,2,11,18.2,9,6,2,4,4,7,11,0
Nadiem Amiri,GER,MF,26,Mainz 05,Bundesliga,14.6,22,14,8,10,4,13,19,68.4,6,16,2,14,14,36,18,0
Tom Krauß,GER,MF,22,Mainz 05,Bundesliga,15.0,57,33,22,31,4,21,58,36.2,37,33,4,29,17,74,28,0
Edimilson Fernandes,SUI,DF,27,Mainz 05,Bundesliga,14.3,25,16,15,9,1,16,24,66.7,8,14,6,8,22,47,52,0
Silvan Widmer,SUI,DF,30,Mainz 05,Bundesliga,13.8,23,10,12,8,3,17,28,60.7,11,18,5,13,16,39,37,0
Andreas Hanche-Olsen,NOR,DF,26,Mainz 05,Bundesliga,11.0,20,12,10,8,2,10,16,62.5,6,10,4,6,11,31,41,0
Danny da Costa,GER,DF,30,Mainz 05,Bundesliga,9.2,18,9,9,7,2,9,19,47.4,10,17,4,13,16,34,24,0
Stefan Bell,GER,DF,31,Mainz 05,Bundesliga,7.4,8,8,7,1,0,4,8,50.0,4,7,5,2,6,14,30,0
Marco Richter,GER,"MF,FW",25,Mainz 05,Bundesliga,8.0,10,4,5,3,2,4,11,36.4,7,9,0,9,2,12,1,0
Josuha Guilavogui,FRA,DF,32,Mainz 05,Bundesliga,4.5,15,10,10,5,0,6,7,85.7,1,13,7,6,13,28,21,0
Maxim Leitsch,GER,DF,25,Mainz 05,Bundesliga,4.2,6,3,5,1,0,3,6,50.0,3,2,0,2,4,10,13,0
Daniel Batz,GER,GK,32,Mainz 05,Bundesliga,4.0,0,0,0,0,0,0,0,0.0,0,0,0,0,0,0,3,0
Matondo-Merveille Papela,GER,"MF,DF",22,Mainz 05,Bundesliga,2.9,5,4,2,3,0,0,4,0.0,4,1,0,1,4,9,2,0
Jessic Ngankam,GER,"FW,MF",23,Mainz 05,Bundesliga,2.0,1,1,0,1,0,0,0,0.0,0,3,1,2,3,4,0,0
Anton Stach,GER,MF,24,Mainz 05,Bundesliga,1.9,3,0,2,0,1,2,4,50.0,2,5,0,5,2,5,5,0
Aymen Barkok,MAR,"MF,FW",25,Mainz 05,Bundesliga,3.6,9,5,2,6,1,3,6,50.0,3,7,0,7,2,11,1,0
Nelson Weiper,GER,"FW,MF",18,Mainz 05,Bundesliga,1.4,2,1,2,0,0,2,3,66.7,1,1,0,1,1,3,0,0
Anwar El Ghazi,NED,"MF,DF",28,Mainz 05,Bundesliga,0.6,0,0,0,0,0,0,1,0.0,1,0,0,0,0,0,0,0
Marcus Müller,GER,MF,20,Mainz 05,Bundesliga,0.2,0,0,0,0,0,0,0,0.0,0,0,0,0,0,0,0,0
David Mamutovic,GER,"FW,DF",22,Mainz 05,Bundesliga,0.1,1,1,0,1,0,1,1,100.0,0,0,0,0,0,1,0,0
Julian Weigl,GER,MF,27,Gladbach,Bundesliga,30.7,66,40,28,32,6,41,67,61.2,26,47,14,33,48,114,61,1
Nico Elvedi,SUI,DF,26,Gladbach,Bundesliga,27.6,33,18,22,10,1,18,24,75.0,6,40,25,15,43,76,150,2
Franck Honorat,FRA,"DF,FW",26,Gladbach,Bundesliga,26.1,25,13,13,10,2,11,20,55.0,9,22,3,19,9,34,35,1
Moritz Nicolas,GER,GK,25,Gladbach,Bundesliga,27.0,1,0,1,0,0,1,3,33.3,2,0,0,0,0,1,12,5
Joe Scally,USA,DF,20,Gladbach,Bundesliga,24.8,41,28,21,17,3,23,40,57.5,17,31,11,20,18,59,78,2
Luca Netz,GER,DF,20,Gladbach,Bundesliga,24.7,38,22,19,16,3,23,43,53.5,20,36,10,26,22,60,76,1
Rocco Reitz,GER,MF,21,Gladbach,Bundesliga,23.7,61,36,28,29,4,28,55,50.9,27,61,20,41,44,105,31,1
Maximilian Wöber,AUT,DF,25,Gladbach,Bundesliga,23.0,66,31,40,25,1,31,53,58.5,22,47,26,21,38,104,111,0
Alassane Pléa,FRA,"FW,MF",30,Gladbach,Bundesliga,21.3,17,7,5,8,4,7,15,46.7,8,11,0,11,2,19,6,0
Ko Itakura,JPN,"DF,MF",26,Gladbach,Bundesliga,17.7,34,21,17,15,2,16,26,61.5,10,32,18,14,22,56,62,0
Manu Koné,FRA,MF,22,Gladbach,Bundesliga,17.3,45,26,20,20,5,17,25,68.0,8,22,1,21,15,60,16,1
Jordan Pefok,USA,FW,27,Gladbach,Bundesliga,15.8,10,4,0,8,2,3,8,37.5,5,12,3,9,5,15,28,0
Marvin Friedrich,GER,DF,27,Gladbach,Bundesliga,17.4,23,15,16,6,1,12,20,60.0,8,28,20,8,17,40,87,0
Florian Neuhaus,GER,MF,26,Gladbach,Bundesliga,13.6,15,12,7,8,0,8,26,30.8,18,8,6,2,14,29,8,0
Nathan N'Goumou,FRA,"FW,MF",23,Gladbach,Bundesliga,15.4,37,22,17,18,2,16,34,47.1,18,22,0,22,5,42,17,1
Robin Hack,GER,"FW,MF",24,Gladbach,Bundesliga,15.0,15,8,6,7,2,4,17,23.5,13,16,0,16,14,29,21,0
Stefan Lainer,AUT,"DF,MF",30,Gladbach,Bundesliga,8.3,23,16,15,8,0,14,24,58.3,10,13,6,7,5,28,28,0
Tomáš Čvančara,CZE,FW,22,Gladbach,Bundesliga,10.0,4,3,0,2,2,1,3,33.3,2,5,1,4,2,6,8,0
Jonas Omlin,SUI,GK,29,Gladbach,Bundesliga,7.0,1,0,1,0,0,1,1,100.0,0,0,0,0,0,1,3,0
Christoph Kramer,GER,MF,32,Gladbach,Bundesliga,2.8,10,5,5,5,0,2,14,14.3,12,7,1,6,4,14,6,0
Fabio Chiarodia,ITA,DF,18,Gladbach,Bundesliga,1.7,8,5,5,1,2,5,7,71.4,2,2,1,1,3,11,9,0
Patrick Herrmann,GER,"FW,DF",32,Gladbach,Bundesliga,1.0,4,4,2,1,1,2,2,100.0,0,1,0,1,1,5,2,0
Grant Ranos,ARM,"MF,FW",20,Gladbach,Bundesliga,0.5,1,0,0,0,1,0,0,0.0,0,0,0,0,0,1,0,0
Lukas Ullrich,GER,"DF,FW",19,Gladbach,Bundesliga,0.5,1,0,1,0,0,1,4,25.0,3,0,0,0,0,1,1,0
Shiō Fukuda,JPN,"FW,MF",19,Gladbach,Bundesliga,0.4,2,0,1,1,0,1,2,50.0,1,0,0,0,1,3,0,0
Tony Jantschke,GER,"DF,MF",33,Gladbach,Bundesliga,0.3,1,1,1,0,0,1,1,100.0,0,2,2,0,1,2,4,0
Yvandro Borges Sanches,LUX,"MF,FW",19,Gladbach,Bundesliga,0.2,0,0,0,0,0,0,0,0.0,0,0,0,0,0,0,0,0
Frederik Rønnow,DEN,GK,30,Union Berlin,Bundesliga,33.0,1,1,1,0,0,0,0,0.0,0,0,0,0,1,2,20,2
Diogo Leite,POR,DF,24,Union Berlin,Bundesliga,30.0,52,36,31,15,6,25,51,49.0,26,48,22,26,47,99,155,1
Robin Gosens,GER,"DF,MF",29,Union Berlin,Bundesliga,25.4,63,44,25,31,7,30,44,68.2,14,52,9,43,36,99,75,0
Danilho Doekhi,NED,DF,25,Union Berlin,Bundesliga,24.0,34,23,18,16,0,15,21,71.4,6,46,25,21,38,72,111,1
Robin Knoche,GER,DF,31,Union Berlin,Bundesliga,21.3,34,22,27,7,0,19,30,63.3,11,27,19,8,13,47,73,0
Christopher Trimmel,AUT,DF,36,Union Berlin,Bundesliga,18.3,23,15,12,10,1,13,33,39.4,20,16,3,13,13,36,57,0
Lucas Tousart,FRA,MF,26,Union Berlin,Bundesliga,17.5,35,20,14,17,4,17,37,45.9,20,32,9,23,25,60,41,0
Rani Khedira,GER,MF,29,Union Berlin,Bundesliga,14.9,35,22,15,19,1,17,26,65.4,9,12,5,7,22,57,38,0
Kevin Volland,GER,"FW,MF",31,Union Berlin,Bundesliga,14.9,22,9,8,8,6,8,20,40.0,12,8,0,8,6,28,12,0
Kevin Vogt,GER,DF,31,Union Berlin,Bundesliga,14.7,10,9,6,4,0,6,12,50.0,6,22,15,7,7,17,72,2
Benedict Hollerbach,GER,"FW,MF",22,Union Berlin,Bundesliga,14.2,17,11,5,7,5,7,22,31.8,15,28,0,28,4,21,3,0
Josip Juranović,CRO,DF,27,Union Berlin,Bundesliga,14.4,20,14,11,7,2,10,21,47.6,11,17,3,14,12,32,27,1
Brenden Aaronson,USA,"MF,FW",22,Union Berlin,Bundesliga,14.1,32,18,13,13,6,16,32,50.0,16,26,1,25,2,34,4,0
Kevin Behrens,GER,FW,32,Union Berlin,Bundesliga,14.0,13,10,3,7,3,1,4,25.0,3,7,2,5,6,19,19,0
Janik Haberer,GER,"MF,DF",29,Union Berlin,Bundesliga,13.6,36,24,16,13,7,22,45,48.9,23,21,4,17,12,48,18,0
András Schäfer,HUN,MF,24,Union Berlin,Bundesliga,13.5,29,16,9,15,5,11,20,55.0,9,25,4,21,20,49,25,0
Alex Král,CZE,MF,25,Union Berlin,Bundesliga,15.2,19,14,7,10,2,8,20,40.0,12,15,4,11,11,30,30,0
Aïssa Laïdouni,TUN,MF,26,Union Berlin,Bundesliga,11.9,21,12,4,12,5,4,12,33.3,8,26,2,24,12,33,14,2
Jérôme Roussillon,FRA,DF,30,Union Berlin,Bundesliga,8.4,16,9,6,7,3,8,12,66.7,4,13,4,9,5,21,26,0
David Datro Fofana,CIV,"FW,MF",20,Union Berlin,Bundesliga,7.6,10,7,3,5,2,4,9,44.4,5,4,0,4,0,10,5,0
Sheraldo Becker,SUR,"FW,MF",28,Union Berlin,Bundesliga,7.2,3,3,0,2,1,0,2,0.0,2,2,0,2,0,3,2,0
Yorbe Vertessen,BEL,"FW,MF",22,Union Berlin,Bundesliga,6.6,3,2,0,3,0,1,4,25.0,3,8,0,8,1,4,3,0
Leonardo Bonucci,ITA,DF,36,Union Berlin,Bundesliga,5.1,6,5,2,4,0,4,4,100.0,0,5,3,2,7,13,16,0
Mikkel Kaufmann,DEN,FW,22,Union Berlin,Bundesliga,5.4,6,3,2,3,1,3,10,30.0,7,12,0,12,1,7,4,0
Paul Jaeckel,GER,DF,25,Union Berlin,Bundesliga,2.6,7,2,4,3,0,5,9,55.6,4,3,2,1,4,11,7,0
Alexander Schwolow,GER,GK,31,Union Berlin,Bundesliga,1.0,0,0,0,0,0,0,0,0.0,0,0,0,0,0,0,2,0
Chris Bedia,CIV,"FW,MF",27,Union Berlin,Bundesliga,1.6,2,1,0,2,0,0,1,0.0,1,3,0,3,0,2,2,0
Aljoscha Kemlein,GER,MF,18,Union Berlin,Bundesliga,0.3,0,0,0,0,0,0,3,0.0,3,1,0,1,0,0,0,0
Jordan Pefok,USA,FW,27,Union Berlin,Bundesliga,0.3,0,0,0,0,0,0,0,0.0,0,1,1,0,0,0,0,0
Miloš Pantović,SRB,MF,27,Union Berlin,Bundesliga,0.2,0,0,0,0,0,0,0,0.0,0,0,0,0,0,0,0,0
Manuel Riemann,GER,GK,34,Bochum,Bundesliga,33.0,2,1,2,0,0,2,4,50.0,2,0,0,0,1,3,25,1
Bernardo,BRA,DF,28,Bochum,Bundesliga,32.5,99,58,56,35,8,45,69,65.2,24,66,30,36,55,154,120,1
Kevin Stöger,AUT,MF,29,Bochum,Bundesliga,29.6,49,30,21,21,7,25,63,39.7,38,46,4,42,19,68,18,0
Anthony Losilla,FRA,MF,37,Bochum,Bundesliga,28.6,63,37,15,40,8,23,51,45.1,28,37,8,29,25,88,51,0
Takuma Asano,JPN,"FW,MF",28,Bochum,Bundesliga,22.1,17,6,2,9,6,7,23,30.4,16,17,3,14,4,21,11,0
Erhan Mašović,SRB,"DF,MF",24,Bochum,Bundesliga,24.7,64,40,37,22,5,37,70,52.9,33,32,10,22,25,89,75,2
Keven Schlotterbeck,GER,DF,26,Bochum,Bundesliga,24.3,42,22,26,14,2,25,30,83.3,5,33,23,10,33,75,104,2
Ivan Ordets,UKR,DF,31,Bochum,Bundesliga,20.9,19,14,11,6,2,10,17,58.8,7,41,29,12,31,50,130,0
Patrick Osterhage,GER,MF,23,Bochum,Bundesliga,20.7,38,26,14,23,1,17,36,47.2,19,36,9,27,27,65,32,1
Matúš Bero,SVK,"MF,FW",27,Bochum,Bundesliga,18.5,32,22,13,12,7,13,32,40.6,19,24,3,21,12,44,26,0
Philipp Hofmann,GER,FW,30,Bochum,Bundesliga,17.5,10,5,4,5,1,4,7,57.1,3,11,2,9,4,14,17,0
Moritz Broschinski,GER,FW,22,Bochum,Bundesliga,13.9,11,7,2,5,4,2,8,25.0,6,11,2,9,0,11,6,0
Maximilian Wittek,GER,"DF,FW",27,Bochum,Bundesliga,11.9,23,17,9,11,3,13,21,61.9,8,12,1,11,18,41,23,0
Felix Passlack,GER,DF,25,Bochum,Bundesliga,10.7,21,14,9,10,2,14,24,58.3,10,13,2,11,10,31,21,0
Cristian Gamboa,CRC,DF,33,Bochum,Bundesliga,13.2,24,18,12,11,1,14,33,42.4,19,20,7,13,15,39,34,1
Christopher Antwi-Adjei,GHA,"FW,MF",29,Bochum,Bundesliga,13.5,21,12,10,6,5,12,22,54.5,10,13,2,11,2,23,11,1
Tim Oermann,GER,DF,19,Bochum,Bundesliga,7.9,19,11,11,4,4,9,14,64.3,5,15,6,9,2,21,22,0
Gonçalo Paciência,POR,"FW,MF",28,Bochum,Bundesliga,7.2,8,4,2,2,4,3,6,50.0,3,5,0,5,0,8,7,0
Lukas Daschner,GER,"MF,FW",24,Bochum,Bundesliga,6.0,9,4,2,3,4,4,9,44.4,5,7,0,7,2,11,2,0
Philipp Förster,GER,"MF,FW",28,Bochum,Bundesliga,4.3,9,5,3,4,2,2,6,33.3,4,3,0,3,7,16,3,0
Danilo Soares,BRA,DF,31,Bochum,Bundesliga,3.9,10,6,5,3,2,5,8,62.5,3,6,0,6,7,17,11,0
Noah Loosli,SUI,DF,26,Bochum,Bundesliga,3.8,10,7,6,4,0,7,14,50.0,7,7,1,6,7,17,18,0
Moritz-Broni Kwarteng,GHA,FW,25,Bochum,Bundesliga,3.1,3,0,0,3,0,1,7,14.3,6,4,0,4,2,5,0,0
Andreas Luthe,GER,GK,36,Bochum,Bundesliga,1.0,0,0,0,0,0,0,0,0.0,0,0,0,0,0,0,1,0
Simon Zoller,GER,"FW,MF",32,Bochum,Bundesliga,0.5,0,0,0,0,0,0,0,0.0,0,1,0,1,0,0,0,0
Marvin Schwäbe,GER,GK,28,Köln,Bundesliga,34.0,1,0,1,0,0,1,1,100.0,0,0,0,0,0,1,10,1
Julian Chabot,GER,DF,25,Köln,Bundesliga,30.0,59,42,40,17,2,35,59,59.3,24,66,43,23,45,104,145,0
Timo Hübers,GER,DF,27,Köln,Bundesliga,30.9,68,47,51,14,3,49,80,61.3,31,54,28,26,63,131,168,1
Eric Martel,GER,MF,21,Köln,Bundesliga,27.3,70,43,32,34,4,37,67,55.2,30,65,19,46,43,113,80,0
Florian Kainz,AUT,"MF,FW",30,Köln,Bundesliga,24.4,28,20,8,13,7,17,39,43.6,22,20,6,14,13,41,23,1
Dejan Ljubicic,AUT,"MF,FW",25,Köln,Bundesliga,22.8,43,27,20,18,5,20,43,46.5,23,22,2,20,18,61,11,0
Linton Maina,GER,"FW,MF",24,Köln,Bundesliga,21.1,18,15,11,5,2,9,28,32.1,19,12,1,11,6,24,12,0
Jan Thielmann,GER,"FW,DF",21,Köln,Bundesliga,17.5,28,18,13,9,6,12,24,50.0,12,31,6,25,8,36,28,0
Max Finkgräfe,GER,"DF,FW",19,Köln,Bundesliga,19.5,65,39,40,25,0,39,74,52.7,35,35,10,25,22,87,39,0
Rasmus Carstensen,DEN,"DF,FW",22,Köln,Bundesliga,18.4,47,22,23,20,4,31,56,55.4,25,38,9,29,20,67,50,2
Denis Huseinbasic,BIH,MF,22,Köln,Bundesliga,18.1,38,18,17,15,6,20,31,64.5,11,26,1,25,13,51,14,0
Davie Selke,GER,FW,28,Köln,Bundesliga,14.1,4,2,1,3,0,0,2,0.0,2,5,3,2,0,4,20,0
Faride Alidou,GER,"FW,MF",22,Köln,Bundesliga,14.2,10,4,3,6,1,4,18,22.2,14,23,2,21,8,18,15,1
Luca Waldschmidt,GER,"MF,FW",27,Köln,Bundesliga,12.7,19,12,4,12,3,5,16,31.3,11,18,3,15,6,25,8,1
Benno Schmitz,GER,DF,28,Köln,Bundesliga,12.8,27,15,20,7,0,17,34,50.0,17,19,4,15,7,34,29,0
Leart Paqarada,KVX,DF,28,Köln,Bundesliga,11.9,21,11,9,9,3,11,22,50.0,11,17,5,12,10,31,30,1
Sargis Adamyan,ARM,"FW,MF",30,Köln,Bundesliga,8.9,14,9,2,9,3,6,11,54.5,5,16,1,15,5,19,7,0
Steffen Tigges,GER,FW,25,Köln,Bundesliga,8.1,10,6,4,5,1,3,7,42.9,4,4,2,2,1,11,12,0
Luca Kilian,GER,DF,23,Köln,Bundesliga,7.1,16,9,15,1,0,9,14,64.3,5,12,5,7,7,23,28,0
Dominique Heintz,GER,DF,29,Köln,Bundesliga,6.3,12,5,6,6,0,8,12,66.7,4,6,1,5,3,15,28,0
Mark Uth,GER,"MF,FW",31,Köln,Bundesliga,4.1,8,4,2,3,3,4,12,33.3,8,6,0,6,1,9,2,0
Jacob Christensen,DEN,MF,22,Köln,Bundesliga,2.4,10,6,7,3,0,4,7,57.1,3,8,2,6,4,14,4,0
Justin Diehl,GER,"FW,MF",18,Köln,Bundesliga,1.9,0,0,0,0,0,0,0,0.0,0,1,1,0,0,0,0,1
Damion Downs,GER,"FW,MF",19,Köln,Bundesliga,2.0,1,1,1,0,0,1,2,50.0,1,1,0,1,0,1,1,0
Mathias Olesen,LUX,"MF,FW",22,Köln,Bundesliga,1.2,0,0,0,0,0,0,0,0.0,0,0,0,0,2,2,2,0
Florian Dietz,GER,"FW,MF",24,Köln,Bundesliga,0.8,0,0,0,0,0,0,0,0.0,0,1,0,1,0,0,0,0
Marcel Schuhen,GER,GK,30,Darmstadt 98,Bundesliga,31.0,1,0,1,0,0,1,3,33.3,2,0,0,0,2,3,11,4
Tim Skarke,GER,"FW,DF",26,Darmstadt 98,Bundesliga,26.7,26,16,12,10,4,10,28,35.7,18,25,2,23,6,32,20,0
Christoph Klarer,AUT,DF,23,Darmstadt 98,Bundesliga,26.2,37,22,30,4,3,24,36,66.7,12,31,20,11,21,58,94,1
Fabian Holland,GER,"MF,DF",33,Darmstadt 98,Bundesliga,20.4,47,26,18,21,8,20,37,54.1,17,22,12,10,24,71,29,0
Matthias Bader,GER,"DF,MF",26,Darmstadt 98,Bundesliga,20.0,51,25,32,11,8,33,65,50.8,32,22,4,18,25,76,20,0
Matej Maglica,CRO,DF,24,Darmstadt 98,Bundesliga,18.9,35,21,25,10,0,22,36,61.1,14,29,11,18,22,57,92,5
Luca Pfeiffer,GER,"FW,MF",26,Darmstadt 98,Bundesliga,18.0,11,6,2,6,3,5,11,45.5,6,5,1,4,2,13,21,0
Marvin Mehlem,GER,MF,25,Darmstadt 98,Bundesliga,16.5,28,21,10,14,4,11,27,40.7,16,21,2,19,33,61,15,0
Emir Karic,AUT,DF,26,Darmstadt 98,Bundesliga,19.8,45,27,23,14,8,21,33,63.6,12,42,11,31,13,58,43,0
Fabian Nürnberger,GER,"DF,MF",24,Darmstadt 98,Bundesliga,16.8,29,22,22,6,1,22,41,53.7,19,11,1,10,17,46,26,0
Klaus Gjasula,ALB,"DF,MF",33,Darmstadt 98,Bundesliga,15.1,44,22,18,25,1,17,30,56.7,13,26,14,12,19,63,42,2
Oscar Vilhelmsson,SWE,"FW,MF",19,Darmstadt 98,Bundesliga,15.3,13,6,3,7,3,7,10,70.0,3,15,5,10,3,16,19,0
Tobias Kempe,GER,MF,34,Darmstadt 98,Bundesliga,15.0,20,13,9,8,3,8,24,33.3,16,16,4,12,9,29,12,0
Bartol Franjić,CRO,MF,23,Darmstadt 98,Bundesliga,13.7,15,12,4,10,1,7,28,25.0,21,12,4,8,30,45,29,2
Christoph Zimmermann,GER,DF,30,Darmstadt 98,Bundesliga,13.6,33,21,26,7,0,19,39,48.7,20,21,14,7,21,54,66,1
Jannik Müller,GER,"DF,MF",29,Darmstadt 98,Bundesliga,12.6,33,16,21,9,3,16,27,59.3,11,24,12,12,17,50,39,1
Julian Justvan,GER,"MF,FW",25,Darmstadt 98,Bundesliga,11.4,10,4,2,7,1,3,17,17.6,14,12,2,10,11,21,6,1
Mathias Honsak,AUT,"FW,MF",26,Darmstadt 98,Bundesliga,11.3,14,7,7,6,1,6,20,30.0,14,14,2,12,8,22,25,0
Clemens Riedel,GER,DF,20,Darmstadt 98,Bundesliga,8.4,22,13,16,5,1,15,24,62.5,9,11,3,8,11,33,26,0
Thomas Isherwood,SWE,DF,25,Darmstadt 98,Bundesliga,7.1,11,5,7,3,1,5,9,55.6,4,10,7,3,10,21,34,0
Aaron Seydel,GER,FW,27,Darmstadt 98,Bundesliga,6.9,3,2,0,2,1,0,3,0.0,3,8,2,6,1,4,9,0
Sebastian Polter,GER,FW,32,Darmstadt 98,Bundesliga,5.0,1,0,1,0,0,0,1,0.0,1,5,1,4,0,1,4,0
Alexander Brunst,GER,GK,28,Darmstadt 98,Bundesliga,3.0,0,0,0,0,0,0,2,0.0,2,0,0,0,0,0,2,1
Braydon Manu,GHA,MF,26,Darmstadt 98,Bundesliga,1.9,2,0,0,1,1,0,0,0.0,0,1,0,1,0,2,0,0
Gerrit Holtmann,PHI,"MF,FW",28,Darmstadt 98,Bundesliga,4.4,8,5,3,4,1,7,10,70.0,3,7,0,7,2,10,4,1
Andreas Müller,GER,MF,23,Darmstadt 98,Bundesliga,3.9,14,9,8,5,1,4,9,44.4,5,5,2,3,4,18,5,0
Fabian Schnellhardt,GER,MF,29,Darmstadt 98,Bundesliga,2.6,4,1,2,1,1,1,3,33.3,2,1,0,1,4,8,5,0
Fraser Hornby,SCO,"FW,MF",23,Darmstadt 98,Bundesliga,2.4,0,0,0,0,0,0,1,0.0,1,2,1,1,0,0,4,0
Fabio Torsiello,ITA,"FW,DF",18,Darmstadt 98,Bundesliga,1.7,1,0,1,0,0,1,8,12.5,7,1,0,1,1,2,1,0
Filip Stojilković,SUI,"FW,MF",23,Darmstadt 98,Bundesliga,1.7,1,1,0,0,1,0,0,0.0,0,0,0,0,0,1,1,0
Frank Ronstadt,GER,"DF,MF",26,Darmstadt 98,Bundesliga,0.8,1,0,0,1,0,0,1,0.0,1,1,0,1,1,2,3,0
Luuk de Jong,NED,FW,32,PSV Eindhoven,Eredivisie,30.6,29,17,5,13,11,10,22,45.5,12,29,7,22,3,32,29,0
Walter Benítez,ARG,GK,30,PSV Eindhoven,Eredivisie,32.9,0,0,0,0,0,0,3,0.0,3,0,0,0,0,0,6,4
Olivier Boscagli,FRA,DF,25,PSV Eindhoven,Eredivisie,31.5,41,26,23,13,5,23,39,59.0,16,32,16,16,66,107,119,3
Johan Bakayoko,BEL,FW,20,PSV Eindhoven,Eredivisie,27.7,33,23,13,10,10,8,22,36.4,14,27,1,26,9,42,4,0
Jordan Teze,NED,DF,23,PSV Eindhoven,Eredivisie,27.6,51,31,21,22,8,31,49,63.3,18,34,2,32,16,67,36,0
André Ramalho,BRA,DF,31,PSV Eindhoven,Eredivisie,26.2,48,31,25,22,1,23,34,67.6,11,38,27,11,30,78,98,2
Jerdy Schouten,NED,"MF,DF",26,PSV Eindhoven,Eredivisie,26.9,54,32,17,29,8,25,37,67.6,12,26,6,20,43,97,30,1
Joey Veerman,NED,MF,24,PSV Eindhoven,Eredivisie,26.5,68,45,35,24,9,38,77,49.4,39,30,4,26,20,88,33,1
Sergiño Dest,USA,DF,22,PSV Eindhoven,Eredivisie,23.5,33,21,18,14,1,18,29,62.1,11,23,3,20,11,44,28,1
Guus Til,NED,MF,25,PSV Eindhoven,Eredivisie,22.6,19,10,7,8,4,8,23,34.8,15,15,5,10,11,30,13,0
Malik Tillman,USA,"FW,MF",21,PSV Eindhoven,Eredivisie,17.7,39,23,17,15,7,16,36,44.4,20,39,4,35,15,54,10,0
Hirving Lozano,MEX,FW,28,PSV Eindhoven,Eredivisie,17.1,24,14,8,12,4,7,20,35.0,13,17,1,16,15,39,4,0
Ismael Saibari,MAR,MF,22,PSV Eindhoven,Eredivisie,11.3,31,20,13,11,7,13,28,46.4,15,14,3,11,10,41,10,0
Patrick van Aanholt,NED,DF,32,PSV Eindhoven,Eredivisie,12.4,22,17,13,6,3,13,20,65.0,7,4,1,3,15,37,9,0
Mauro Júnior,BRA,"MF,DF",24,PSV Eindhoven,Eredivisie,9.7,18,12,8,7,3,12,19,63.2,7,9,2,7,7,25,17,0
Noa Lang,NED,"FW,MF",24,PSV Eindhoven,Eredivisie,6.5,3,1,0,2,1,1,5,20.0,4,6,0,6,1,4,3,0
Yorbe Vertessen,BEL,FW,22,PSV Eindhoven,Eredivisie,4.9,5,4,3,0,2,5,12,41.7,7,3,1,2,1,6,6,0
Isaac Babadi,NED,MF,18,PSV Eindhoven,Eredivisie,3.9,8,3,2,3,3,3,5,60.0,2,3,0,3,1,9,1,0
Ibrahim Sangaré,CIV,MF,25,PSV Eindhoven,Eredivisie,2.0,2,0,1,1,0,2,2,100.0,0,2,0,2,2,4,2,0
Armel Bella Kotchap,GER,DF,21,PSV Eindhoven,Eredivisie,1.8,1,0,0,0,1,0,2,0.0,2,1,0,1,2,3,5,0
Ricardo Pepi,USA,"FW,MF",20,PSV Eindhoven,Eredivisie,5.4,9,3,0,4,5,1,3,33.3,2,1,0,1,1,10,2,0
Shurandy Sambo,NED,DF,21,PSV Eindhoven,Eredivisie,2.1,3,3,1,1,1,3,4,75.0,1,3,1,2,5,8,5,0
Armando Obispo,NED,DF,24,PSV Eindhoven,Eredivisie,1.9,3,2,3,0,0,1,1,100.0,0,4,2,2,1,4,5,0
Joel Drommel,NED,GK,26,PSV Eindhoven,Eredivisie,1.0,0,0,0,0,0,0,0,0.0,0,0,0,0,0,0,1,0
Tygo Land,NED,MF,17,PSV Eindhoven,Eredivisie,0.2,2,2,0,2,0,0,0,0.0,0,0,0,0,0,2,0,0
Richy Ledezma,USA,MF,22,PSV Eindhoven,Eredivisie,0.1,0,0,0,0,0,0,0,0.0,0,0,0,0,0,0,0,0
Boy Waterman,NED,GK,39,PSV Eindhoven,Eredivisie,0.1,0,0,0,0,0,0,0,0.0,0,0,0,0,0,0,0,0
Anwar El Ghazi,NED,FW,28,PSV Eindhoven,Eredivisie,0.0,0,0,0,0,0,0,0,0.0,0,0,0,0,0,0,0,0
Jesper Uneken,NED,FW,18,PSV Eindhoven,Eredivisie,0.0,0,0,0,0,0,0,0,0.0,0,0,0,0,0,0,0,0
Lutsharel Geertruida,NED,DF,23,Feyenoord,Eredivisie,33.8,49,31,29,15,5,23,34,67.6,11,18,4,14,31,80,49,2
Dávid Hancko,SVK,DF,25,Feyenoord,Eredivisie,33.7,38,27,22,13,3,23,40,57.5,17,29,24,5,29,67,94,0
Quinten Timber,NED,MF,22,Feyenoord,Eredivisie,29.6,66,42,17,29,20,24,39,61.5,15,32,5,27,13,79,16,0
Mats Wieffer,NED,MF,23,Feyenoord,Eredivisie,28.8,83,44,26,45,12,50,90,55.6,40,68,16,52,50,133,38,0
Santiago Giménez,MEX,FW,22,Feyenoord,Eredivisie,26.3,8,1,1,4,3,2,9,22.2,7,19,2,17,0,8,9,0
Calvin Stengs,NED,"MF,FW",24,Feyenoord,Eredivisie,23.3,31,17,4,19,8,9,26,34.6,17,18,0,18,3,34,10,0
Quilindschy Hartman,NED,DF,21,Feyenoord,Eredivisie,23.0,45,25,20,17,8,19,42,45.2,23,21,1,20,28,73,22,0
Igor Paixão,BRA,FW,23,Feyenoord,Eredivisie,21.4,22,15,5,10,7,10,27,37.0,17,20,0,20,9,31,18,1
Timon Wellenreuther,GER,GK,27,Feyenoord,Eredivisie,17.8,1,1,1,0,0,1,2,50.0,1,0,0,0,0,1,8,0
Justin Bijlow,NED,GK,25,Feyenoord,Eredivisie,16.2,0,0,0,0,0,0,2,0.0,2,0,0,0,0,0,8,4
Yankuba Minteh,GAM,FW,19,Feyenoord,Eredivisie,16.2,46,30,18,15,13,11,30,36.7,19,19,2,17,3,49,14,0
Gernot Trauner,AUT,DF,31,Feyenoord,Eredivisie,15.1,27,20,19,7,1,18,25,72.0,7,6,2,4,20,47,50,1
Ramiz Zerrouki,ALG,MF,25,Feyenoord,Eredivisie,15.4,39,24,17,18,4,18,29,62.1,11,27,6,21,17,56,24,0
Thomas Beelen,NED,DF,22,Feyenoord,Eredivisie,14.4,25,10,19,6,0,12,13,92.3,1,14,7,7,16,41,41,0
Luka Ivanušec,CRO,FW,24,Feyenoord,Eredivisie,12.9,20,16,5,8,7,8,23,34.8,15,9,0,9,4,24,11,0
Bart Nieuwkoop,NED,DF,27,Feyenoord,Eredivisie,9.5,15,7,7,7,1,7,20,35.0,13,15,2,13,16,31,25,0
Ayase Ueda,JPN,"FW,MF",24,Feyenoord,Eredivisie,9.3,7,4,0,5,2,0,4,0.0,4,7,1,6,0,7,11,0
Marcos López,PER,DF,23,Feyenoord,Eredivisie,5.2,6,3,4,2,0,2,5,40.0,3,5,3,2,2,8,6,0
Alireza Jahanbakhsh,IRN,"FW,MF",29,Feyenoord,Eredivisie,5.1,23,13,9,7,7,12,17,70.6,5,6,0,6,5,28,7,0
Javairô Dilrosun,NED,"FW,MF",25,Feyenoord,Eredivisie,3.5,7,5,3,2,2,4,6,66.7,2,3,1,2,4,11,0,0
Thomas van den Belt,NED,MF,22,Feyenoord,Eredivisie,3.0,8,5,6,0,2,4,5,80.0,1,5,0,5,2,10,2,0
Antoni Milambo,NED,"MF,FW",18,Feyenoord,Eredivisie,2.6,4,2,2,2,0,1,1,100.0,0,3,1,2,1,5,2,0
Ondřej Lingr,CZE,"MF,FW",24,Feyenoord,Eredivisie,3.8,4,1,1,3,0,1,4,25.0,3,4,0,4,1,5,1,0
Leo Sauer,SVK,"FW,MF",17,Feyenoord,Eredivisie,3.2,3,1,1,2,0,0,5,0.0,5,3,0,3,1,4,0,0
Gjivai Zechiël,NED,"DF,MF",19,Feyenoord,Eredivisie,0.3,3,0,1,2,0,3,4,75.0,1,1,0,1,0,3,1,0
Robin Pröpper,NED,DF,29,Twente,Eredivisie,30.5,45,30,18,23,4,20,44,45.5,24,34,16,18,32,77,90,1
Daan Rots,NED,FW,22,Twente,Eredivisie,28.6,59,38,20,24,15,35,85,41.2,50,30,1,29,17,76,20,0
Lars Unnerstall,GER,GK,33,Twente,Eredivisie,32.0,0,0,0,0,0,0,0,0.0,0,0,0,0,0,0,12,1
Sem Steijn,NED,MF,21,Twente,Eredivisie,26.8,29,17,13,11,5,18,51,35.3,33,18,2,16,10,39,10,0
Michal Sadílek,CZE,MF,24,Twente,Eredivisie,30.0,49,21,18,25,6,20,57,35.1,37,46,9,37,28,77,37,0
Mathias Kjølø,NOR,MF,22,Twente,Eredivisie,24.8,29,19,9,15,5,18,29,62.1,11,19,3,16,28,57,32,0
Mees Hilgers,NED,DF,22,Twente,Eredivisie,24.3,52,32,32,19,1,33,56,58.9,23,27,8,19,26,78,51,1
Gijs Smal,NED,DF,25,Twente,Eredivisie,22.8,34,19,14,13,7,22,46,47.8,24,27,3,24,16,50,35,0
Michel Vlap,NED,FW,26,Twente,Eredivisie,21.9,17,14,5,10,2,9,23,39.1,14,13,0,13,16,33,13,0
Youri Regeer,NED,"DF,MF",19,Twente,Eredivisie,19.5,41,23,20,16,5,23,37,62.2,14,19,2,17,14,55,38,2
Alfons Sampsted,ISL,DF,25,Twente,Eredivisie,17.1,36,20,25,7,4,30,55,54.5,25,20,5,15,30,66,41,0
Ricky van Wolfswinkel,NED,"FW,MF",34,Twente,Eredivisie,21.0,24,14,6,10,8,3,12,25.0,9,28,1,27,9,33,18,0
Manfred Ugalde,CRC,FW,21,Twente,Eredivisie,15.2,14,10,2,6,6,2,12,16.7,10,13,1,12,1,15,6,0
Joshua Brenet,CUW,DF,29,Twente,Eredivisie,12.0,31,19,15,11,5,19,34,55.9,15,11,0,11,12,43,11,1
Carel Eiting,NED,MF,25,Twente,Eredivisie,8.8,21,9,7,11,3,11,22,50.0,11,5,1,4,8,29,20,0
Max Bruns,NED,DF,20,Twente,Eredivisie,6.3,8,6,4,3,1,4,8,50.0,4,6,3,3,7,15,21,1
Alec Van Hoorenbeeck,BEL,DF,24,Twente,Eredivisie,5.8,6,4,6,0,0,4,7,57.1,3,12,8,4,4,10,40,2
Mitchell van Bergen,NED,FW,23,Twente,Eredivisie,5.8,6,5,3,0,3,3,8,37.5,5,9,1,8,4,10,7,0
Naci Ünüvar,NED,"FW,MF",20,Twente,Eredivisie,5.6,9,4,0,5,4,3,8,37.5,5,11,1,10,2,11,4,0
Younes Taha El Idrissi,MAR,"FW,MF",21,Twente,Eredivisie,5.2,12,8,3,7,2,8,18,44.4,10,6,0,6,1,13,3,0
Myron Boadu,NED,"FW,MF",22,Twente,Eredivisie,3.3,1,1,0,1,0,0,2,0.0,2,3,0,3,0,1,2,0
Przemysław Tytoń,POL,GK,36,Twente,Eredivisie,2.0,0,0,0,0,0,0,0,0.0,0,0,0,0,0,0,0,0
Mats Rots,NED,DF,17,Twente,Eredivisie,0.8,0,0,0,0,0,0,1,0.0,1,1,0,1,2,2,2,0
Anass Salah-Eddine,NED,"DF,MF",21,Twente,Eredivisie,1.4,9,6,4,2,3,5,6,83.3,1,2,0,2,1,10,1,0
Gijs Besselink,NED,"FW,MF",19,Twente,Eredivisie,0.6,6,2,2,2,2,3,3,100.0,0,0,0,0,1,7,0,0
Julien Mesbahi,NED,DF,17,Twente,Eredivisie,0.4,3,2,3,0,0,1,1,100.0,0,1,0,1,0,3,3,0
Vangelis Pavlidis,GRE,FW,24,AZ Alkmaar,Eredivisie,33.3,35,18,5,20,10,17,30,56.7,13,26,6,20,3,38,31,0
Yukinari Sugawara,JPN,DF,23,AZ Alkmaar,Eredivisie,28.4,34,25,17,15,2,25,41,61.0,16,31,11,20,18,52,59,1
Mathew Ryan,AUS,GK,31,AZ Alkmaar,Eredivisie,29.0,0,0,0,0,0,0,0,0.0,0,0,0,0,0,0,6,0
Dani de Wit,NED,MF,25,AZ Alkmaar,Eredivisie,27.9,46,25,8,26,12,19,46,41.3,27,33,6,27,16,62,30,0
Riechedly Bazoer,NED,DF,26,AZ Alkmaar,Eredivisie,27.0,19,16,15,3,1,9,13,69.2,4,18,14,4,21,40,49,4
David Møller Wolfe,NOR,DF,21,AZ Alkmaar,Eredivisie,26.4,44,25,26,11,7,21,38,55.3,17,26,9,17,30,74,43,0
Sven Mijnans,NED,"MF,FW",23,AZ Alkmaar,Eredivisie,26.3,44,26,16,19,9,20,46,43.5,26,46,5,41,25,69,40,0
Jordy Clasie,NED,MF,32,AZ Alkmaar,Eredivisie,27.4,63,32,24,34,5,28,54,51.9,26,22,4,18,43,106,35,0
Ruben van Bommel,NED,FW,18,AZ Alkmaar,Eredivisie,17.2,35,21,10,18,7,17,33,51.5,16,11,0,11,10,45,12,0
Alexandre Penetra,POR,DF,21,AZ Alkmaar,Eredivisie,19.5,13,7,10,2,1,11,16,68.8,5,19,14,5,20,33,76,0
Myron van Brederode,NED,FW,20,AZ Alkmaar,Eredivisie,14.6,29,19,9,13,7,14,34,41.2,20,18,1,17,9,38,5,0
Wouter Goes,NED,DF,19,AZ Alkmaar,Eredivisie,12.6,17,12,12,4,1,11,17,64.7,6,17,14,3,12,29,46,0
Kristijan Belic,SRB,MF,22,AZ Alkmaar,Eredivisie,10.2,41,28,17,22,2,18,34,52.9,16,30,5,25,18,59,16,0
Mayckel Lahdo,SWE,FW,20,AZ Alkmaar,Eredivisie,8.5,11,6,4,7,0,8,14,57.1,6,11,0,11,2,13,2,0
Bruno Martins Indi,NED,DF,31,AZ Alkmaar,Eredivisie,8.4,9,4,6,3,0,3,4,75.0,1,14,10,4,7,16,25,1
Tiago Dantas,POR,MF,22,AZ Alkmaar,Eredivisie,7.7,14,8,4,6,4,7,16,43.8,9,5,3,2,3,17,5,0
Ernest Poku,NED,FW,19,AZ Alkmaar,Eredivisie,7.4,11,7,4,4,3,4,13,30.8,9,6,1,5,5,16,8,0
Ibrahim Sadiq,GHA,"FW,MF",23,AZ Alkmaar,Eredivisie,7.3,16,12,7,7,2,8,10,80.0,2,14,1,13,4,20,7,0
Jens Odgaard,DEN,"FW,MF",24,AZ Alkmaar,Eredivisie,4.9,12,4,3,5,4,5,9,55.6,4,7,1,6,1,13,4,0
Mees de Wit,NED,DF,25,AZ Alkmaar,Eredivisie,4.6,10,7,4,5,1,3,6,50.0,3,5,3,2,3,13,16,0
Rome-Jayden Owusu-Oduro,NED,GK,19,AZ Alkmaar,Eredivisie,4.0,0,0,0,0,0,0,0,0.0,0,0,0,0,0,0,1,0
Denso Kasius,NED,DF,20,AZ Alkmaar,Eredivisie,5.0,14,11,7,4,3,8,16,50.0,8,9,2,7,9,23,12,0
Djordje Mihailovic,USA,MF,24,AZ Alkmaar,Eredivisie,3.1,9,6,3,5,1,4,7,57.1,3,2,0,2,3,12,1,0
Jayden Addai,NED,FW,17,AZ Alkmaar,Eredivisie,3.3,9,7,6,1,2,6,11,54.5,5,3,0,3,0,9,2,0
Pantelis Hatzidiakos,GRE,DF,26,AZ Alkmaar,Eredivisie,2.0,2,1,2,0,0,1,1,100.0,0,1,0,1,1,3,6,0
Kenzo Goudmijn,NED,MF,21,AZ Alkmaar,Eredivisie,2.7,8,2,2,6,0,4,11,36.4,7,1,0,1,1,9,2,0
Hobie Verhulst,NED,GK,30,AZ Alkmaar,Eredivisie,1.0,0,0,0,0,0,0,0,0.0,0,0,0,0,0,0,1,0
Dave Kwakman,NED,MF,18,AZ Alkmaar,Eredivisie,0.8,1,0,0,1,0,1,4,25.0,3,0,0,0,1,2,0,0
Maxim Dekker,NED,DF,19,AZ Alkmaar,Eredivisie,0.9,4,2,2,2,0,4,4,100.0,0,0,0,0,3,7,4,0
Lequincio Zeefuik,NED,"MF,FW",18,AZ Alkmaar,Eredivisie,0.7,0,0,0,0,0,0,0,0.0,0,0,0,0,0,0,2,0
Finn Stam,NED,DF,20,AZ Alkmaar,Eredivisie,0.4,0,0,0,0,0,0,0,0.0,0,0,0,0,0,0,1,0
Mexx Meerdink,NED,"FW,MF",20,AZ Alkmaar,Eredivisie,0.3,0,0,0,0,0,0,0,0.0,0,0,0,0,0,0,1,0
Kees Smit,NED,MF,17,AZ Alkmaar,Eredivisie,0.2,3,2,2,1,0,3,4,75.0,1,0,0,0,1,4,1,0
Jorrel Hato,NED,DF,17,Ajax,Eredivisie,32.9,67,38,36,24,7,31,52,59.6,21,50,22,28,45,112,84,0
Kenneth Taylor,NED,"MF,DF",21,Ajax,Eredivisie,30.6,43,27,14,20,9,11,28,39.3,17,40,9,31,26,69,29,0
Brian Brobbey,NED,FW,21,Ajax,Eredivisie,26.7,7,4,0,2,5,2,4,50.0,2,16,1,15,0,7,25,0
Devyne Rensch,NED,DF,20,Ajax,Eredivisie,24.6,43,29,23,15,5,27,37,73.0,10,21,6,15,31,74,51,0
Steven Bergwijn,NED,"FW,MF",25,Ajax,Eredivisie,21.6,17,12,7,6,4,9,21,42.9,12,12,1,11,4,21,7,0
Josip Šutalo,CRO,DF,23,Ajax,Eredivisie,22.0,29,12,20,9,0,13,22,59.1,9,24,15,9,40,69,86,0
Kristian Nökkvi Hlynsson,ISL,"MF,FW",19,Ajax,Eredivisie,19.6,20,13,5,10,5,7,29,24.1,22,13,2,11,5,25,16,0
Diant Ramaj,GER,GK,21,Ajax,Eredivisie,20.3,0,0,0,0,0,0,2,0.0,2,0,0,0,0,0,7,3
Benjamin Tahirovic,BIH,MF,20,Ajax,Eredivisie,18.5,34,24,10,21,3,17,36,47.2,19,23,7,16,26,60,20,0
Steven Berghuis,NED,"FW,MF",31,Ajax,Eredivisie,16.0,26,15,14,8,4,12,22,54.5,10,14,0,14,5,31,11,0
Anton Gaaei,DEN,DF,20,Ajax,Eredivisie,12.9,24,13,12,8,4,10,18,55.6,8,13,4,9,20,44,24,1
Sivert Mannsverk,NOR,"MF,DF",21,Ajax,Eredivisie,9.8,11,7,5,5,1,6,11,54.5,5,7,4,3,9,20,17,0
Branco van den Boomen,NED,MF,28,Ajax,Eredivisie,11.9,21,11,6,12,3,11,24,45.8,13,20,4,16,8,29,8,2
Ahmetcan Kaplan,TUR,DF,20,Ajax,Eredivisie,10.5,20,14,10,10,0,12,20,60.0,8,16,8,8,9,29,35,0
Borna Sosa,CRO,DF,25,Ajax,Eredivisie,9.4,22,14,13,6,3,20,30,66.7,10,13,3,10,16,38,19,0
Jordan Henderson,ENG,MF,33,Ajax,Eredivisie,8.3,13,2,3,8,2,8,14,57.1,6,19,4,15,5,18,9,0
Chuba Akpom,ENG,"FW,MF",27,Ajax,Eredivisie,11.7,15,8,2,10,3,4,8,50.0,4,9,0,9,3,18,13,0
Carlos Forbs,POR,FW,19,Ajax,Eredivisie,9.2,19,12,8,7,4,10,19,52.6,9,14,1,13,2,21,7,0
Ar'jany Martha,NED,"DF,FW",19,Ajax,Eredivisie,7.8,25,12,13,8,4,14,28,50.0,14,9,1,8,11,36,16,0
Jay Gorter,NED,GK,23,Ajax,Eredivisie,7.4,0,0,0,0,0,0,2,0.0,2,1,0,1,0,0,4,1
Mika Godts,BEL,"FW,MF",18,Ajax,Eredivisie,6.4,10,5,2,5,3,3,8,37.5,5,6,0,6,1,11,3,0
Gerónimo Rulli,ARG,GK,31,Ajax,Eredivisie,6.3,0,0,0,0,0,0,0,0.0,0,0,0,0,0,0,4,1
Tristan Gooijer,NED,"DF,MF",18,Ajax,Eredivisie,6.3,28,17,12,9,7,20,24,83.3,4,5,0,5,4,32,14,1
Gastón Ávila,ARG,DF,21,Ajax,Eredivisie,3.9,15,10,10,5,0,14,27,51.9,13,7,1,6,3,18,12,0
Silvano Vos,NED,MF,18,Ajax,Eredivisie,3.9,5,5,2,3,0,3,8,37.5,5,8,4,4,12,17,2,0
Jakov Medić,CRO,DF,24,Ajax,Eredivisie,3.7,3,2,2,1,0,1,3,33.3,2,4,3,1,2,5,8,1
Georges Mikautadze,GEO,"MF,FW",22,Ajax,Eredivisie,2.6,1,0,1,0,0,0,3,0.0,3,1,0,1,0,1,2,0
Anass Salah-Eddine,NED,DF,21,Ajax,Eredivisie,2.1,4,3,2,2,0,4,11,36.4,7,4,1,3,1,5,5,1
Mohammed Kudus,GHA,"FW,MF",22,Ajax,Eredivisie,2.0,2,2,1,0,1,0,3,0.0,3,4,0,4,1,3,3,0
Jaydon Amauri Banel,NED,"FW,MF",18,Ajax,Eredivisie,1.0,3,2,1,1,1,1,4,25.0,3,0,0,0,0,3,1,0
Amourrichio Van Axel Dongen,NED,FW,18,Ajax,Eredivisie,0.6,1,0,0,0,1,0,1,0.0,1,2,0,2,1,2,0,0
Julian Rijkhoff,NED,"FW,MF",18,Ajax,Eredivisie,0.8,2,1,0,0,2,0,2,0.0,2,0,0,0,1,3,0,0
Davy Klaassen,NED,MF,30,Ajax,Eredivisie,0.7,0,0,0,0,0,0,1,0.0,1,0,0,0,1,1,0,0
Owen Wijndal,NED,DF,23,Ajax,Eredivisie,0.5,2,1,2,0,0,1,2,50.0,1,0,0,0,1,3,0,0
Kian Fitz-Jim,NED,"MF,FW",20,Ajax,Eredivisie,0.5,1,1,0,1,0,0,2,0.0,2,0,0,0,0,1,0,0
Calvin Verdonk,NED,DF,26,NEC Nijmegen,Eredivisie,31.7,109,71,70,29,10,55,86,64.0,31,52,17,35,39,148,123,3
Jasper Cillessen,NED,GK,34,NEC Nijmegen,Eredivisie,29.3,0,0,0,0,0,0,4,0.0,4,1,0,1,0,0,7,2
Bram Nuytinck,NED,DF,33,NEC Nijmegen,Eredivisie,26.7,31,21,17,9,5,17,28,60.7,11,66,50,16,27,58,136,1
Dirk Proper,NED,MF,21,NEC Nijmegen,Eredivisie,25.5,48,24,26,21,1,21,44,47.7,23,29,11,18,28,76,59,0
Koki Ogawa,JPN,FW,25,NEC Nijmegen,Eredivisie,24.5,15,12,4,9,2,4,19,21.1,15,12,3,9,5,20,22,0
Sontje Hansen,NED,FW,21,NEC Nijmegen,Eredivisie,21.2,30,16,9,12,9,11,26,42.3,15,21,0,21,6,36,15,0
Bart van Rooij,NED,DF,22,NEC Nijmegen,Eredivisie,21.9,47,23,32,14,1,28,55,50.9,27,33,6,27,12,59,54,1
Mees Hoedemakers,NED,MF,25,NEC Nijmegen,Eredivisie,21.7,44,35,22,18,4,25,59,42.4,34,36,11,25,30,74,38,1
Philippe Sandler,NED,DF,26,NEC Nijmegen,Eredivisie,20.8,24,14,16,8,0,9,11,81.8,2,26,21,5,17,41,89,1
Magnus Mattsson,DEN,MF,24,NEC Nijmegen,Eredivisie,19.0,37,18,15,11,11,9,37,24.3,28,26,3,23,14,51,17,0
Youri Baas,NED,"DF,FW",20,NEC Nijmegen,Eredivisie,19.1,66,40,46,16,4,42,78,53.8,36,33,7,26,14,80,27,1
Kodai Sano,JPN,"FW,MF",19,NEC Nijmegen,Eredivisie,17.7,33,17,14,15,4,19,37,51.4,18,29,5,24,20,53,26,0
Roberto González,ESP,"FW,MF",22,NEC Nijmegen,Eredivisie,15.4,25,14,14,8,3,9,29,31.0,20,15,1,14,4,29,11,0
Lasse Schöne,DEN,MF,37,NEC Nijmegen,Eredivisie,13.8,14,7,7,4,3,9,20,45.0,11,9,3,6,13,27,35,0
Tjaronn Chery,SUR,"MF,FW",35,NEC Nijmegen,Eredivisie,11.5,8,6,4,4,0,4,12,33.3,8,8,3,5,4,12,2,0
Brayann Pereira,FRA,DF,20,NEC Nijmegen,Eredivisie,8.8,37,24,32,5,0,20,33,60.6,13,17,6,11,14,51,24,1
Mathias Ross,DEN,DF,22,NEC Nijmegen,Eredivisie,11.6,14,8,9,5,0,5,13,38.5,8,12,7,5,11,25,89,2
Lars Olden Larsen,NOR,FW,24,NEC Nijmegen,Eredivisie,7.5,23,17,11,10,2,13,31,41.9,18,11,1,10,4,27,10,0
Bas Dost,NED,FW,34,NEC Nijmegen,Eredivisie,5.1,2,0,1,0,1,0,2,0.0,2,0,0,0,1,3,7,0
Sylla Sow,NED,FW,26,NEC Nijmegen,Eredivisie,5.4,4,2,1,1,2,1,3,33.3,2,2,1,1,1,5,1,0
Robin Roefs,NED,GK,20,NEC Nijmegen,Eredivisie,4.7,0,0,0,0,0,0,0,0.0,0,0,0,0,0,0,2,0
Elayis Tavsan,NED,FW,22,NEC Nijmegen,Eredivisie,3.8,4,3,1,2,1,2,4,50.0,2,3,1,2,0,4,5,0
Yvandro Borges Sanches,LUX,"FW,MF",19,NEC Nijmegen,Eredivisie,2.4,2,1,0,0,2,0,4,0.0,4,5,0,5,0,2,1,0
Sai van Wermeskerken,JPN,DF,29,NEC Nijmegen,Eredivisie,1.8,4,3,2,1,1,3,6,50.0,3,5,2,3,4,8,7,0
Pedro David Rosendo Marques,POR,FW,25,NEC Nijmegen,Eredivisie,0.5,0,0,0,0,0,0,1,0.0,1,0,0,0,0,0,0,0
Nils Rossen,NED,"MF,FW",17,NEC Nijmegen,Eredivisie,0.3,0,0,0,0,0,0,0,0.0,0,0,0,0,0,0,0,0
Luc Netten,NED,DF,19,NEC Nijmegen,Eredivisie,0.3,1,0,0,1,0,1,2,50.0,1,0,0,0,0,1,5,0
D'Leanu Arts,NED,DF,20,NEC Nijmegen,Eredivisie,0.3,0,0,0,0,0,0,2,0.0,2,0,0,0,0,0,1,0
Ryan Flamingo,NED,"MF,DF",20,Utrecht,Eredivisie,30.7,44,26,25,16,3,27,56,48.2,29,35,11,24,39,83,118,1
Vasilios Barkas,GRE,GK,29,Utrecht,Eredivisie,29.0,2,2,2,0,0,2,4,50.0,2,0,0,0,0,2,9,1
Souffian El Karouani,MAR,DF,22,Utrecht,Eredivisie,27.2,67,50,35,26,6,33,53,62.3,20,22,7,15,17,84,59,0
Oscar Fraulo,DEN,MF,19,Utrecht,Eredivisie,23.3,40,27,10,24,6,13,36,36.1,23,20,8,12,17,57,35,1
Hidde ter Avest,NED,DF,26,Utrecht,Eredivisie,22.9,34,24,18,9,7,14,24,58.3,10,35,13,22,23,57,76,1
Nick Viergever,NED,DF,33,Utrecht,Eredivisie,22.8,32,15,24,5,3,23,31,74.2,8,29,18,11,13,45,93,1
Othman Boussaid,BEL,FW,23,Utrecht,Eredivisie,21.9,20,12,9,9,2,13,40,32.5,27,19,1,18,19,39,9,1
Can Bozdogan,GER,MF,22,Utrecht,Eredivisie,21.8,55,36,17,32,6,30,58,51.7,28,28,6,22,25,80,34,0
Jens Toornstra,NED,"MF,FW",34,Utrecht,Eredivisie,19.8,42,24,20,18,4,15,36,41.7,21,25,1,24,14,56,20,0
Mike van der Hoorn,NED,DF,30,Utrecht,Eredivisie,18.5,27,18,18,9,0,18,29,62.1,11,16,5,11,14,41,70,0
Sam Lammers,NED,FW,26,Utrecht,Eredivisie,17.8,25,16,3,14,8,6,16,37.5,10,19,3,16,4,29,4,0
Victor Jensen,DEN,"MF,FW",23,Utrecht,Eredivisie,16.4,35,19,15,18,2,11,27,40.7,16,11,3,8,6,41,12,0
Taylor Booth,USA,FW,22,Utrecht,Eredivisie,9.6,11,5,4,4,3,4,12,33.3,8,7,2,5,7,18,7,0
Mats Seuntjens,NED,"FW,MF",31,Utrecht,Eredivisie,10.6,9,5,4,4,1,5,15,33.3,10,5,1,4,5,14,11,0
Isac Lidberg,SWE,FW,24,Utrecht,Eredivisie,10.5,8,5,1,2,5,1,3,33.3,2,7,0,7,1,9,8,0
Modibo Sagnan,MLI,DF,24,Utrecht,Eredivisie,9.7,23,13,12,10,1,13,15,86.7,2,12,8,4,8,31,62,1
Marouan Azarkan,NED,FW,21,Utrecht,Eredivisie,8.8,17,12,8,5,4,11,25,44.0,14,21,0,21,6,23,9,0
Mark van der Maarel,NED,DF,33,Utrecht,Eredivisie,8.3,13,5,8,3,2,4,14,28.6,10,9,3,6,5,18,30,0
Yannick Leliendal,NED,DF,21,Utrecht,Eredivisie,5.5,14,7,8,5,1,10,18,55.6,8,4,1,3,7,21,22,0
Mattijs Branderhorst,NED,GK,29,Utrecht,Eredivisie,5.0,0,0,0,0,0,0,0,0.0,0,0,0,0,0,0,3,1
Ole Romeny,NED,"FW,MF",23,Utrecht,Eredivisie,5.8,6,3,5,0,1,4,6,66.7,2,3,0,3,3,9,2,0
Zidane Iqbal,IRQ,"MF,DF",20,Utrecht,Eredivisie,5.7,16,10,11,4,1,11,19,57.9,8,3,1,2,3,19,8,1
Zakaria Labyad,MAR,"MF,FW",30,Utrecht,Eredivisie,3.1,4,2,2,2,0,0,3,0.0,3,2,0,2,2,6,2,0
Bart Ramselaar,NED,"FW,MF",27,Utrecht,Eredivisie,4.5,1,1,0,1,0,0,4,0.0,4,5,2,3,3,4,3,0
Niklas Vesterlund,DEN,"DF,FW",24,Utrecht,Eredivisie,3.0,5,4,5,0,0,4,5,80.0,1,8,5,3,1,6,10,0
Anthony Descotte,BEL,FW,19,Utrecht,Eredivisie,2.3,3,3,0,1,2,1,4,25.0,3,4,0,4,1,4,1,0
Hugo Novoa,ESP,"DF,FW",20,Utrecht,Eredivisie,2.3,6,3,2,3,1,3,7,42.9,4,7,1,6,3,9,4,0
Anastasios Douvikas,GRE,FW,23,Utrecht,Eredivisie,2.0,1,1,0,1,0,1,4,25.0,3,1,0,1,0,1,0,0
Sean Klaiber,SUR,DF,29,Utrecht,Eredivisie,1.1,7,7,4,2,1,5,6,83.3,1,0,0,0,0,7,3,0
Jeppe Okkels,DEN,"FW,DF",24,Utrecht,Eredivisie,1.8,1,0,1,0,0,0,1,0.0,1,3,0,3,0,1,1,0
Adrian Blake,ENG,"FW,MF",18,Utrecht,Eredivisie,0.3,0,0,0,0,0,0,0,0.0,0,0,0,0,0,0,0,0
Nazjir Held,CUW,DF,17,Utrecht,Eredivisie,0.3,2,1,2,0,0,2,3,66.7,1,1,1,0,0,2,1,0
Tim Handwerker,GER,"FW,DF",25,Utrecht,Eredivisie,0.2,3,3,2,1,0,3,3,100.0,0,1,0,1,0,3,0,0
Silas Andersen,DEN,FW,19,Utrecht,Eredivisie,0.1,0,0,0,0,0,0,0,0.0,0,0,0,0,0,0,0,0
Jesse van de Haar,NED,FW,18,Utrecht,Eredivisie,0.1,0,0,0,0,0,0,0,0.0,0,0,0,0,0,0,0,0
Nick Olij,NED,GK,27,Sparta R'dam,Eredivisie,34.0,2,1,2,0,0,2,2,100.0,0,1,0,1,0,2,11,4
Saïd Bakari,COM,DF,28,Sparta R'dam,Eredivisie,31.7,86,63,51,30,5,55,88,62.5,33,43,13,30,28,114,81,1
Tobias Lauritsen,NOR,FW,25,Sparta R'dam,Eredivisie,27.6,12,4,3,5,4,5,15,33.3,10,21,3,18,3,15,38,0
Djevencio van der Kust,SUR,DF,22,Sparta R'dam,Eredivisie,27.8,57,36,36,17,4,23,57,40.4,34,46,18,28,35,92,85,2
Arno Verschueren,BEL,MF,26,Sparta R'dam,Eredivisie,26.3,53,35,23,23,7,14,37,37.8,23,28,4,24,18,71,23,1
Bart Vriends,NED,DF,32,Sparta R'dam,Eredivisie,24.5,25,18,18,6,1,15,23,65.2,8,29,17,12,30,55,124,2
Jonathan de Guzmán,NED,MF,35,Sparta R'dam,Eredivisie,21.4,19,9,9,10,0,10,30,33.3,20,32,13,19,24,43,41,0
Joshua Kitolano,NOR,MF,21,Sparta R'dam,Eredivisie,23.4,33,19,13,17,3,17,40,42.5,23,30,16,14,6,39,29,3
Pelle Clement,NED,"MF,FW",27,Sparta R'dam,Eredivisie,21.1,35,17,16,14,5,18,45,40.0,27,29,12,17,18,53,46,0
Koki Saito,JPN,FW,21,Sparta R'dam,Eredivisie,18.4,16,11,8,4,4,10,21,47.6,11,14,3,11,5,21,20,0
Tijs Velthuis,NED,DF,21,Sparta R'dam,Eredivisie,19.6,26,18,17,8,1,16,20,80.0,4,16,7,9,6,32,103,0
Mike Eerdhuijzen,NED,DF,23,Sparta R'dam,Eredivisie,14.7,17,10,6,9,2,10,15,66.7,5,30,24,6,22,39,82,1
Shunsuke Mito,JPN,"FW,MF",20,Sparta R'dam,Eredivisie,11.3,14,9,6,6,2,8,16,50.0,8,3,2,1,7,21,11,0
Camiel Neghli,NED,FW,21,Sparta R'dam,Eredivisie,15.0,25,14,11,13,1,17,29,58.6,12,16,1,15,9,34,15,0
Metinho,BRA,MF,20,Sparta R'dam,Eredivisie,14.1,51,34,25,22,4,20,38,52.6,18,18,4,14,20,71,29,0
Charles-Andréas Brym,CAN,"FW,MF",24,Sparta R'dam,Eredivisie,15.3,16,12,11,2,3,4,10,40.0,6,6,0,6,4,20,18,1
Django Warmerdam,NED,"DF,FW",27,Sparta R'dam,Eredivisie,9.9,19,13,9,7,3,14,24,58.3,10,10,1,9,12,31,29,0
Rick Meijssen,NED,DF,21,Sparta R'dam,Eredivisie,9.8,10,5,7,2,1,8,11,72.7,3,19,16,3,10,20,52,1
Vito van Crooy,NED,FW,27,Sparta R'dam,Eredivisie,2.9,3,1,3,0,0,3,4,75.0,1,3,1,2,2,5,5,0
Augustin Anello,BEL,"FW,MF",21,Sparta R'dam,Eredivisie,2.5,4,3,2,1,1,2,10,20.0,8,2,0,2,0,4,0,0
Jeremy van Mullem,NED,MF,24,Sparta R'dam,Eredivisie,0.8,2,0,2,0,0,0,1,0.0,1,1,0,1,0,2,2,0
Rayvien Rosario,CUW,"FW,DF",19,Sparta R'dam,Eredivisie,0.5,3,3,2,0,1,1,3,33.3,2,2,1,1,0,3,3,0
Hamza el Dahri,NED,"MF,FW",18,Sparta R'dam,Eredivisie,0.4,2,2,1,1,0,2,3,66.7,1,1,0,1,0,2,0,0
Mehmet Yuksel,NED,"DF,FW",21,Sparta R'dam,Eredivisie,0.1,1,1,0,1,0,0,0,0.0,0,0,0,0,0,1,0,0
Jesse Bal,NED,MF,16,Sparta R'dam,Eredivisie,0.1,0,0,0,0,0,0,0,0.0,0,0,0,0,0,0,0,0
Sergi Rosanas,ESP,DF,22,Sparta R'dam,Eredivisie,0.1,1,1,1,0,0,1,1,100.0,0,0,0,0,0,1,0,0
Jeffrey De Lange,NED,GK,25,Go Ahead Eag,Eredivisie,34.0,0,0,0,0,0,0,0,0.0,0,0,0,0,0,0,7,2
Bas Kuipers,NED,DF,28,Go Ahead Eag,Eredivisie,32.8,47,28,24,17,6,31,55,56.4,24,34,15,19,31,78,90,0
Mats Deijl,NED,DF,26,Go Ahead Eag,Eredivisie,30.9,54,40,21,27,6,31,56,55.4,25,25,7,18,18,72,105,0
Willum Þór Willumsson,ISL,MF,24,Go Ahead Eag,Eredivisie,29.7,32,17,7,18,7,6,18,33.3,12,25,6,19,12,44,44,0
Evert Linthorst,NED,MF,23,Go Ahead Eag,Eredivisie,26.3,39,19,16,18,5,21,41,51.2,20,37,17,20,36,75,79,0
Oliver Edvardsen,NOR,"FW,MF",24,Go Ahead Eag,Eredivisie,26.1,30,12,9,15,6,15,48,31.3,33,26,2,24,18,48,28,0
Joris Kramer,NED,DF,26,Go Ahead Eag,Eredivisie,28.5,37,25,25,12,0,20,29,69.0,9,48,35,13,26,63,174,1
Bobby Adekanye,NED,FW,24,Go Ahead Eag,Eredivisie,20.0,18,11,6,9,3,8,27,29.6,19,18,2,16,4,22,12,0
Victor Edvardsen,SWE,FW,27,Go Ahead Eag,Eredivisie,20.3,5,4,1,2,2,0,8,0.0,8,10,1,9,2,7,12,0
Jamal Amofa,NED,DF,24,Go Ahead Eag,Eredivisie,18.5,31,19,25,6,0,13,20,65.0,7,29,26,3,17,48,51,1
Philippe Rommens,BEL,MF,25,Go Ahead Eag,Eredivisie,18.0,30,17,13,14,3,11,26,42.3,15,10,5,5,25,55,17,0
Gerrit Nauber,GER,DF,31,Go Ahead Eag,Eredivisie,19.5,15,7,6,8,1,10,16,62.5,6,33,27,6,15,30,102,1
Jakob Breum,DEN,FW,19,Go Ahead Eag,Eredivisie,16.1,27,17,13,7,7,16,35,45.7,19,28,3,25,10,37,16,0
Enric Llansana,NED,"MF,DF",22,Go Ahead Eag,Eredivisie,13.6,51,32,21,22,8,28,41,68.3,13,32,8,24,13,64,31,0
Thibo Baeten,BEL,"FW,MF",21,Go Ahead Eag,Eredivisie,10.1,16,7,4,6,6,8,19,42.1,11,14,0,14,4,20,10,0
Xander Blomme,BEL,MF,21,Go Ahead Eag,Eredivisie,7.9,29,15,15,7,7,13,22,59.1,9,20,5,15,18,47,20,0
Sylla Sow,NED,FW,26,Go Ahead Eag,Eredivisie,7.0,11,7,4,2,5,4,4,100.0,0,0,0,0,1,12,2,0
Søren Tengstedt,DEN,"MF,FW",23,Go Ahead Eag,Eredivisie,4.5,9,8,2,5,2,4,9,44.4,5,2,1,1,1,10,3,0
Finn Stokkers,NED,FW,27,Go Ahead Eag,Eredivisie,4.2,6,3,2,3,1,3,6,50.0,3,2,0,2,2,8,3,0
Luca Everink,NED,DF,22,Go Ahead Eag,Eredivisie,3.1,7,2,6,1,0,2,8,25.0,6,4,1,3,9,16,6,0
Dean James,NED,"DF,FW",23,Go Ahead Eag,Eredivisie,1.1,3,2,3,0,0,3,3,100.0,0,3,0,3,2,5,4,0
Pim Saathof,NED,DF,19,Go Ahead Eag,Eredivisie,0.6,5,5,3,2,0,4,5,80.0,1,1,1,0,0,5,5,0
Rashaan Fernandes,NED,"FW,MF",24,Go Ahead Eag,Eredivisie,0.4,0,0,0,0,0,0,1,0.0,1,0,0,0,0,0,0,0
Rodrigo Guth,BRA,DF,22,Fortuna Sittard,Eredivisie,31.3,36,19,22,12,2,24,36,66.7,12,37,24,13,32,68,105,2
Ivo Pinto,POR,DF,33,Fortuna Sittard,Eredivisie,31.2,59,41,39,14,6,35,63,55.6,28,25,6,19,25,84,72,0
Iñigo Córdoba,ESP,"FW,MF",26,Fortuna Sittard,Eredivisie,29.2,92,62,46,31,15,37,85,43.5,48,63,6,57,42,134,24,0
Deroy Duarte,CPV,MF,24,Fortuna Sittard,Eredivisie,26.9,64,35,26,34,4,33,62,53.2,29,30,8,22,27,91,43,0
Mitchell Dijks,NED,DF,30,Fortuna Sittard,Eredivisie,26.0,56,33,34,14,8,38,51,74.5,13,34,5,29,20,76,51,0
Dimitris Siovas,GRE,DF,34,Fortuna Sittard,Eredivisie,25.6,36,17,27,7,2,17,29,58.6,12,28,19,9,49,85,120,0
Kaj Sierhuis,NED,FW,25,Fortuna Sittard,Eredivisie,24.2,11,5,1,4,6,4,18,22.2,14,16,4,12,0,11,11,0
Alen Halilović,CRO,"MF,FW",27,Fortuna Sittard,Eredivisie,23.3,24,13,9,12,3,18,37,48.6,19,20,2,18,9,33,4,0
Loreintz Rosier,FRA,MF,24,Fortuna Sittard,Eredivisie,19.0,57,31,33,19,5,19,36,52.8,17,37,7,30,41,98,50,0
Ivor Pandur,CRO,GK,23,Fortuna Sittard,Eredivisie,16.0,0,0,0,0,0,0,2,0.0,2,0,0,0,0,0,3,0
Justin Lonwijk,SUR,"FW,MF",23,Fortuna Sittard,Eredivisie,11.4,24,15,8,13,3,10,20,50.0,10,8,0,8,13,37,5,0
Tijjani Noslin,NED,FW,24,Fortuna Sittard,Eredivisie,11.3,16,9,4,10,2,9,17,52.9,8,19,2,17,8,24,5,0
Michael Verrips,NED,GK,26,Fortuna Sittard,Eredivisie,12.0,0,0,0,0,0,0,0,0.0,0,0,0,0,0,0,6,0
Oğuzhan Özyakup,TUR,MF,30,Fortuna Sittard,Eredivisie,10.7,25,18,8,14,3,17,30,56.7,13,15,2,13,14,39,6,0
Siemen Voet,BEL,DF,23,Fortuna Sittard,Eredivisie,10.9,24,18,16,5,3,16,24,66.7,8,17,10,7,19,43,48,0
Arianit Ferati,KVX,"MF,DF",25,Fortuna Sittard,Eredivisie,8.2,18,9,6,8,4,8,24,33.3,16,7,0,7,8,26,10,0
Ragnar Oratmangoen,IDN,"MF,FW",25,Fortuna Sittard,Eredivisie,9.8,10,6,5,1,4,7,15,46.7,8,8,1,7,8,18,7,0
Sadik Fofana,TOG,DF,20,Fortuna Sittard,Eredivisie,7.0,24,13,17,7,0,9,22,40.9,13,10,6,4,3,27,17,0
Rémy Vita,MAD,"DF,MF",22,Fortuna Sittard,Eredivisie,6.6,23,17,13,9,1,10,21,47.6,11,11,3,8,11,34,13,0
Kristoffer Peterson,SWE,"MF,FW",28,Fortuna Sittard,Eredivisie,6.5,2,1,0,1,1,0,4,0.0,4,9,0,9,1,3,2,0
Luuk Koopmans,NED,GK,29,Fortuna Sittard,Eredivisie,5.0,1,1,0,1,0,1,1,100.0,0,0,0,0,0,1,0,0
Alessio da Cruz,CPV,"FW,MF",26,Fortuna Sittard,Eredivisie,4.5,3,3,2,1,0,0,1,0.0,1,2,0,2,1,4,1,0
Marko Lazetić,SRB,"FW,DF",19,Fortuna Sittard,Eredivisie,2.0,2,1,1,0,1,1,5,20.0,4,1,0,1,0,2,2,0
Iman Griffith,NED,"FW,MF",21,Fortuna Sittard,Eredivisie,2.7,5,4,1,2,2,1,7,14.3,6,3,1,2,2,7,1,0
Milan Robberechts,BEL,"FW,MF",19,Fortuna Sittard,Eredivisie,2.4,7,3,2,2,3,2,5,40.0,3,2,0,2,2,9,2,0
Paul Gladon,NED,FW,31,Fortuna Sittard,Eredivisie,1.9,1,1,0,1,0,0,1,0.0,1,1,0,1,0,1,3,0
Mouhamed Belkheir,FRA,"FW,MF",24,Fortuna Sittard,Eredivisie,4.7,4,2,1,2,1,3,6,50.0,3,3,0,3,0,4,2,0
Tom Hendriks,NED,GK,21,Fortuna Sittard,Eredivisie,1.0,0,0,0,0,0,0,0,0.0,0,0,0,0,0,0,1,0
Nathan Markelo,CUW,DF,24,Fortuna Sittard,Eredivisie,0.8,2,2,2,0,0,2,3,66.7,1,0,0,0,0,2,2,0
Jayden Braaf,NED,"FW,MF",20,Fortuna Sittard,Eredivisie,0.5,0,0,0,0,0,0,1,0.0,1,1,0,1,0,0,1,0
Daan Bisschops,NED,MF,18,Fortuna Sittard,Eredivisie,0.0,0,0,0,0,0,0,0,0.0,0,0,0,0,0,0,0,0
Sjors Hermsen,NED,"FW,MF",16,Fortuna Sittard,Eredivisie,0.0,0,0,0,0,0,0,0,0.0,0,0,0,0,0,0,0,0
Mats Köhlert,GER,DF,25,Heerenveen,Eredivisie,32.9,46,21,24,17,5,21,49,42.9,28,26,12,14,34,80,72,0
Simon Olsson,SWE,"MF,FW",25,Heerenveen,Eredivisie,30.3,56,32,26,25,5,31,57,54.4,26,39,5,34,24,80,13,0
Sven van Beek,NED,DF,29,Heerenveen,Eredivisie,29.1,56,35,39,13,4,38,46,82.6,8,39,15,24,52,108,136,1
Thom Haye,IDN,MF,28,Heerenveen,Eredivisie,29.0,54,36,21,25,8,24,52,46.2,28,28,6,22,30,84,47,0
Osame Sahraoui,NOR,FW,22,Heerenveen,Eredivisie,27.4,17,12,6,5,6,6,21,28.6,15,10,0,10,10,27,11,2
Paweł Bochniewicz,POL,DF,27,Heerenveen,Eredivisie,25.7,27,14,19,7,1,16,29,55.2,13,42,33,9,25,52,116,1
Pelle van Amersfoort,NED,FW,27,Heerenveen,Eredivisie,23.7,12,6,3,7,2,3,17,17.6,14,11,2,9,7,19,18,0
Luuk Brouwers,NED,MF,25,Heerenveen,Eredivisie,22.5,26,11,8,12,6,13,34,38.2,21,20,5,15,17,43,15,0
Oliver Braude,NOR,DF,19,Heerenveen,Eredivisie,23.5,78,52,44,28,6,39,62,62.9,23,47,10,37,18,96,70,1
Andries Noppert,NED,GK,29,Heerenveen,Eredivisie,22.0,0,0,0,0,0,0,0,0.0,0,0,0,0,0,0,13,5
Ché Nunnely,NED,FW,24,Heerenveen,Eredivisie,19.0,18,10,7,6,5,11,24,45.8,13,21,1,20,7,25,6,0
Patrik Wålemark,SWE,FW,21,Heerenveen,Eredivisie,13.8,25,16,11,9,5,13,28,46.4,15,16,2,14,9,34,13,0
Syb Van Ottele,NED,"DF,MF",21,Heerenveen,Eredivisie,15.9,29,20,19,8,2,16,35,45.7,19,24,11,13,22,51,61,3
Anas Tahiri,BEL,MF,28,Heerenveen,Eredivisie,12.9,7,6,2,5,0,3,10,30.0,7,11,3,8,4,11,19,0
Mickey van der Hart,NED,GK,29,Heerenveen,Eredivisie,12.0,0,0,0,0,0,0,0,0.0,0,0,0,0,1,1,4,0
Hussein Ali,IRQ,"DF,FW",21,Heerenveen,Eredivisie,7.8,11,7,8,2,1,8,14,57.1,6,7,2,5,12,23,25,0
Ion Nicolaescu,MDA,FW,24,Heerenveen,Eredivisie,7.8,3,2,0,1,2,1,2,50.0,1,2,0,2,1,4,3,1
Denzel Hall,NED,DF,22,Heerenveen,Eredivisie,4.6,13,8,11,1,1,3,4,75.0,1,0,0,0,5,18,15,1
Espen van Ee,NED,"MF,FW",20,Heerenveen,Eredivisie,4.6,13,7,4,7,2,4,15,26.7,11,9,2,7,5,18,5,1
Charlie Webster,ENG,"MF,FW",19,Heerenveen,Eredivisie,2.6,7,6,1,6,0,4,10,40.0,6,2,0,2,2,9,2,0
Loizos Loizou,CYP,"FW,MF",20,Heerenveen,Eredivisie,1.5,0,0,0,0,0,0,3,0.0,3,4,0,4,0,0,1,0
Daniel Karlsbakk,NOR,"FW,MF",20,Heerenveen,Eredivisie,3.3,4,3,2,1,1,2,4,50.0,2,3,0,3,1,5,1,0
Melle Witteveen,NED,FW,20,Heerenveen,Eredivisie,0.8,1,0,1,0,0,1,3,33.3,2,1,0,1,1,2,1,0
Djenahro Nunumete,NED,DF,21,Heerenveen,Eredivisie,0.6,1,0,1,0,0,1,1,100.0,0,1,0,1,1,2,1,0
Nathan Tjoe-A-On,IDN,"FW,DF",21,Heerenveen,Eredivisie,0.2,1,1,0,1,0,1,2,50.0,1,1,0,1,0,1,0,0
Sam Kersten,NED,DF,25,Zwolle,Eredivisie,34.0,63,43,45,16,2,26,46,56.5,20,48,29,19,55,118,148,1
Jasper Schendelaar,NED,GK,22,Zwolle,Eredivisie,32.0,1,1,1,0,0,1,4,25.0,3,0,0,0,3,4,17,4
Bram van Polen,NED,DF,37,Zwolle,Eredivisie,29.5,34,24,20,10,4,22,39,56.4,17,39,20,19,27,61,113,1
Thomas Lam,FIN,DF,29,Zwolle,Eredivisie,29.4,34,20,28,5,1,27,40,67.5,13,25,13,12,25,59,151,0
Lennart Thy,GER,"FW,MF",31,Zwolle,Eredivisie,29.7,19,9,9,7,3,7,22,31.8,15,18,3,15,11,30,27,1
Younes Namli,DEN,"FW,MF",29,Zwolle,Eredivisie,28.5,37,18,16,11,10,24,47,51.1,23,26,2,24,11,48,20,1
Anselmo García MacNulty,IRL,DF,20,Zwolle,Eredivisie,27.9,73,42,48,19,6,50,82,61.0,32,31,15,16,36,109,78,0
Dave Van Den Berg,NED,MF,23,Zwolle,Eredivisie,28.4,64,44,32,26,6,34,57,59.6,23,35,3,32,24,88,33,0
Odysseus Velanas,NED,"MF,FW",25,Zwolle,Eredivisie,23.8,24,18,14,3,7,16,43,37.2,27,20,4,16,7,31,35,0
Eliano Reijnders,NED,"FW,DF",22,Zwolle,Eredivisie,23.1,34,24,16,15,3,17,47,36.2,30,22,3,19,22,56,38,0
Zico Buurmeester,NED,MF,21,Zwolle,Eredivisie,15.1,23,15,13,9,1,11,25,44.0,14,15,6,9,25,48,29,0
Anouar El Azzouzi,NED,MF,22,Zwolle,Eredivisie,14.6,45,27,25,18,2,22,43,51.2,21,19,5,14,18,63,59,0
Ferdy Druijf,NED,"FW,MF",25,Zwolle,Eredivisie,10.5,4,3,1,0,3,3,8,37.5,5,6,3,3,0,4,11,0
Filip Krastev,BUL,MF,21,Zwolle,Eredivisie,10.0,31,20,14,15,2,12,27,44.4,15,18,2,16,13,44,12,2
Silvester van der Water,NED,"FW,MF",26,Zwolle,Eredivisie,6.4,15,9,9,4,2,9,16,56.3,7,9,2,7,5,20,8,0
Ryan Thomas,NZL,MF,28,Zwolle,Eredivisie,3.7,11,9,4,5,2,7,11,63.6,4,7,2,5,6,17,16,0
Apostolos Vellios,GRE,"FW,MF",31,Zwolle,Eredivisie,8.1,2,2,0,1,1,1,5,20.0,4,1,0,1,0,2,19,0
Nick Fichtinger,NED,MF,20,Zwolle,Eredivisie,3.9,17,7,7,9,1,7,16,43.8,9,3,2,1,6,23,5,0
Damian van der Haar,NED,DF,20,Zwolle,Eredivisie,3.2,6,3,5,1,0,5,9,55.6,4,6,2,4,6,12,9,0
Bart van Hintum,NED,DF,36,Zwolle,Eredivisie,2.0,6,3,3,2,1,4,6,66.7,2,1,0,1,6,12,8,0
Mike Hauptmeijer,NED,GK,26,Zwolle,Eredivisie,2.0,0,0,0,0,0,0,0,0.0,0,0,0,0,0,0,2,0
Lennart-Marten Czyborra,GER,DF,24,Zwolle,Eredivisie,1.7,1,0,1,0,0,0,3,0.0,3,0,0,0,1,2,3,0
Kaj de Rooij,NED,"FW,MF",22,Zwolle,Eredivisie,1.8,6,3,3,3,0,4,4,100.0,0,2,1,1,0,6,2,0
Dean Huiberts,NED,"MF,DF",23,Zwolle,Eredivisie,1.3,2,2,0,1,1,1,7,14.3,6,2,0,2,4,6,4,0
Nicolás Serrano,ESP,"FW,MF",20,Zwolle,Eredivisie,1.6,5,5,3,2,0,4,5,80.0,1,2,0,2,0,5,1,0
Divaio Jhaïr-Bobson,NED,"DF,FW",19,Zwolle,Eredivisie,0.6,0,0,0,0,0,0,0,0.0,0,1,0,1,0,0,0,0
Anthony Fontana,USA,"MF,FW",23,Zwolle,Eredivisie,0.5,1,0,1,0,0,0,0,0.0,0,0,0,0,1,2,0,0
Mohamed Oukhattou,NED,"FW,MF",18,Zwolle,Eredivisie,0.4,0,0,0,0,0,0,1,0.0,1,2,1,1,0,0,1,0
Teun Gijselhart,NED,MF,18,Zwolle,Eredivisie,0.1,0,0,0,0,0,0,1,0.0,1,0,0,0,0,0,0,0
Thomas Robinet,FRA,"FW,MF",26,Almere City,Eredivisie,31.7,39,18,13,15,11,19,39,48.7,20,31,0,31,11,50,44,0
Peer Koopmeiners,NED,MF,23,Almere City,Eredivisie,30.8,115,66,57,50,8,51,99,51.5,48,59,18,41,41,156,88,1
Damian van Bruggen,NED,DF,27,Almere City,Eredivisie,27.8,29,17,14,15,0,14,24,58.3,10,33,23,10,56,85,118,1
Nordin Bakker,NED,GK,25,Almere City,Eredivisie,28.8,2,2,2,0,0,2,6,33.3,4,0,0,0,0,2,17,1
Stije Resink,NED,MF,20,Almere City,Eredivisie,28.6,74,42,29,31,14,35,69,50.7,34,40,7,33,30,104,60,1
Sherel Floranus,CUW,DF,24,Almere City,Eredivisie,28.0,57,38,35,18,4,31,61,50.8,30,39,13,26,38,95,75,1
Jochem van de Kamp,NED,"DF,MF",19,Almere City,Eredivisie,21.1,50,32,20,21,9,23,51,45.1,28,23,5,18,35,85,31,0
Joey Jacobs,NED,DF,23,Almere City,Eredivisie,21.8,57,37,33,20,4,32,51,62.7,19,19,6,13,26,83,67,0
Rajiv van La Parra,NED,"FW,MF",32,Almere City,Eredivisie,20.0,24,15,10,8,6,6,22,27.3,16,19,3,16,1,25,8,0
Théo Barbet,FRA,DF,22,Almere City,Eredivisie,20.2,22,11,13,6,3,15,27,55.6,12,24,9,15,24,46,82,0
Yoann Cathline,FRA,"DF,FW",21,Almere City,Eredivisie,19.1,28,23,10,9,9,11,22,50.0,11,14,0,14,9,37,8,0
Kornelius Hansen,NOR,FW,22,Almere City,Eredivisie,15.4,11,3,2,5,4,4,20,20.0,16,14,1,13,1,12,7,0
Hamdi Akujobi,NED,"DF,FW",23,Almere City,Eredivisie,17.3,39,29,23,13,3,11,24,45.8,13,35,11,24,16,55,33,0
Alvaro Peña,ESP,MF,31,Almere City,Eredivisie,12.5,19,11,7,9,3,7,23,30.4,16,15,3,12,9,28,4,0
Loïc Mbe Soh,FRA,DF,22,Almere City,Eredivisie,14.0,17,11,10,6,1,12,16,75.0,4,14,12,2,14,31,65,1
Manu Royo,ESP,DF,29,Almere City,Eredivisie,7.4,16,9,7,6,3,8,13,61.5,5,8,0,8,4,20,14,0
Yann Kitala,RDC,FW,25,Almere City,Eredivisie,5.3,4,3,1,2,1,1,3,33.3,2,3,0,3,0,4,3,0
Samuel Şahin-Radlinger,AUT,GK,30,Almere City,Eredivisie,5.2,0,0,0,0,0,0,0,0.0,0,0,0,0,0,0,6,0
Lance Duijvestijn,NED,"MF,FW",24,Almere City,Eredivisie,5.0,5,3,2,1,2,3,16,18.8,13,5,1,4,3,8,2,0
Anthony Limbombe,BEL,FW,29,Almere City,Eredivisie,2.0,1,0,0,1,0,1,2,50.0,1,0,0,0,1,2,0,0
Adi Nalic,BIH,"FW,MF",25,Almere City,Eredivisie,2.4,0,0,0,0,0,0,1,0.0,1,5,0,5,0,0,3,0
Jason Van Duiven,NED,"FW,MF",18,Almere City,Eredivisie,3.2,2,1,0,0,2,1,3,33.3,2,3,0,3,0,2,4,0
Milan Corryn,BEL,"MF,FW",24,Almere City,Eredivisie,1.8,4,3,3,0,1,4,5,80.0,1,4,2,2,3,7,3,0
José Pascual Alba Seva,ESP,FW,23,Almere City,Eredivisie,1.5,2,1,2,0,0,2,3,66.7,1,5,0,5,1,3,2,0
Christopher Mamengi,NED,"DF,FW",22,Almere City,Eredivisie,0.8,4,2,4,0,0,1,2,50.0,1,4,2,2,4,8,6,0
Faiz Mattoir,COM,"FW,MF",23,Almere City,Eredivisie,0.6,1,0,1,0,0,0,0,0.0,0,2,0,2,0,1,1,0
Danny Post,NED,"MF,DF",34,Almere City,Eredivisie,0.4,0,0,0,0,0,0,0,0.0,0,0,0,0,1,1,1,0
Marcelencio Esajas,NED,"MF,FW",21,Almere City,Eredivisie,0.4,1,1,1,0,0,0,0,0.0,0,0,0,0,0,1,0,0
Jeffrey Puriel,NED,FW,20,Almere City,Eredivisie,0.3,0,0,0,0,0,0,0,0.0,0,0,0,0,0,0,0,0
Michael Brouwer,NED,GK,30,Heracles Almelo,Eredivisie,34.0,2,0,2,0,0,2,3,66.7,1,0,0,0,1,3,14,2
Brian De Keersmaecker,BEL,MF,23,Heracles Almelo,Eredivisie,32.8,83,57,56,21,6,42,92,45.7,50,70,26,44,48,131,64,1
Justin Hoogma,NED,DF,25,Heracles Almelo,Eredivisie,28.7,48,30,35,9,4,26,38,68.4,12,44,27,17,17,65,108,0
Emil Hansson,SWE,"FW,MF",25,Heracles Almelo,Eredivisie,20.9,13,6,6,2,5,7,26,26.9,19,5,0,5,1,14,16,0
Bryan Limbombe,BEL,"FW,MF",22,Heracles Almelo,Eredivisie,19.3,17,9,7,2,8,9,21,42.9,12,16,2,14,4,21,9,0
Navajo Bakboord,NED,DF,24,Heracles Almelo,Eredivisie,18.7,43,29,30,13,0,23,49,46.9,26,33,9,24,17,60,49,1
Sven Sonnenberg,GER,DF,24,Heracles Almelo,Eredivisie,18.4,17,11,16,1,0,10,16,62.5,6,20,15,5,23,40,113,3
Anas Ouahim,GER,"MF,FW",25,Heracles Almelo,Eredivisie,13.5,37,21,15,17,5,16,46,34.8,30,10,3,7,11,48,8,0
Mario Engels,GER,"FW,MF",29,Heracles Almelo,Eredivisie,17.8,13,9,8,4,1,3,12,25.0,9,6,0,6,0,13,9,0
Jannes Wieckhoff,GER,DF,22,Heracles Almelo,Eredivisie,15.1,40,26,28,9,3,30,52,57.7,22,23,10,13,12,52,32,1
Fredrik Oppegard,NOR,DF,20,Heracles Almelo,Eredivisie,15.0,39,18,24,13,2,19,26,73.1,7,18,5,13,11,50,39,0
Jizz Hornkamp,NED,FW,25,Heracles Almelo,Eredivisie,14.3,12,7,2,5,5,1,6,16.7,5,13,5,8,3,15,16,0
Ruben Roosken,NED,"DF,FW",23,Heracles Almelo,Eredivisie,14.6,45,28,22,16,7,24,40,60.0,16,19,6,13,28,73,40,0
Ajdin Hrustic,AUS,"MF,FW",27,Heracles Almelo,Eredivisie,12.9,15,10,6,6,3,7,21,33.3,14,9,4,5,5,20,14,1
Mohamed Sankoh,NED,FW,19,Heracles Almelo,Eredivisie,12.1,5,4,0,3,2,0,3,0.0,3,8,0,8,1,6,5,0
Stijn Bultman,NED,DF,18,Heracles Almelo,Eredivisie,12.4,29,22,18,10,1,14,20,70.0,6,24,9,15,17,46,62,0
Jetro Willems,NED,DF,29,Heracles Almelo,Eredivisie,11.9,18,12,14,3,1,11,16,68.8,5,13,6,7,10,28,40,1
Jordy Bruijn,NED,MF,27,Heracles Almelo,Eredivisie,7.6,10,5,7,2,1,4,14,28.6,10,5,1,4,4,14,8,0
Kelvin Leerdam,SUR,DF,33,Heracles Almelo,Eredivisie,8.7,8,6,6,2,0,5,6,83.3,1,19,13,6,7,15,41,1
Thomas Bruns,NED,"MF,FW",31,Heracles Almelo,Eredivisie,12.0,24,16,11,10,3,13,25,52.0,12,14,3,11,6,30,9,0
Sem Scheperman,NED,"MF,DF",21,Heracles Almelo,Eredivisie,7.8,21,14,7,12,2,4,14,28.6,10,10,4,6,8,29,13,1
Marko Vejinović,NED,MF,33,Heracles Almelo,Eredivisie,13.7,39,14,17,20,2,16,33,48.5,17,30,7,23,10,49,38,0
Abdenego Nankishi,GER,FW,21,Heracles Almelo,Eredivisie,3.9,13,8,7,3,3,7,11,63.6,4,4,0,4,1,14,1,0
Sava Cestic,SRB,DF,22,Heracles Almelo,Eredivisie,2.3,3,2,2,1,0,3,4,75.0,1,7,6,1,6,9,11,0
Lasse Wehmeyer,GER,FW,20,Heracles Almelo,Eredivisie,1.9,0,0,0,0,0,0,3,0.0,3,1,1,0,0,0,1,0
Antonio Satriano,ITA,FW,19,Heracles Almelo,Eredivisie,1.8,2,1,0,2,0,0,0,0.0,0,0,0,0,0,2,0,0
Diego van Oorschot,NED,"MF,FW",18,Heracles Almelo,Eredivisie,0.3,1,1,1,0,0,0,0,0.0,0,1,0,1,0,1,1,0
Yassin Oukili,NED,MF,22,RKC Waalwijk,Eredivisie,31.0,95,53,48,36,11,41,67,61.2,26,41,13,28,30,125,70,1
Etienne Vaessen,SUR,GK,28,RKC Waalwijk,Eredivisie,29.4,2,1,2,0,0,2,4,50.0,2,2,0,2,0,2,15,3
Dario Van den Buijs,BEL,DF,27,RKC Waalwijk,Eredivisie,28.9,52,25,33,16,3,23,33,69.7,10,44,30,14,25,77,143,1
Julian Lelieveld,NED,DF,25,RKC Waalwijk,Eredivisie,26.9,79,58,56,14,9,48,92,52.2,44,30,2,28,28,107,78,2
Godfried Roemeratoe,CUW,MF,23,RKC Waalwijk,Eredivisie,25.9,57,31,27,28,2,25,42,59.5,17,39,16,23,29,86,51,1
Aaron Meijers,NED,DF,35,RKC Waalwijk,Eredivisie,25.6,60,29,39,18,3,39,77,50.6,38,32,13,19,30,90,78,0
Shawn Adewoye,BEL,DF,23,RKC Waalwijk,Eredivisie,26.0,36,24,23,9,4,22,33,66.7,11,57,36,21,32,68,169,1
Denilho Cleonise,NED,"FW,MF",21,RKC Waalwijk,Eredivisie,20.0,16,9,4,5,7,8,14,57.1,6,15,0,15,12,28,5,0
Chris Lokesa,BEL,"FW,MF",18,RKC Waalwijk,Eredivisie,22.9,30,13,9,13,8,11,37,29.7,26,14,2,12,13,43,18,0
Michiel Kramer,NED,FW,34,RKC Waalwijk,Eredivisie,20.3,4,2,0,4,0,1,7,14.3,6,7,4,3,0,4,32,0
David Min,NED,FW,24,RKC Waalwijk,Eredivisie,18.4,18,9,0,8,10,9,23,39.1,14,16,3,13,3,21,15,0
Reuven Niemeijer,NED,"MF,FW",28,RKC Waalwijk,Eredivisie,17.8,13,7,4,3,6,5,24,20.8,19,17,1,16,7,20,15,0
Juriën Gaari,CUW,DF,29,RKC Waalwijk,Eredivisie,18.3,41,23,30,9,2,31,48,64.6,17,17,7,10,20,61,72,2
Mats Seuntjens,NED,"FW,MF",31,RKC Waalwijk,Eredivisie,9.0,9,4,2,5,2,3,9,33.3,6,7,1,6,0,9,5,0
Kevin Felida,CUW,MF,23,RKC Waalwijk,Eredivisie,8.8,27,22,18,8,1,7,14,50.0,7,14,3,11,10,37,16,0
Zakaria Bakkali,BEL,"MF,FW",27,RKC Waalwijk,Eredivisie,8.0,16,9,10,3,3,6,12,50.0,6,6,0,6,2,18,2,0
Thierry Lutonda,BEL,DF,22,RKC Waalwijk,Eredivisie,8.0,28,14,22,5,1,12,25,48.0,13,13,2,11,18,46,33,0
Filip Stevanovic,SRB,"FW,MF",20,RKC Waalwijk,Eredivisie,6.9,12,9,6,3,3,6,15,40.0,9,3,0,3,3,15,4,0
Richonell Margaret,NED,"FW,MF",22,RKC Waalwijk,Eredivisie,9.3,19,8,7,6,6,5,11,45.5,6,9,1,8,8,27,5,0
Jeffrey Bruma,NED,DF,31,RKC Waalwijk,Eredivisie,4.4,4,4,3,1,0,2,3,66.7,1,12,8,4,4,8,21,1
Jeroen Houwen,NED,GK,27,RKC Waalwijk,Eredivisie,3.6,0,0,0,0,0,0,0,0.0,0,0,0,0,0,0,3,0
Mark Spenkelink,NED,GK,26,RKC Waalwijk,Eredivisie,1.0,0,0,0,0,0,0,0,0.0,0,0,0,0,0,0,0,1
Ilias Takidine,BEL,"FW,MF",22,RKC Waalwijk,Eredivisie,1.0,1,1,0,1,0,0,1,0.0,1,1,0,1,1,2,0,0
Daouda Weidmann,CIV,"MF,DF",20,RKC Waalwijk,Eredivisie,0.3,0,0,0,0,0,0,0,0.0,0,0,0,0,1,1,1,0
Patrick Vroegh,NED,MF,23,RKC Waalwijk,Eredivisie,0.2,0,0,0,0,0,0,0,0.0,0,0,0,0,0,0,0,0
Stijn van Gassel,NED,GK,26,Excelsior,Eredivisie,34.0,0,0,0,0,0,0,1,0.0,1,1,0,1,0,0,14,4
Siebe Horemans,BEL,DF,25,Excelsior,Eredivisie,33.6,97,58,67,25,5,64,99,64.6,35,52,14,38,45,142,137,2
Julian Baas,NED,MF,21,Excelsior,Eredivisie,32.0,66,42,27,29,10,26,55,47.3,29,43,13,30,49,115,36,0
Arthur Zagre,FRA,DF,21,Excelsior,Eredivisie,25.7,76,48,58,14,4,31,47,66.0,16,39,12,27,43,119,60,3
Casper Widell,SWE,DF,20,Excelsior,Eredivisie,25.8,21,11,15,5,1,11,22,50.0,11,39,25,14,38,59,121,0
Redouan El Yaakoubi,NED,"DF,MF",27,Excelsior,Eredivisie,25.1,45,27,28,13,4,20,43,46.5,23,25,16,9,30,75,113,0
Couhaib Driouech,MAR,"FW,MF",21,Excelsior,Eredivisie,21.3,36,26,23,12,1,16,54,29.6,38,33,4,29,15,51,27,0
Lazaros Lamprou,GRE,"FW,MF",25,Excelsior,Eredivisie,18.0,15,10,8,5,2,4,17,23.5,13,18,0,18,11,26,18,0
Cisse Sandra,BEL,MF,19,Excelsior,Eredivisie,18.6,34,17,17,11,6,10,24,41.7,14,16,6,10,15,49,22,0
Troy Parrott,IRL,FW,21,Excelsior,Eredivisie,17.6,6,5,2,3,1,4,7,57.1,3,12,3,9,1,7,16,0
Kenzo Goudmijn,NED,"MF,FW",21,Excelsior,Eredivisie,17.4,33,18,16,11,6,17,31,54.8,14,21,4,17,12,45,16,0
Sven Nieuwpoort,NED,DF,30,Excelsior,Eredivisie,16.3,14,9,7,7,0,8,11,72.7,3,14,8,6,9,23,52,1
Derensili Fernandes,NED,"FW,MF",22,Excelsior,Eredivisie,14.3,20,11,8,7,5,9,25,36.0,16,16,0,16,9,29,16,0
Lance Duijvestijn,NED,"MF,FW",24,Excelsior,Eredivisie,12.2,20,14,10,9,1,9,18,50.0,9,16,3,13,10,30,10,0
Noah Naujoks,NED,"MF,FW",21,Excelsior,Eredivisie,11.7,24,14,9,12,3,8,20,40.0,12,19,3,16,9,33,19,0
Nikolas Agrafiotis,NED,FW,23,Excelsior,Eredivisie,8.4,12,7,2,6,4,4,8,50.0,4,3,1,2,1,13,13,0
Mimeirhel Benita,NED,DF,19,Excelsior,Eredivisie,10.5,26,17,19,4,3,14,20,70.0,6,15,5,10,17,43,33,1
Serano Seymor,NED,DF,21,Excelsior,Eredivisie,4.1,3,3,3,0,0,2,4,50.0,2,5,0,5,5,8,20,1
Kian Fitz-Jim,NED,MF,20,Excelsior,Eredivisie,4.4,12,9,2,7,3,3,13,23.1,10,3,0,3,5,17,6,0
Kik Pierie,NED,DF,23,Excelsior,Eredivisie,3.3,7,5,5,2,0,2,8,25.0,6,3,1,2,8,15,29,0
Siem de Moes,NED,DF,19,Excelsior,Eredivisie,3.2,9,5,7,2,0,7,13,53.8,6,8,5,3,8,17,13,0
Richie Omorowa,SWE,FW,19,Excelsior,Eredivisie,5.7,7,4,3,3,1,1,3,33.3,2,5,0,5,0,7,9,0
Oscar Uddenäs,SWE,"FW,MF",20,Excelsior,Eredivisie,5.2,9,6,4,4,1,6,12,50.0,6,2,0,2,2,11,12,0
Ian Smeulers,NED,DF,23,Excelsior,Eredivisie,2.0,5,5,4,1,0,4,5,80.0,1,4,1,3,7,12,7,0
Lennard Hartjes,NED,MF,20,Excelsior,Eredivisie,1.0,3,2,1,2,0,1,3,33.3,2,3,0,3,1,4,0,0
Mike van Duinen,NED,"FW,MF",31,Excelsior,Eredivisie,1.0,2,0,0,1,1,2,4,50.0,2,2,0,2,1,3,0,0
Jeremy Udenhout,NED,DF,20,Excelsior,Eredivisie,0.1,0,0,0,0,0,0,0,0.0,0,1,0,1,0,0,0,0
Damon Mirani,NED,"MF,DF",27,Volendam,Eredivisie,32.0,48,29,34,13,1,25,56,44.6,31,57,32,25,41,89,146,2
Mio Backhaus,GER,GK,19,Volendam,Eredivisie,32.0,2,2,2,0,0,2,3,66.7,1,1,0,1,1,3,21,1
Benaissa Benamar,MAR,DF,26,Volendam,Eredivisie,25.2,30,19,21,9,0,18,39,46.2,21,39,31,8,24,54,93,1
Milan de Haan,NED,MF,19,Volendam,Eredivisie,24.1,48,31,22,17,9,23,61,37.7,38,31,8,23,11,59,43,1
Bilal Ould-Chikh,MAR,"FW,MF",26,Volendam,Eredivisie,23.6,16,9,11,3,2,8,22,36.4,14,10,0,10,5,21,8,0
Josh Flint,ENG,DF,22,Volendam,Eredivisie,24.8,52,27,36,14,2,33,49,67.3,16,36,22,14,32,84,136,2
George Cox,ENG,"DF,MF",25,Volendam,Eredivisie,21.3,44,29,30,9,5,29,65,44.6,36,27,12,15,36,80,66,1
Calvin Twigt,NED,MF,20,Volendam,Eredivisie,22.7,44,24,21,16,7,18,43,41.9,25,31,6,25,19,63,48,0
Brian Plat,NED,DF,23,Volendam,Eredivisie,22.0,91,59,59,30,2,50,83,60.2,33,35,11,24,28,119,68,0
Oskar Buur,DEN,DF,25,Volendam,Eredivisie,18.3,42,28,24,12,6,25,42,59.5,17,14,6,8,13,55,52,0
Robert Mühren,NED,FW,34,Volendam,Eredivisie,16.5,15,8,9,3,3,9,14,64.3,5,5,0,5,7,22,12,0
Zach Booth,USA,"MF,FW",19,Volendam,Eredivisie,17.3,16,8,5,8,3,2,16,12.5,14,11,1,10,8,24,16,0
Darius Johnson,GRN,"FW,MF",23,Volendam,Eredivisie,13.3,11,8,4,5,2,5,18,27.8,13,13,1,12,11,22,13,0
Deron Payne,NED,DF,20,Volendam,Eredivisie,9.6,33,20,19,13,1,16,31,51.6,15,18,3,15,16,49,34,0
Robin Maulun,FRA,MF,26,Volendam,Eredivisie,7.8,5,2,1,3,1,2,7,28.6,5,3,0,3,4,9,7,0
Luke Le Roux,RSA,MF,23,Volendam,Eredivisie,9.7,30,18,20,8,2,9,25,36.0,16,13,4,9,9,39,19,0
Lequincio Zeefuik,NED,"FW,MF",18,Volendam,Eredivisie,8.6,7,4,1,5,1,1,2,50.0,1,11,0,11,1,8,9,0
Garang Kuol,AUS,"FW,MF",18,Volendam,Eredivisie,7.6,12,5,7,2,3,8,16,50.0,8,10,0,10,2,14,1,1
Xavier Mbuyamba,NED,DF,21,Volendam,Eredivisie,6.7,13,4,7,5,1,8,11,72.7,3,14,5,9,14,27,37,1
Vivaldo Semedo,POR,FW,18,Volendam,Eredivisie,7.0,2,1,0,2,0,0,3,0.0,3,5,2,3,0,2,4,0
Achraf Douiri,NED,"DF,FW",23,Volendam,Eredivisie,3.8,14,10,7,5,2,9,14,64.3,5,2,0,2,6,20,5,0
Bram van Driel,NED,MF,18,Volendam,Eredivisie,2.6,8,7,4,3,1,5,9,55.6,4,3,1,2,3,11,6,0
Derry Murkin,ENG,DF,24,Volendam,Eredivisie,2.0,5,2,3,2,0,2,6,33.3,4,2,0,2,4,9,7,0
Daryl van Mieghem,NED,MF,33,Volendam,Eredivisie,1.7,2,0,0,2,0,0,1,0.0,1,0,0,0,0,2,0,0
Joey Antonioli,NED,MF,19,Volendam,Eredivisie,1.1,1,1,1,0,0,1,3,33.3,2,2,0,2,0,1,0,0
Imran Nazih,MAR,MF,17,Volendam,Eredivisie,1.0,3,0,1,1,1,2,3,66.7,1,2,0,2,0,3,0,0
Barry Lauwers,NED,GK,23,Volendam,Eredivisie,1.0,0,0,0,0,0,0,0,0.0,0,0,0,0,0,0,2,1
Kayne van Oevelen,NED,GK,19,Volendam,Eredivisie,1.0,0,0,0,0,0,0,0,0.0,0,0,0,0,0,0,1,0
Axel Guessand,FRA,DF,18,Volendam,Eredivisie,0.5,1,1,1,0,0,1,1,100.0,0,1,0,1,1,2,1,0
Quincy Hoeve,BOE,"FW,MF",20,Volendam,Eredivisie,3.9,2,1,1,0,1,1,4,25.0,3,4,1,3,0,2,2,0
Safouane Karim,NED,"MF,FW",19,Volendam,Eredivisie,2.6,9,5,2,4,3,4,6,66.7,2,7,2,5,3,12,1,0
Ibrahim El Kadiri,NED,FW,21,Volendam,Eredivisie,0.9,2,2,1,0,1,2,4,50.0,2,2,0,2,0,2,1,0
Ezechiel Fiemawhle,NED,"MF,FW",19,Volendam,Eredivisie,0.4,1,0,1,0,0,1,1,100.0,0,1,0,1,0,1,1,0
Flip Klomp,NED,MF,21,Volendam,Eredivisie,0.4,3,3,2,1,0,2,3,66.7,1,0,0,0,0,3,1,0
Francisco Reyes,DOM,DF,17,Volendam,Eredivisie,0.2,1,0,1,0,0,1,3,33.3,2,0,0,0,0,1,1,0
Myron Mau-Asam,NED,MF,19,Volendam,Eredivisie,0.1,0,0,0,0,0,0,1,0.0,1,0,0,0,0,0,0,0
Caner Demircioglu,NED,FW,21,Volendam,Eredivisie,0.1,0,0,0,0,0,0,0,0.0,0,0,0,0,0,0,0,0
Eloy Room,CUW,GK,34,Vitesse,Eredivisie,34.0,0,0,0,0,0,0,2,0.0,2,0,0,0,2,2,8,2
Ramon Hendriks,NED,DF,22,Vitesse,Eredivisie,29.4,48,27,28,18,2,21,28,75.0,7,50,36,14,36,84,106,2
Kacper Kozłowski,POL,"MF,FW",19,Vitesse,Eredivisie,22.7,39,24,15,12,12,9,25,36.0,16,19,3,16,13,52,17,0
Melle Meulensteen,NED,MF,24,Vitesse,Eredivisie,22.7,35,17,15,13,7,17,34,50.0,17,38,14,24,31,66,44,1
Carlens Arcus,HAI,DF,27,Vitesse,Eredivisie,24.2,60,39,37,16,7,33,62,53.2,29,22,3,19,47,107,60,1
Nicolas Isimat-Mirin,FRA,DF,31,Vitesse,Eredivisie,24.2,40,25,28,12,0,16,30,53.3,14,45,21,24,27,67,116,0
Marco van Ginkel,NED,"MF,FW",30,Vitesse,Eredivisie,21.8,13,8,5,3,5,4,11,36.4,7,15,5,10,4,17,38,0
Alois Oroz,CRO,DF,22,Vitesse,Eredivisie,21.0,34,22,27,5,2,14,40,35.0,26,32,12,20,30,64,78,1
Michael Pinto,LUX,DF,30,Vitesse,Eredivisie,20.2,37,27,16,18,3,21,34,61.8,13,18,6,12,12,49,38,1
Amine Boutrah,FRA,FW,22,Vitesse,Eredivisie,20.2,16,11,7,6,3,6,25,24.0,19,24,3,21,15,31,7,1
Mathijs Tielemans,NED,MF,21,Vitesse,Eredivisie,18.6,27,21,13,11,3,10,24,41.7,14,23,3,20,27,54,10,0
Million Manhoef,NED,FW,21,Vitesse,Eredivisie,16.2,27,12,17,8,2,8,16,50.0,8,9,0,9,2,29,5,0
Paxten Aaronson,USA,MF,19,Vitesse,Eredivisie,13.9,44,25,22,16,6,18,30,60.0,12,21,3,18,9,53,9,0
Gyan de Regt,NED,"FW,MF",20,Vitesse,Eredivisie,13.2,18,14,7,7,4,11,31,35.5,20,12,1,11,6,24,6,1
Enzo Cornelisse,NED,"DF,MF",20,Vitesse,Eredivisie,17.1,30,16,15,14,1,19,39,48.7,20,15,4,11,17,47,36,1
Anis Hadj Moussa,ALG,FW,21,Vitesse,Eredivisie,9.4,6,3,2,3,1,2,17,11.8,15,9,0,9,2,8,5,0
Saïd Hamulic,BIH,FW,22,Vitesse,Eredivisie,7.9,5,4,1,1,3,2,5,40.0,3,2,0,2,2,7,3,0
Mexx Meerdink,NED,FW,20,Vitesse,Eredivisie,6.6,3,1,2,0,1,1,2,50.0,1,4,1,3,0,3,7,0
Toni Domgjoni,KVX,MF,24,Vitesse,Eredivisie,7.5,15,8,4,7,4,6,14,42.9,8,9,3,6,8,23,15,0
Thomas Buitink,NED,FW,23,Vitesse,Eredivisie,5.3,5,1,1,2,2,2,10,20.0,8,1,0,1,0,5,2,0
Giovanni van Zwam,NED,DF,19,Vitesse,Eredivisie,5.5,16,12,10,5,1,13,22,59.1,9,11,4,7,6,22,14,0
Joel Voelkerling Persson,SWE,FW,20,Vitesse,Eredivisie,3.3,1,1,0,1,0,0,1,0.0,1,0,0,0,0,1,2,0
Andy Visser,NED,FW,19,Vitesse,Eredivisie,2.7,0,0,0,0,0,0,1,0.0,1,1,0,1,0,0,1,0
Fodé Fofana,NED,FW,20,Vitesse,Eredivisie,1.1,0,0,0,0,0,0,0,0.0,0,0,0,0,0,0,0,0
Maximilian Wittek,GER,DF,27,Vitesse,Eredivisie,1.0,2,1,1,1,0,2,4,50.0,2,0,0,0,1,3,2,0
Davy Pröpper,NED,MF,31,Vitesse,Eredivisie,0.7,1,0,0,1,0,0,0,0.0,0,2,2,0,0,1,0,0
Miliano Jonathans,NED,"MF,FW",19,Vitesse,Eredivisie,1.0,1,1,1,0,0,1,3,33.3,2,2,0,2,1,2,0,0
Mats Egbring,NED,DF,16,Vitesse,Eredivisie,0.7,3,1,1,1,1,2,8,25.0,6,2,0,2,4,7,4,0
Adrian Mazilu,ROU,FW,17,Vitesse,Eredivisie,0.3,1,0,0,1,0,0,0,0.0,0,0,0,0,0,1,0,0
Jordi Altena,NED,MF,19,Vitesse,Eredivisie,0.1,0,0,0,0,0,0,0,0.0,0,0,0,0,0,0,0,0
Daan Huisman,NED,FW,21,Vitesse,Eredivisie,0.0,0,0,0,0,0,0,0,0.0,0,0,0,0,0,0,0,0
Federico Valverde,URU,MF,25,Real Madrid,La Liga,32.3,47,34,22,13,12,24,42,57.1,18,39,2,37,43,90,40,0
Antonio Rüdiger,GER,DF,30,Real Madrid,La Liga,30.1,26,15,18,4,4,16,20,80.0,4,27,20,7,11,37,89,0
Rodrygo,BRA,FW,22,Real Madrid,La Liga,26.4,16,15,2,9,5,5,19,26.3,14,14,0,14,8,24,6,0
Jude Bellingham,ENG,MF,20,Real Madrid,La Liga,25.7,42,34,14,18,10,12,36,33.3,24,55,5,50,21,63,17,0
Dani Carvajal,ESP,DF,31,Real Madrid,La Liga,24.1,47,32,28,15,4,23,42,54.8,19,28,9,19,22,69,54,4
Toni Kroos,GER,MF,33,Real Madrid,La Liga,23.6,53,34,19,25,9,24,59,40.7,35,22,4,18,17,70,11,1
Aurélien Tchouaméni,FRA,"MF,DF",23,Real Madrid,La Liga,22.1,38,23,19,17,2,9,18,50.0,9,21,13,8,28,66,52,1
Vinicius Júnior,BRA,FW,23,Real Madrid,La Liga,20.7,18,13,5,5,8,3,12,25.0,9,13,0,13,1,19,3,2
Andriy Lunin,UKR,GK,24,Real Madrid,La Liga,21.0,0,0,0,0,0,0,1,0.0,1,0,0,0,0,0,15,1
Eduardo Camavinga,FRA,"MF,DF",20,Real Madrid,La Liga,20.2,76,47,39,29,8,23,39,59.0,16,36,8,28,29,105,29,1
Ferland Mendy,FRA,DF,28,Real Madrid,La Liga,19.1,15,10,12,2,1,11,14,78.6,3,12,2,10,13,28,26,1
Nacho,ESP,DF,33,Real Madrid,La Liga,19.4,18,10,9,7,2,6,13,46.2,7,23,13,10,18,36,56,0
Luka Modrić,CRO,MF,37,Real Madrid,La Liga,18.8,22,15,10,6,6,9,25,36.0,16,13,4,9,21,43,9,0
Brahim Díaz,MAR,"FW,MF",23,Real Madrid,La Liga,17.2,29,19,4,16,9,6,13,46.2,7,16,1,15,5,34,2,0
Joselu,ESP,FW,33,Real Madrid,La Liga,18.7,6,3,1,4,1,0,7,0.0,7,11,1,10,6,12,11,0
Fran Garcia,ESP,DF,23,Real Madrid,La Liga,15.5,25,17,11,12,2,13,31,41.9,18,16,3,13,19,44,28,1
Lucas Vázquez,ESP,DF,32,Real Madrid,La Liga,15.8,37,25,22,14,1,18,25,72.0,7,27,5,22,12,49,36,0
David Alaba,AUT,DF,31,Real Madrid,La Liga,12.8,13,9,7,5,1,4,8,50.0,4,10,7,3,15,28,34,0
Kepa Arrizabalaga,ESP,GK,28,Real Madrid,La Liga,13.3,0,0,0,0,0,0,1,0.0,1,0,0,0,0,0,4,0
Eder Militão,BRA,DF,25,Real Madrid,La Liga,5.5,7,3,4,3,0,6,9,66.7,3,4,3,1,4,11,19,1
Dani Ceballos,ESP,"MF,FW",26,Real Madrid,La Liga,6.6,10,5,4,5,1,5,14,35.7,9,9,2,7,0,10,4,1
Arda Güler,TUR,"FW,MF",18,Real Madrid,La Liga,4.2,6,4,1,3,2,5,8,62.5,3,0,0,0,2,8,5,0
Thibaut Courtois,BEL,GK,31,Real Madrid,La Liga,3.7,1,0,1,0,0,0,0,0.0,0,0,0,0,0,1,0,0
Nicolás Paz,ARG,"MF,FW",18,Real Madrid,La Liga,0.3,0,0,0,0,0,0,0,0.0,0,2,0,2,1,1,0,0
Gonzalo García,ESP,"FW,MF",19,Real Madrid,La Liga,0.2,0,0,0,0,0,0,1,0.0,1,1,1,0,0,0,1,0
Mario Martín,ESP,MF,19,Real Madrid,La Liga,0.2,5,1,0,2,3,3,4,75.0,1,2,1,1,0,5,0,0
Alvaro Muñoz,URU,FW,19,Real Madrid,La Liga,0.0,0,0,0,0,0,0,0,0.0,0,0,0,0,0,0,1,0
Ilkay Gündoğan,GER,MF,32,Barcelona,La Liga,33.3,32,22,14,16,2,12,39,30.8,27,19,4,15,21,53,18,1
Jules Koundé,FRA,DF,24,Barcelona,La Liga,32.2,37,23,22,10,5,28,51,54.9,23,32,12,20,25,62,83,5
Robert Lewandowski,POL,FW,34,Barcelona,La Liga,30.6,8,5,0,6,2,4,12,33.3,8,13,4,9,9,17,18,0
João Cancelo,POR,DF,29,Barcelona,La Liga,27.8,64,44,35,21,8,38,58,65.5,20,35,6,29,29,93,59,1
Marc-André ter Stegen,GER,GK,31,Barcelona,La Liga,28.0,0,0,0,0,0,0,0,0.0,0,0,0,0,0,0,3,3
Andreas Christensen,DEN,"DF,MF",27,Barcelona,La Liga,22.0,23,14,7,14,2,16,28,57.1,12,23,10,13,21,44,41,0
Lamine Yamal,ESP,FW,16,Barcelona,La Liga,24.5,61,37,32,15,14,18,48,37.5,30,32,0,32,19,80,11,0
Ronald Araújo,URU,DF,24,Barcelona,La Liga,22.2,27,22,11,15,1,12,17,70.6,5,20,11,9,12,39,66,2
Frenkie de Jong,NED,MF,26,Barcelona,La Liga,18.2,43,26,14,23,6,8,19,42.1,11,18,8,10,14,57,28,1
Pau Cubarsí,ESP,DF,16,Barcelona,La Liga,17.3,22,14,18,3,1,13,18,72.2,5,20,16,4,12,34,65,0
João Félix,POR,FW,23,Barcelona,La Liga,17.1,22,16,9,7,6,8,22,36.4,14,14,1,13,10,32,11,0
Raphinha,BRA,"FW,MF",26,Barcelona,La Liga,15.2,14,8,6,6,2,4,18,22.2,14,17,1,16,13,27,11,0
Pedri,ESP,"MF,FW",20,Barcelona,La Liga,16.4,33,24,16,13,4,8,27,29.6,19,27,3,24,14,47,10,0
Alejandro Balde,ESP,DF,19,Barcelona,La Liga,15.3,20,11,11,6,3,7,11,63.6,4,14,1,13,5,25,21,1
Fermin López,ESP,"MF,FW",20,Barcelona,La Liga,16.1,41,21,15,18,8,14,40,35.0,26,14,1,13,4,45,9,0
Iñigo Martínez,ESP,DF,32,Barcelona,La Liga,14.4,10,7,9,1,0,6,8,75.0,2,13,10,3,11,21,50,0
Ferrán Torres,ESP,FW,23,Barcelona,La Liga,13.5,9,6,1,6,2,5,16,31.3,11,7,1,6,5,14,6,0
Oriol Romeu,ESP,MF,31,Barcelona,La Liga,10.4,34,20,17,14,3,13,24,54.2,11,12,2,10,10,44,18,0
Gavi,ESP,"MF,FW",18,Barcelona,La Liga,10.5,39,21,20,14,5,18,36,50.0,18,19,3,16,8,47,16,1
Iñaki Peña,ESP,GK,24,Barcelona,La Liga,10.0,0,0,0,0,0,0,1,0.0,1,0,0,0,0,0,5,1
Sergi Roberto,ESP,"MF,DF",31,Barcelona,La Liga,9.6,15,10,4,10,1,3,11,27.3,8,7,2,5,8,23,7,1
Héctor Fort,ESP,DF,16,Barcelona,La Liga,3.5,6,5,5,1,0,4,10,40.0,6,0,0,0,2,8,4,0
Marcos Alonso,ESP,DF,32,Barcelona,La Liga,2.8,5,3,2,3,0,3,4,75.0,1,2,0,2,4,9,6,0
Vitor Roque,BRA,FW,18,Barcelona,La Liga,3.6,3,2,2,0,1,0,2,0.0,2,3,0,3,0,3,5,0
Marc Guiu,ESP,"FW,MF",17,Barcelona,La Liga,0.8,1,0,0,1,0,0,0,0.0,0,0,0,0,0,1,0,0
Abdessamad Ezzalzouli,MAR,"FW,MF",21,Barcelona,La Liga,0.8,1,1,0,0,1,0,1,0.0,1,1,0,1,0,1,0,0
Eric García,ESP,DF,22,Barcelona,La Liga,0.6,0,0,0,0,0,0,0,0.0,0,1,1,0,0,0,0,0
Ansu Fati,ESP,"MF,FW",20,Barcelona,La Liga,0.6,0,0,0,0,0,0,1,0.0,1,0,0,0,0,0,0,0
Marc Casado,ESP,MF,19,Barcelona,La Liga,0.2,1,1,1,0,0,1,1,100.0,0,0,0,0,1,2,2,0
Paulo Gazzaniga,ARG,GK,31,Girona,La Liga,38.0,2,2,2,0,0,2,4,50.0,2,0,0,0,0,2,12,1
Aleix García,ESP,MF,26,Girona,La Liga,35.5,49,28,17,26,6,28,54,51.9,26,45,17,28,36,85,53,3
Miguel Gutiérrez,ESP,DF,22,Girona,La Liga,33.7,29,18,11,14,4,13,35,37.1,22,27,11,16,22,51,66,2
Sávio,BRA,"FW,MF",19,Girona,La Liga,33.1,42,25,14,22,6,16,28,57.1,12,34,0,34,18,60,11,1
Daley Blind,NED,DF,33,Girona,La Liga,33.0,47,21,33,13,1,29,47,61.7,18,37,19,18,21,68,113,0
Iván Martín,ESP,MF,24,Girona,La Liga,30.3,44,25,22,15,7,22,57,38.6,35,25,3,22,21,65,14,0
Artem Dovbyk,UKR,FW,26,Girona,La Liga,28.7,4,3,2,1,1,0,2,0.0,2,8,1,7,0,4,17,0
Eric García,ESP,DF,22,Girona,La Liga,29.3,55,37,34,18,3,34,49,69.4,15,36,18,18,30,85,79,2
Yangel Herrera,VEN,MF,25,Girona,La Liga,23.4,64,37,28,30,6,30,56,53.6,26,30,8,22,24,88,45,1
Viktor Tsyhankov,UKR,"MF,FW",25,Girona,La Liga,22.8,29,20,11,13,5,14,26,53.8,12,18,1,17,12,41,24,0
David López,ESP,DF,33,Girona,La Liga,21.8,33,20,21,12,0,17,22,77.3,5,28,19,9,20,53,63,4
Yan Couto,BRA,"DF,FW",21,Girona,La Liga,24.9,45,34,25,14,6,20,40,50.0,20,14,2,12,10,55,31,1
Arnau Martinez,ESP,DF,20,Girona,La Liga,13.8,25,16,17,6,2,15,32,46.9,17,15,5,10,10,35,41,3
Portu,ESP,"MF,FW",31,Girona,La Liga,13.2,18,13,3,10,5,3,18,16.7,15,9,1,8,4,22,6,0
Juanpe,ESP,DF,32,Girona,La Liga,8.3,11,8,8,3,0,9,10,90.0,1,17,11,6,7,18,50,1
Cristhian Stuani,URU,FW,36,Girona,La Liga,8.9,14,11,4,6,4,4,7,57.1,3,9,2,7,5,19,13,0
Pablo Torre,ESP,"MF,FW",20,Girona,La Liga,7.8,5,2,0,5,0,4,10,40.0,6,10,2,8,4,9,6,1
Valery Fernández,ESP,"MF,FW",23,Girona,La Liga,5.6,11,9,4,7,0,6,8,75.0,2,6,1,5,1,12,4,0
Jhon Solis,COL,MF,18,Girona,La Liga,4.3,10,8,4,5,1,4,12,33.3,8,8,3,5,8,18,7,1
Antal Yaakobishvili,HUN,DF,19,Girona,La Liga,0.7,2,1,1,1,0,1,1,100.0,0,0,0,0,3,5,3,0
Jastin García,ESP,FW,19,Girona,La Liga,0.4,1,0,0,0,1,0,0,0.0,0,0,0,0,0,1,1,0
Toni Villa,ESP,FW,28,Girona,La Liga,0.1,0,0,0,0,0,0,0,0.0,0,0,0,0,0,0,0,0
Ibrahima Kebe,MLI,MF,22,Girona,La Liga,0.1,1,1,0,1,0,0,0,0.0,0,1,0,1,1,2,0,0
Bernardo Espinosa,COL,DF,34,Girona,La Liga,0.0,1,1,1,0,0,1,1,100.0,0,0,0,0,0,1,2,0
Silvi Clúa,ESP,MF,18,Girona,La Liga,0.0,2,0,2,0,0,2,2,100.0,0,1,0,1,0,2,0,0
Jan Oblak,SVN,GK,30,Atlético Madrid,La Liga,38.0,0,0,0,0,0,0,0,0.0,0,0,0,0,0,0,10,0
Koke,ESP,MF,31,Atlético Madrid,La Liga,27.7,66,44,27,32,7,36,79,45.6,43,37,12,25,16,82,34,1
Antoine Griezmann,FRA,"FW,MF",32,Atlético Madrid,La Liga,29.4,33,19,14,14,5,15,41,36.6,26,34,3,31,10,43,23,1
Axel Witsel,BEL,DF,34,Atlético Madrid,La Liga,30.9,35,21,23,12,0,17,24,70.8,7,40,21,19,16,51,119,0
Marcos Llorente,ESP,"MF,DF",28,Atlético Madrid,La Liga,28.5,40,23,18,17,5,16,44,36.4,28,36,11,25,14,54,35,0
Mario Hermoso,ESP,DF,28,Atlético Madrid,La Liga,28.4,46,25,29,13,4,28,51,54.9,23,27,9,18,30,76,93,0
Samuel Lino,BRA,"DF,MF",23,Atlético Madrid,La Liga,23.1,61,34,32,17,12,35,70,50.0,35,37,1,36,14,75,27,0
Rodrigo De Paul,ARG,MF,29,Atlético Madrid,La Liga,23.1,31,21,11,14,6,15,38,39.5,23,28,1,27,11,42,15,2
Alvaro Morata,ESP,FW,30,Atlético Madrid,La Liga,21.2,16,10,4,7,5,3,5,60.0,2,18,3,15,1,17,26,0
Nahuel Molina,ARG,DF,25,Atlético Madrid,La Liga,20.6,38,22,16,18,4,26,54,48.1,28,19,3,16,9,47,36,1
Stefan Savić,MNE,DF,32,Atlético Madrid,La Liga,18.1,27,19,16,7,4,15,30,50.0,15,29,15,14,27,54,61,1
Pablo Barrios,ESP,MF,20,Atlético Madrid,La Liga,17.3,45,25,15,29,1,19,40,47.5,21,20,3,17,28,73,24,2
Rodrigo Riquelme,ESP,"DF,MF",23,Atlético Madrid,La Liga,17.0,30,19,18,4,8,18,46,39.1,28,19,0,19,9,39,20,0
Angel Correa,ARG,"FW,MF",28,Atlético Madrid,La Liga,17.0,22,15,3,11,8,5,17,29.4,12,13,0,13,2,24,6,0
César Azpilicueta,ESP,DF,33,Atlético Madrid,La Liga,15.8,25,14,15,9,1,12,19,63.2,7,25,6,19,16,41,46,0
Saúl Ñíguez,ESP,MF,28,Atlético Madrid,La Liga,15.3,64,39,29,29,6,30,49,61.2,19,36,9,27,14,78,56,0
José María Giménez,URU,DF,28,Atlético Madrid,La Liga,14.7,18,10,10,7,1,5,16,31.3,11,16,12,4,10,28,95,0
Memphis,NED,FW,29,Atlético Madrid,La Liga,9.9,5,2,0,3,2,3,6,50.0,3,2,0,2,1,6,0,0
Reinildo Mandava,MOZ,DF,29,Atlético Madrid,La Liga,8.1,30,22,16,11,3,19,22,86.4,3,10,2,8,15,45,21,0
Gabriel Paulista,BRA,DF,32,Atlético Madrid,La Liga,4.5,7,5,4,3,0,3,4,75.0,1,5,3,2,4,11,27,0
Yannick Carrasco,BEL,DF,29,Atlético Madrid,La Liga,2.5,4,4,3,1,0,2,7,28.6,5,2,0,2,1,5,6,0
Thomas Lemar,FRA,MF,27,Atlético Madrid,La Liga,1.8,3,1,2,1,0,1,2,50.0,1,0,0,0,0,3,0,0
Arthur Vermeeren,BEL,MF,18,Atlético Madrid,La Liga,1.8,1,0,0,1,0,0,1,0.0,1,5,0,5,6,7,2,0
Cağlar Söyüncü,TUR,DF,27,Atlético Madrid,La Liga,1.3,1,1,1,0,0,0,0,0.0,0,1,0,1,1,2,7,0
Javi Galán,ESP,DF,28,Atlético Madrid,La Liga,1.0,5,4,2,2,1,4,5,80.0,1,1,0,1,1,6,3,0
Salim El Jebari,MAR,MF,19,Atlético Madrid,La Liga,0.1,1,0,0,1,0,0,0,0.0,0,0,0,0,0,1,1,0
Abdellah Raihani,MAR,FW,19,Atlético Madrid,La Liga,0.1,0,0,0,0,0,0,1,0.0,1,0,0,0,0,0,0,0
Unai Simón,ESP,GK,26,Athletic Club,La Liga,35.4,2,1,1,1,0,2,3,66.7,1,0,0,0,1,3,9,0
Iñaki Williams,GHA,FW,29,Athletic Club,La Liga,31.6,24,17,6,8,10,13,34,38.2,21,42,8,34,14,38,29,0
Daniel Vivian,ESP,DF,24,Athletic Club,La Liga,32.0,42,28,29,11,2,28,45,62.2,17,49,25,24,31,73,104,0
Aitor Paredes,ESP,DF,23,Athletic Club,La Liga,30.0,20,11,11,9,0,7,14,50.0,7,23,11,12,33,53,104,0
Gorka Guruzeta,ESP,FW,26,Athletic Club,La Liga,24.6,34,23,6,25,3,9,30,30.0,21,36,2,34,17,51,23,0
Nico Williams,ESP,FW,21,Athletic Club,La Liga,25.1,31,12,9,15,7,13,36,36.1,23,18,2,16,3,34,4,1
Oscar de Marcos,ESP,DF,34,Athletic Club,La Liga,25.1,56,39,26,24,6,42,71,59.2,29,28,6,22,15,71,44,0
Iñigo Ruiz de Galarreta,ESP,MF,29,Athletic Club,La Liga,23.2,49,31,15,26,8,24,49,49.0,25,18,5,13,12,61,17,0
Oihan Sancet,ESP,MF,23,Athletic Club,La Liga,21.9,19,11,3,10,6,8,21,38.1,13,5,1,4,10,29,5,0
Iñigo Lekue,ESP,DF,30,Athletic Club,La Liga,22.2,40,22,25,10,5,27,53,50.9,26,24,6,18,15,55,50,0
Yuri Berchiche,ESP,DF,33,Athletic Club,La Liga,21.4,33,25,13,14,6,19,33,57.6,14,28,9,19,20,53,62,0
Mikel Vesga,ESP,MF,30,Athletic Club,La Liga,17.0,40,20,11,23,6,19,49,38.8,30,19,7,12,32,72,35,1
Beñat Prados,ESP,"MF,DF",22,Athletic Club,La Liga,16.1,45,28,11,23,11,23,42,54.8,19,32,5,27,23,68,27,0
Alex Berenguer,ESP,FW,28,Athletic Club,La Liga,17.7,23,14,9,9,5,7,24,29.2,17,23,0,23,5,28,13,0
Yeray Álvarez,ESP,DF,28,Athletic Club,La Liga,12.8,18,9,15,3,0,12,19,63.2,7,8,5,3,11,29,34,1
Ander Herrera,ESP,MF,33,Athletic Club,La Liga,11.4,44,32,11,26,7,20,36,55.6,16,16,6,10,15,59,18,1
Unai Gómez,ESP,MF,20,Athletic Club,La Liga,9.7,12,10,2,6,4,5,10,50.0,5,13,2,11,2,14,9,0
Dani García,ESP,MF,33,Athletic Club,La Liga,8.3,17,11,4,7,6,12,24,50.0,12,9,3,6,8,25,11,0
Iker Muniain,ESP,"MF,FW",30,Athletic Club,La Liga,6.6,5,1,2,3,0,1,3,33.3,2,4,1,3,0,5,0,0
Imanol,ESP,DF,23,Athletic Club,La Liga,5.8,7,5,1,5,1,5,18,27.8,13,6,0,6,7,14,15,0
Asier Villalibre,ESP,FW,25,Athletic Club,La Liga,5.7,2,1,0,0,2,2,2,100.0,0,2,1,1,0,2,6,0
Adu Ares,ESP,FW,21,Athletic Club,La Liga,2.9,8,4,4,2,2,2,3,66.7,1,1,0,1,1,9,0,0
Julen Agirrezabala,ESP,GK,22,Athletic Club,La Liga,2.6,0,0,0,0,0,0,0,0.0,0,0,0,0,0,0,0,0
Raúl García,ESP,"FW,MF",37,Athletic Club,La Liga,4.7,9,6,2,4,3,4,9,44.4,5,10,1,9,3,12,9,0
Mikel Jauregizar,ESP,MF,19,Athletic Club,La Liga,1.7,0,0,0,0,0,0,6,0.0,6,5,0,5,0,0,2,0
Peru Nolaskoain,ESP,"DF,MF",24,Athletic Club,La Liga,0.1,1,1,1,0,0,1,1,100.0,0,0,0,0,0,1,1,0
Aingeru Olabarrieta,ESP,FW,17,Athletic Club,La Liga,0.1,0,0,0,0,0,0,0,0.0,0,0,0,0,0,0,0,0
Alex Remiro,ESP,GK,28,Real Sociedad,La Liga,36.4,0,0,0,0,0,0,0,0.0,0,0,0,0,0,0,24,2
Martín Zubimendi,ESP,MF,24,Real Sociedad,La Liga,29.5,49,27,18,29,2,23,42,54.8,19,33,9,24,37,86,54,0
Igor Zubeldia,ESP,DF,26,Real Sociedad,La Liga,28.0,32,25,20,10,2,19,26,73.1,7,28,19,9,32,64,97,3
Robin Le Normand,ESP,DF,26,Real Sociedad,La Liga,27.4,31,22,16,15,0,17,30,56.7,13,26,15,11,28,59,96,1
Mikel Merino,ESP,MF,27,Real Sociedad,La Liga,27.6,77,43,25,34,18,22,48,45.8,26,36,11,25,16,93,55,3
Brais Méndez,ESP,"MF,FW",26,Real Sociedad,La Liga,26.8,42,28,13,20,9,15,43,34.9,28,23,4,19,12,54,21,0
Hamari Traoré,MLI,DF,31,Real Sociedad,La Liga,25.5,44,19,24,17,3,25,43,58.1,18,27,8,19,24,68,59,2
Takefusa Kubo,JPN,"FW,MF",22,Real Sociedad,La Liga,23.9,26,17,15,6,5,9,23,39.1,14,21,2,19,11,37,8,1
Mikel Oyarzabal,ESP,"FW,MF",26,Real Sociedad,La Liga,24.0,23,18,7,11,5,7,21,33.3,14,25,4,21,4,27,12,0
Ander Barrenetxea,ESP,"FW,MF",21,Real Sociedad,La Liga,15.9,32,21,7,16,9,10,26,38.5,16,18,1,17,6,38,5,0
Beñat Turrientes,ESP,MF,21,Real Sociedad,La Liga,18.7,31,17,6,20,5,13,30,43.3,17,19,8,11,6,37,17,0
Jon Pacheco,ESP,DF,22,Real Sociedad,La Liga,17.0,25,15,21,4,0,14,22,63.6,8,17,6,11,10,35,53,1
Arsen Zakharyan,RUS,"MF,FW",20,Real Sociedad,La Liga,13.6,22,15,8,11,3,9,22,40.9,13,16,0,16,4,26,10,0
Kieran Tierney,SCO,DF,26,Real Sociedad,La Liga,13.8,37,24,16,18,3,18,27,66.7,9,22,8,14,10,47,45,0
Javi Galán,ESP,DF,28,Real Sociedad,La Liga,11.9,38,22,15,19,4,15,30,50.0,15,24,1,23,14,52,17,1
Umar Sadiq,NGA,FW,26,Real Sociedad,La Liga,12.0,15,10,2,8,5,4,8,50.0,4,9,0,9,0,15,10,0
Aihen Muñoz,ESP,DF,25,Real Sociedad,La Liga,12.5,36,21,20,10,6,24,35,68.6,11,16,8,8,9,45,33,0
André Silva,POR,FW,27,Real Sociedad,La Liga,8.1,2,2,0,0,2,0,4,0.0,4,3,0,3,1,3,3,0
Sheraldo Becker,SUR,"FW,MF",28,Real Sociedad,La Liga,8.6,2,2,0,2,0,0,1,0.0,1,3,0,3,1,3,0,0
Aritz Elustondo,ESP,DF,29,Real Sociedad,La Liga,9.0,11,7,5,4,2,6,14,42.9,8,12,10,2,7,18,26,0
Alvaro Odriozola,ESP,DF,27,Real Sociedad,La Liga,4.4,9,7,7,1,1,5,5,100.0,0,2,1,1,8,17,7,0
Jon Aramburu,VEN,DF,21,Real Sociedad,La Liga,6.0,24,15,12,10,2,15,25,60.0,10,8,3,5,7,31,17,0
Carlos Fernández,ESP,FW,27,Real Sociedad,La Liga,4.5,11,7,3,6,2,0,2,0.0,2,4,0,4,0,11,5,0
Olasagasti,ESP,MF,22,Real Sociedad,La Liga,4.0,16,13,4,7,5,5,8,62.5,3,2,0,2,3,19,5,1
Urko González,ESP,MF,22,Real Sociedad,La Liga,1.7,4,1,0,3,1,2,2,100.0,0,1,0,1,1,5,6,0
Mohamed Ali Cho,FRA,"FW,MF",19,Real Sociedad,La Liga,2.8,4,3,3,1,0,2,7,28.6,5,6,0,6,1,5,1,0
Unai Marrero,ESP,GK,21,Real Sociedad,La Liga,1.6,0,0,0,0,0,0,0,0.0,0,0,0,0,0,0,0,0
Jon Magunacelaya,ESP,"FW,MF",23,Real Sociedad,La Liga,1.3,5,3,2,3,0,4,8,50.0,4,3,0,3,0,5,2,0
Alex Sola,ESP,"DF,MF",24,Real Sociedad,La Liga,0.3,0,0,0,0,0,0,0,0.0,0,0,0,0,1,1,2,0
Alberto Dadie,ESP,MF,21,Real Sociedad,La Liga,0.3,2,1,2,0,0,0,0,0.0,0,1,0,1,0,2,0,0
Jon Martin,ESP,DF,17,Real Sociedad,La Liga,0.3,0,0,0,0,0,0,0,0.0,0,0,0,0,0,0,3,0
Germán Pezzella,ARG,DF,32,Betis,La Liga,30.7,34,24,24,10,0,23,38,60.5,15,31,18,13,31,65,150,0
Ayoze Pérez,ESP,FW,30,Betis,La Liga,25.5,59,32,16,33,10,21,49,42.9,28,42,4,38,22,81,18,0
Rui Silva,POR,GK,29,Betis,La Liga,27.5,0,0,0,0,0,0,3,0.0,3,0,0,0,1,1,13,1
Isco,ESP,MF,31,Betis,La Liga,25.8,41,27,15,21,5,14,38,36.8,24,19,1,18,10,51,7,0
Willian José,BRA,FW,31,Betis,La Liga,21.9,7,3,1,2,4,2,5,40.0,3,8,2,6,2,9,15,0
Chadi Riad,MAR,DF,20,Betis,La Liga,24.0,35,24,17,18,0,17,27,63.0,10,23,14,9,23,58,108,0
Marc Roca,ESP,MF,26,Betis,La Liga,22.0,52,36,17,29,6,30,53,56.6,23,29,6,23,17,69,23,1
Guido Rodríguez,ARG,MF,29,Betis,La Liga,20.5,53,30,21,24,8,34,55,61.8,21,27,6,21,29,82,44,0
Juan Miranda,ESP,DF,23,Betis,La Liga,20.6,38,24,21,13,4,17,31,54.8,14,31,6,25,19,57,62,0
Héctor Bellerín,ESP,DF,28,Betis,La Liga,19.0,34,22,14,16,4,20,53,37.7,33,13,5,8,22,56,40,1
Abner,BRA,DF,23,Betis,La Liga,15.6,25,19,15,9,1,17,34,50.0,17,23,5,18,15,40,62,0
Johnny Cardoso,USA,MF,21,Betis,La Liga,14.8,48,29,19,24,5,22,33,66.7,11,20,5,15,32,80,31,0
Pablo Fornals,ESP,"FW,MF",27,Betis,La Liga,12.8,24,16,8,11,5,12,22,54.5,10,14,0,14,22,46,10,2
Assane Diao,ESP,FW,17,Betis,La Liga,11.6,20,12,5,9,6,6,17,35.3,11,22,4,18,7,27,7,0
Sokratis Papastathopoulos,GRE,DF,35,Betis,La Liga,12.6,21,14,16,5,0,13,17,76.5,4,15,9,6,6,27,60,0
Youssouf Sabaly,SEN,DF,30,Betis,La Liga,11.6,16,11,12,3,1,8,12,66.7,4,6,3,3,11,27,27,0
Aitor Ruibal,ESP,"DF,FW",27,Betis,La Liga,11.3,46,27,28,13,5,32,59,54.2,27,12,1,11,14,60,33,1
Nabil Fekir,FRA,"MF,FW",30,Betis,La Liga,11.7,15,10,5,7,3,5,10,50.0,5,9,0,9,7,22,3,0
Rodri,ESP,"FW,MF",23,Betis,La Liga,11.7,17,10,6,7,4,8,21,38.1,13,11,0,11,8,25,2,0
Claudio Bravo,CHI,GK,40,Betis,La Liga,7.0,0,0,0,0,0,0,1,0.0,1,0,0,0,0,0,2,0
Abdessamad Ezzalzouli,MAR,FW,21,Betis,La Liga,9.6,17,14,7,5,5,4,14,28.6,10,10,0,10,5,22,5,0
Luiz Henrique,BRA,FW,22,Betis,La Liga,6.8,15,11,4,10,1,9,14,64.3,5,11,0,11,5,20,8,0
Sergi Altimira,ESP,MF,21,Betis,La Liga,6.3,15,8,8,6,1,11,23,47.8,12,12,1,11,9,24,10,0
William Carvalho,POR,MF,31,Betis,La Liga,7.6,20,12,11,7,2,10,16,62.5,6,8,1,7,8,28,9,1
Andrés Guardado,MEX,MF,36,Betis,La Liga,5.0,17,12,5,9,3,7,14,50.0,7,4,2,2,6,23,5,0
Borja Iglesias,ESP,FW,30,Betis,La Liga,4.5,0,0,0,0,0,0,3,0.0,3,0,0,0,2,2,2,0
Luiz Felipe,ITA,DF,26,Betis,La Liga,4.0,7,3,5,2,0,4,5,80.0,1,10,4,6,4,11,16,0
Ezequiel Ávila,ARG,FW,29,Betis,La Liga,3.3,2,1,0,2,0,1,3,33.3,2,2,0,2,1,3,4,0
Fran Vieites,ESP,GK,24,Betis,La Liga,3.5,1,0,1,0,0,1,1,100.0,0,0,0,0,0,1,2,1
Marc Bartra,ESP,DF,32,Betis,La Liga,2.5,4,3,3,1,0,4,5,80.0,1,3,1,2,3,7,10,0
Cédric Bakambu,COD,FW,32,Betis,La Liga,2.2,1,0,0,1,0,0,0,0.0,0,2,0,2,0,1,0,0
Ricardo Visus,ESP,DF,22,Betis,La Liga,1.8,2,2,1,1,0,2,2,100.0,0,2,2,0,2,4,9,1
Juan Cruz,ESP,FW,23,Betis,La Liga,0.8,0,0,0,0,0,0,1,0.0,1,0,0,0,0,0,0,0
Pablo Busto,ESP,DF,17,Betis,La Liga,0.5,1,1,0,0,1,1,1,100.0,0,0,0,0,1,2,3,0
Paul Akouokou,CIV,MF,25,Betis,La Liga,0.3,5,3,0,2,3,3,3,100.0,0,3,1,2,1,6,1,0
Filip Jørgensen,DEN,GK,21,Villarreal,La Liga,36.0,3,1,3,0,0,3,4,75.0,1,0,0,0,2,5,10,3
Alex Baena,ESP,"MF,FW",22,Villarreal,La Liga,28.7,34,21,10,16,8,20,47,42.6,27,23,2,21,13,47,17,1
Alexander Sørloth,NOR,FW,27,Villarreal,La Liga,27.7,6,3,1,2,3,2,6,33.3,4,9,4,5,0,6,26,0
Daniel Parejo,ESP,MF,34,Villarreal,La Liga,28.7,43,30,16,21,6,20,46,43.5,26,25,9,16,21,64,29,3
Gerard Moreno,ESP,FW,31,Villarreal,La Liga,24.6,25,12,10,7,8,11,25,44.0,14,24,7,17,9,34,24,0
Raúl Albiol,ESP,DF,37,Villarreal,La Liga,22.6,25,14,15,9,1,18,27,66.7,9,31,24,7,16,41,102,0
Jorge Cuenca,ESP,DF,23,Villarreal,La Liga,21.8,42,29,26,10,6,19,30,63.3,11,26,15,11,21,63,114,0
Santi Comesaña,ESP,MF,26,Villarreal,La Liga,18.4,44,26,15,21,8,19,38,50.0,19,33,9,24,22,66,27,1
Ilias Akhomach,MAR,"MF,FW",19,Villarreal,La Liga,16.8,36,21,11,16,9,10,20,50.0,10,10,2,8,13,49,13,0
Alberto Moreno,ESP,DF,31,Villarreal,La Liga,16.5,31,21,19,10,2,10,30,33.3,20,12,2,10,24,55,33,0
Kiko Femenía,ESP,DF,32,Villarreal,La Liga,17.6,35,25,19,13,3,19,34,55.9,15,21,6,15,31,66,45,0
Etienne Capoue,FRA,MF,35,Villarreal,La Liga,16.2,32,18,17,12,3,15,22,68.2,7,20,4,16,22,54,24,1
Yerson Mosquera,COL,DF,22,Villarreal,La Liga,13.7,27,13,18,7,2,12,15,80.0,3,12,2,10,17,44,65,0
Alfonso Pedraza,ESP,DF,27,Villarreal,La Liga,12.4,25,9,18,5,2,9,17,52.9,8,16,7,9,13,38,19,0
Aïssa Mandi,ALG,DF,31,Villarreal,La Liga,12.4,13,8,8,5,0,7,14,50.0,7,10,7,3,8,21,41,0
Juan Foyth,ARG,DF,25,Villarreal,La Liga,11.8,26,15,18,8,0,12,27,44.4,15,17,4,13,12,38,44,0
Francis Coquelin,FRA,MF,32,Villarreal,La Liga,10.1,20,12,8,10,2,5,13,38.5,8,14,4,10,16,36,15,0
Adrià Altimira,ESP,"DF,MF",22,Villarreal,La Liga,8.6,16,7,9,6,1,9,24,37.5,15,18,5,13,5,21,18,0
Gonçalo Guedes,POR,"FW,MF",26,Villarreal,La Liga,10.6,6,4,1,2,3,2,7,28.6,5,8,0,8,2,8,3,0
Eric Bailly,CIV,DF,29,Villarreal,La Liga,9.3,5,3,4,1,0,2,2,100.0,0,8,8,0,9,14,38,2
José Luis Morales,ESP,"FW,MF",36,Villarreal,La Liga,11.6,5,3,1,4,0,3,13,23.1,10,9,1,8,7,12,4,0
Yeremi Pino,ESP,"MF,FW",20,Villarreal,La Liga,5.3,25,18,12,10,3,9,18,50.0,9,11,1,10,5,30,5,0
Ramón Terrats,ESP,"MF,DF",22,Villarreal,La Liga,8.7,17,13,8,8,1,7,15,46.7,8,11,1,10,3,20,9,0
Bertrand Traoré,BFA,MF,27,Villarreal,La Liga,6.3,5,4,2,1,2,1,4,25.0,3,6,0,6,1,6,2,0
Matteo Gabbia,ITA,DF,23,Villarreal,La Liga,5.3,10,6,4,6,0,5,8,62.5,3,5,2,3,8,18,36,1
Manu Trigueros,ESP,MF,31,Villarreal,La Liga,3.4,7,5,6,1,0,4,10,40.0,6,1,1,0,3,10,9,0
Ben Brereton,CHI,"FW,MF",24,Villarreal,La Liga,3.0,2,2,1,0,1,0,2,0.0,2,0,0,0,0,2,0,0
Carlos Romero,ESP,DF,21,Villarreal,La Liga,2.9,11,5,8,1,2,7,12,58.3,5,3,0,3,1,12,11,0
Pepe Reina,ESP,GK,40,Villarreal,La Liga,2.0,0,0,0,0,0,0,0,0.0,0,0,0,0,0,0,1,0
Denis Suárez,ESP,"MF,FW",29,Villarreal,La Liga,1.5,0,0,0,0,0,0,2,0.0,2,2,2,0,0,0,4,0
Stefan Lekovic,SRB,DF,19,Villarreal,La Liga,0.3,0,0,0,0,0,0,0,0.0,0,1,1,0,0,0,1,0
Pascu,ESP,FW,20,Villarreal,La Liga,0.2,0,0,0,0,0,0,0,0.0,0,0,0,0,0,0,0,0
José Luis García Vayá,ESP,MF,24,Valencia,La Liga,36.7,78,53,36,36,6,37,71,52.1,34,41,10,31,49,127,71,0
Giorgi Mamardashvili,GEO,GK,22,Valencia,La Liga,36.5,4,3,4,0,0,4,4,100.0,0,1,0,1,2,6,22,2
Hugo Duro,ESP,FW,23,Valencia,La Liga,33.1,16,8,5,8,3,9,29,31.0,20,24,5,19,5,21,27,0
Cristhian Mosquera,COL,DF,19,Valencia,La Liga,34.2,57,34,36,18,3,25,39,64.1,14,42,23,19,36,93,137,2
Diego López,ESP,"MF,FW",21,Valencia,La Liga,29.5,37,25,14,16,7,13,56,23.2,43,23,1,22,20,57,12,0
Javier Guerra,ESP,MF,20,Valencia,La Liga,27.8,54,24,25,22,7,22,58,37.9,36,27,7,20,18,72,44,0
Francisco Perez,ESP,"MF,FW",20,Valencia,La Liga,22.8,30,17,10,14,6,15,44,34.1,29,19,0,19,14,44,5,0
Thierry Correia,POR,DF,24,Valencia,La Liga,23.9,63,35,39,20,4,28,49,57.1,21,39,16,23,33,96,61,0
José Luis Gayà,ESP,DF,28,Valencia,La Liga,19.9,71,36,44,23,4,43,67,64.2,24,18,3,15,11,82,42,0
Dimitri Foulquier,FRA,"DF,MF",30,Valencia,La Liga,20.5,39,22,22,13,4,18,26,69.2,8,10,1,9,16,55,49,1
Cenk Özkacar,TUR,DF,22,Valencia,La Liga,17.8,26,15,22,4,0,15,23,65.2,8,18,7,11,18,44,84,1
Gabriel Paulista,BRA,DF,32,Valencia,La Liga,15.5,10,7,8,2,0,6,11,54.5,5,15,7,8,24,34,78,0
Sergi Canós,ESP,"MF,FW",26,Valencia,La Liga,13.7,23,13,7,11,5,10,24,41.7,14,14,2,12,11,34,9,0
Hugo Guillamón,ESP,MF,23,Valencia,La Liga,14.6,24,15,7,14,3,11,17,64.7,6,8,3,5,12,36,25,2
Mouctar Diakhaby,GUI,"DF,MF",26,Valencia,La Liga,11.9,18,11,9,9,0,11,13,84.6,2,17,7,10,11,29,62,0
Domingos André Ribeiro Almeida,POR,"FW,MF",23,Valencia,La Liga,10.7,25,15,9,12,4,9,19,47.4,10,13,1,12,6,31,5,0
Roman Yaremchuk,UKR,FW,27,Valencia,La Liga,10.3,5,2,1,2,2,3,6,50.0,3,4,0,4,1,6,9,0
Yarek Hernandis,ESP,DF,18,Valencia,La Liga,8.2,22,12,14,5,3,13,19,68.4,6,15,8,7,15,37,50,1
Selim Amallah,MAR,"FW,MF",26,Valencia,La Liga,6.7,17,12,7,7,3,3,9,33.3,6,13,0,13,11,28,6,0
Jesus Vazquez,ESP,"DF,MF",20,Valencia,La Liga,8.0,24,12,13,8,3,10,16,62.5,6,17,4,13,3,27,24,0
Peter González,DOM,"MF,FW",21,Valencia,La Liga,7.2,5,3,3,1,1,1,10,10.0,9,11,0,11,7,12,10,0
Alberto Marí,ESP,FW,22,Valencia,La Liga,3.1,4,2,0,1,3,1,1,100.0,0,3,0,3,0,4,5,0
Pablo Gozalbez,ESP,"MF,FW",22,Valencia,La Liga,1.1,1,0,0,0,1,1,6,16.7,5,0,0,0,1,2,2,0
Jaume Doménech,ESP,GK,32,Valencia,La Liga,0.9,0,0,0,0,0,0,0,0.0,0,0,0,0,0,0,0,0
Hugo González,ESP,"MF,FW",20,Valencia,La Liga,1.0,2,1,0,2,0,0,0,0.0,0,0,0,0,0,2,0,0
Cristian,ESP,GK,25,Valencia,La Liga,0.6,0,0,0,0,0,0,0,0.0,0,0,0,0,0,0,0,0
Mario Dominguez,ESP,FW,19,Valencia,La Liga,0.3,0,0,0,0,0,0,0,0.0,0,0,0,0,0,0,0,0
Ruben Lendinez,ESP,DF,20,Valencia,La Liga,0.1,2,2,0,2,0,1,1,100.0,0,0,0,0,0,2,1,0
César Tárrega,ESP,DF,21,Valencia,La Liga,0.1,0,0,0,0,0,0,0,0.0,0,0,0,0,0,0,2,0
Antonio Sivera,ESP,GK,26,Alavés,La Liga,34.0,0,0,0,0,0,0,1,0.0,1,0,0,0,0,0,17,1
Jon Guridi,ESP,MF,28,Alavés,La Liga,29.8,42,24,10,27,5,12,45,26.7,33,23,3,20,22,64,22,0
Ander Guevara,ESP,MF,26,Alavés,La Liga,32.6,59,32,28,25,6,31,64,48.4,33,34,12,22,13,72,46,1
Andoni Gorosabel,ESP,DF,26,Alavés,La Liga,31.7,62,42,40,17,5,38,75,50.7,37,24,8,16,28,90,69,0
Luis Rioja,ESP,"FW,MF",29,Alavés,La Liga,27.8,27,19,10,12,5,14,43,32.6,29,28,1,27,16,43,28,0
Antonio Blanco,ESP,MF,23,Alavés,La Liga,27.0,61,36,29,27,5,31,86,36.0,55,25,2,23,35,96,30,0
Rafa Marín,ESP,DF,21,Alavés,La Liga,27.1,32,20,23,9,0,14,27,51.9,13,34,21,13,33,65,129,2
Abdel Abqar,MAR,DF,24,Alavés,La Liga,25.7,35,19,28,5,2,21,35,60.0,14,31,26,5,23,58,115,0
Javi López,ESP,DF,21,Alavés,La Liga,26.5,23,12,11,9,3,15,26,57.7,11,25,9,16,10,33,77,1
Samuel Omorodion,ESP,FW,19,Alavés,La Liga,21.3,6,3,1,4,1,0,4,0.0,4,11,2,9,1,7,14,0
Rubén Duarte,ESP,DF,27,Alavés,La Liga,20.9,39,20,21,16,2,21,31,67.7,10,21,6,15,23,62,69,0
Kiké,ESP,"FW,MF",33,Alavés,La Liga,15.8,8,4,2,3,3,4,9,44.4,5,16,5,11,1,9,12,0
Alex Sola,ESP,"FW,MF",24,Alavés,La Liga,14.0,27,15,11,9,7,14,26,53.8,12,18,2,16,11,38,16,0
Carlos Vicente,ESP,FW,24,Alavés,La Liga,12.4,16,6,7,7,2,10,25,40.0,15,4,0,4,4,20,9,0
Nahuel Tenaglia,ARG,DF,27,Alavés,La Liga,12.7,29,19,22,4,3,16,28,57.1,12,14,8,6,12,41,59,0
Aleksandar Sedlar,SRB,DF,31,Alavés,La Liga,10.5,14,10,10,4,0,10,16,62.5,6,8,4,4,13,27,43,0
Carlos Benavídez,URU,MF,25,Alavés,La Liga,12.6,56,35,19,26,11,19,34,55.9,15,13,5,8,19,75,31,0
Ianis Hagi,ROU,"MF,FW",24,Alavés,La Liga,8.9,17,12,2,14,1,5,12,41.7,7,8,0,8,5,22,4,0
Abderrahman Rebbach,ALG,"FW,MF",24,Alavés,La Liga,8.0,9,5,4,2,3,5,15,33.3,10,10,1,9,3,12,7,0
Giuliano Simeone,ARG,FW,20,Alavés,La Liga,7.0,7,5,2,3,2,5,17,29.4,12,10,0,10,5,12,3,0
Jesús Owono,EQG,GK,22,Alavés,La Liga,4.0,0,0,0,0,0,0,0,0.0,0,0,0,0,0,0,3,0
Xeber,ESP,"FW,MF",26,Alavés,La Liga,3.4,5,5,3,2,0,3,7,42.9,4,2,1,1,1,6,2,0
Joaquín Panichelli,ARG,"FW,MF",20,Alavés,La Liga,2.5,3,3,1,1,1,1,2,50.0,1,1,0,1,1,4,4,0
Miguel,ESP,"FW,MF",23,Alavés,La Liga,0.7,0,0,0,0,0,0,0,0.0,0,2,0,2,0,0,0,0
Mamadou Sylla,SEN,"FW,MF",29,Alavés,La Liga,0.2,0,0,0,0,0,0,0,0.0,0,1,1,0,0,0,1,0
Jon Karrikaburu,ESP,"MF,FW",20,Alavés,La Liga,0.2,0,0,0,0,0,0,0,0.0,0,0,0,0,0,0,0,0
Eneko Ortiz,ESP,DF,20,Alavés,La Liga,0.2,0,0,0,0,0,0,0,0.0,0,0,0,0,0,0,0,0
Tomás Mendes,ESP,MF,18,Alavés,La Liga,0.1,0,0,0,0,0,0,0,0.0,0,0,0,0,0,0,0,0
Unai Ropero,ESP,MF,21,Alavés,La Liga,0.1,0,0,0,0,0,0,0,0.0,0,0,0,0,0,0,0,0
Victor Parada,ESP,"FW,MF",21,Alavés,La Liga,0.0,1,1,0,1,0,1,1,100.0,0,0,0,0,0,1,0,0
Sergio Herrera,ESP,GK,30,Osasuna,La Liga,31.9,2,2,2,0,0,2,3,66.7,1,0,0,0,0,2,22,3
Jesús Areso,ESP,DF,24,Osasuna,La Liga,29.6,45,24,25,13,7,31,38,81.6,7,36,15,21,18,63,58,0
Ante Budimir,CRO,FW,32,Osasuna,La Liga,27.1,21,15,2,11,8,5,14,35.7,9,19,5,14,5,26,18,0
Catena,ESP,DF,28,Osasuna,La Liga,28.2,33,18,26,6,1,19,35,54.3,16,24,15,9,15,48,119,3
David García,ESP,DF,29,Osasuna,La Liga,25.9,29,18,19,9,1,16,26,61.5,10,40,19,21,18,47,115,2
Aimar Oroz,ESP,MF,21,Osasuna,La Liga,26.0,43,26,18,20,5,13,37,35.1,24,27,2,25,16,59,11,0
Rubén Peña,ESP,"DF,FW",32,Osasuna,La Liga,23.2,47,25,22,18,7,20,49,40.8,29,37,8,29,30,77,39,3
Moi Gómez,ESP,"MF,FW",29,Osasuna,La Liga,22.3,30,19,7,19,4,9,24,37.5,15,15,1,14,11,41,22,0
Johan Mojica,COL,DF,30,Osasuna,La Liga,22.7,30,22,11,15,4,16,25,64.0,9,15,2,13,21,51,40,2
Jon Moncayola,ESP,MF,25,Osasuna,La Liga,20.0,27,18,14,10,3,17,42,40.5,25,31,5,26,15,42,21,0
Lucas Torró,ESP,MF,29,Osasuna,La Liga,19.9,25,15,11,8,6,11,28,39.3,17,10,2,8,33,58,37,0
Iker Muñoz,ESP,MF,20,Osasuna,La Liga,20.6,32,18,13,17,2,15,31,48.4,16,16,5,11,11,43,50,0
Rubén García,ESP,"FW,MF",30,Osasuna,La Liga,17.2,32,18,8,17,7,13,33,39.4,20,23,3,20,12,44,23,0
Juan Cruz Armada,ESP,DF,31,Osasuna,La Liga,18.5,27,15,16,10,1,17,25,68.0,8,14,7,7,12,39,39,1
Jorge Herrando,ESP,DF,22,Osasuna,La Liga,18.3,29,19,23,6,0,12,19,63.2,7,20,11,9,15,44,69,1
Raúl,ESP,FW,22,Osasuna,La Liga,15.1,10,4,4,2,4,2,10,20.0,8,9,1,8,5,15,11,0
Pablo Ibáñez,ESP,MF,24,Osasuna,La Liga,12.8,18,9,5,7,6,5,21,23.8,16,26,3,23,9,27,17,0
Ezequiel Ávila,ARG,"FW,MF",29,Osasuna,La Liga,9.6,3,2,1,1,1,3,11,27.3,8,14,0,14,4,7,8,0
José Arnaiz,ESP,"FW,MF",28,Osasuna,La Liga,10.3,14,8,6,4,4,6,21,28.6,15,11,2,9,3,17,2,0
Unai García,ESP,DF,31,Osasuna,La Liga,6.2,12,9,9,2,1,5,10,50.0,5,7,1,6,8,20,18,0
Aitor Fernández,ESP,GK,32,Osasuna,La Liga,6.1,0,0,0,0,0,0,1,0.0,1,0,0,0,0,0,5,1
Kike Barja,ESP,"FW,MF",26,Osasuna,La Liga,3.4,6,2,2,2,2,3,8,37.5,5,2,1,1,2,8,2,0
Nacho Vidal,ESP,"DF,FW",28,Osasuna,La Liga,1.1,5,4,2,2,1,2,5,40.0,3,2,0,2,0,5,6,0
Darko Brašanac,SRB,MF,31,Osasuna,La Liga,0.5,1,0,1,0,0,1,1,100.0,0,1,0,1,0,1,0,0
Iñigo Arguibide,ESP,DF,18,Osasuna,La Liga,0.2,1,0,0,1,0,0,0,0.0,0,0,0,0,0,1,1,0
Jorge Moreno,ESP,DF,22,Osasuna,La Liga,0.2,0,0,0,0,0,0,0,0.0,0,1,0,1,0,0,3,0
Xabier Huarte Armendáriz,ESP,MF,22,Osasuna,La Liga,0.1,0,0,0,0,0,0,0,0.0,0,0,0,0,0,0,0,0
Asier Osambela,ESP,MF,19,Osasuna,La Liga,0.1,2,1,0,1,1,0,0,0.0,0,0,0,0,0,2,0,0
Max Svensson,ESP,FW,22,Osasuna,La Liga,0.0,1,0,0,0,1,0,0,0.0,0,0,0,0,0,1,0,0
David Soria,ESP,GK,30,Getafe,La Liga,37.9,0,0,0,0,0,0,2,0.0,2,0,0,0,0,0,21,6
Nemanja Maksimović,SRB,MF,28,Getafe,La Liga,36.3,65,43,26,31,8,23,41,56.1,18,56,23,33,46,111,61,0
Mason Greenwood,ENG,"MF,FW",21,Getafe,La Liga,29.6,11,6,3,5,3,4,21,19.0,17,9,0,9,4,15,4,0
Djené,TOG,"DF,MF",31,Getafe,La Liga,27.6,34,19,18,13,3,15,26,57.7,11,31,15,16,23,57,70,0
Gastón Álvarez,URU,DF,23,Getafe,La Liga,28.2,68,37,43,20,5,37,57,64.9,20,40,11,29,35,103,80,0
Diego Rico,ESP,DF,30,Getafe,La Liga,28.2,64,48,32,23,9,41,76,53.9,35,25,8,17,41,105,76,0
Borja Mayoral,ESP,FW,26,Getafe,La Liga,23.9,9,5,2,2,5,5,22,22.7,17,7,0,7,4,13,16,0
Luis Milla,ESP,MF,28,Getafe,La Liga,23.5,57,33,19,28,10,28,47,59.6,19,20,1,19,32,89,10,0
Omar Alderete,PAR,DF,26,Getafe,La Liga,24.4,28,21,15,13,0,19,35,54.3,16,30,18,12,13,41,111,0
Jaime Mata,ESP,"FW,MF",34,Getafe,La Liga,19.9,24,15,12,8,4,11,26,42.3,15,18,1,17,17,41,31,0
Iglesias,ESP,"DF,FW",25,Getafe,La Liga,15.7,41,22,25,11,5,21,33,63.6,12,18,7,11,16,57,53,0
Juanmi Latasa,ESP,FW,22,Getafe,La Liga,17.3,9,7,0,6,3,1,11,9.1,10,9,0,9,4,13,21,0
Carmona,ESP,"DF,MF",21,Getafe,La Liga,14.6,30,21,13,14,3,9,28,32.1,19,15,2,13,21,51,25,0
Damián Suárez,URU,DF,35,Getafe,La Liga,14.4,36,21,16,16,4,26,45,57.8,19,13,3,10,10,46,31,0
Domingos Duarte,POR,DF,28,Getafe,La Liga,10.1,7,4,6,0,1,5,7,71.4,2,7,5,2,8,15,27,0
Carles Aleñá,ESP,MF,25,Getafe,La Liga,11.3,24,8,7,14,3,10,24,41.7,14,14,3,11,4,28,13,0
Oscar Rodríguez Arnaiz,ESP,"MF,FW",25,Getafe,La Liga,10.7,24,13,2,15,7,9,15,60.0,6,12,1,11,5,29,5,0
Stefan Mitrović,SRB,DF,33,Getafe,La Liga,7.8,9,3,7,2,0,4,8,50.0,4,3,2,1,6,15,26,0
Jesús Santiago,ESP,MF,19,Getafe,La Liga,7.3,17,8,8,5,4,4,7,57.1,3,3,0,3,0,17,8,0
Ilaix Moriba,GUI,"MF,FW",20,Getafe,La Liga,6.7,20,11,3,11,6,4,9,44.4,5,3,1,2,4,24,10,0
Jordi,ESP,"MF,DF",22,Getafe,La Liga,6.4,16,11,3,11,2,7,15,46.7,8,7,2,5,8,24,7,0
Mauro Arambarri,URU,MF,27,Getafe,La Liga,3.8,6,2,3,2,1,1,6,16.7,5,1,0,1,2,8,7,0
Nabil Aberdin,FRA,DF,20,Getafe,La Liga,2.0,0,0,0,0,0,0,1,0.0,1,0,0,0,0,0,4,0
Fabrizio Angileri,ARG,"DF,MF",29,Getafe,La Liga,1.8,1,1,1,0,0,1,3,33.3,2,0,0,0,4,5,8,0
Enes Ünal,TUR,"FW,MF",26,Getafe,La Liga,1.6,0,0,0,0,0,0,0,0.0,0,1,0,1,0,0,2,0
Alberto Risco,ESP,MF,17,Getafe,La Liga,1.5,2,2,1,1,0,0,4,0.0,4,0,0,0,0,2,1,0
Portu,ESP,FW,31,Getafe,La Liga,1.1,5,3,4,0,1,5,6,83.3,1,0,0,0,0,5,0,0
Anthony Lozano,HON,"MF,FW",30,Getafe,La Liga,1.0,0,0,0,0,0,0,1,0.0,1,0,0,0,0,0,1,0
Santiago García,SPA,FW,21,Getafe,La Liga,0.3,1,0,0,0,1,1,1,100.0,0,0,0,0,0,1,0,0
Daniel Fuzato,BRA,GK,26,Getafe,La Liga,0.1,0,0,0,0,0,0,0,0.0,0,0,0,0,0,0,1,0
Gorka Rivera Alonso,ESP,DF,18,Getafe,La Liga,0.0,0,0,0,0,0,0,0,0.0,0,0,0,0,0,0,0,0
Yassin Tallal,ESP,FW,18,Getafe,La Liga,0.0,0,0,0,0,0,0,0,0.0,0,0,0,0,0,0,0,0
Jeremy Jorge,ESP,FW,20,Getafe,La Liga,0.0,0,0,0,0,0,0,0,0.0,0,0,0,0,0,0,0,0
Jørgen Strand Larsen,NOR,FW,23,Celta Vigo,La Liga,31.8,21,11,1,15,5,8,38,21.1,30,15,1,14,5,26,17,0
Oscar Mingueza,ESP,"DF,MF",24,Celta Vigo,La Liga,33.3,62,38,44,11,7,37,80,46.3,43,38,7,31,17,79,49,2
Unai Núñez,ESP,DF,26,Celta Vigo,La Liga,31.1,51,28,30,19,2,23,49,46.9,26,38,24,14,52,103,153,3
Iago Aspas,ESP,FW,35,Celta Vigo,La Liga,30.1,11,6,4,6,1,1,15,6.7,14,23,3,20,10,21,8,0
Fran Beltrán,ESP,MF,24,Celta Vigo,La Liga,27.0,56,32,22,23,11,24,63,38.1,39,28,2,26,18,74,34,0
Vicente Guaita,ESP,GK,36,Celta Vigo,La Liga,26.7,1,1,1,0,0,1,2,50.0,1,0,0,0,0,1,9,1
Carl Starfelt,SWE,DF,28,Celta Vigo,La Liga,24.6,36,30,30,5,1,19,28,67.9,9,35,28,7,34,70,159,2
Jonathan Bamba,CIV,"MF,FW",27,Celta Vigo,La Liga,22.0,14,9,4,8,2,2,17,11.8,15,20,0,20,18,32,12,0
Luca de la Torre,USA,MF,25,Celta Vigo,La Liga,21.7,39,21,12,22,5,22,43,51.2,21,23,4,19,12,51,17,0
Manu Sánchez,ESP,"DF,MF",22,Celta Vigo,La Liga,19.7,54,28,21,25,8,31,55,56.4,24,23,3,20,19,73,65,0
Carlos Dominguez,ESP,DF,22,Celta Vigo,La Liga,17.6,33,21,17,9,7,23,37,62.2,14,24,12,12,22,55,78,0
Renato Tapia,PER,"MF,DF",28,Celta Vigo,La Liga,14.9,41,29,19,19,3,14,25,56.0,11,31,7,24,21,62,50,1
Iván Villar,ESP,GK,26,Celta Vigo,La Liga,11.3,0,0,0,0,0,0,1,0.0,1,0,0,0,0,0,6,0
Javier Manquillo,ESP,"DF,MF",29,Celta Vigo,La Liga,8.3,15,11,6,5,4,8,15,53.3,7,14,3,11,3,18,17,0
Kevin Vázquez,ESP,DF,30,Celta Vigo,La Liga,7.8,15,13,7,7,1,12,21,57.1,9,11,3,8,5,20,25,0
Jailson Siqueira,BRA,"DF,MF",27,Celta Vigo,La Liga,10.0,27,18,22,5,0,13,24,54.2,11,13,5,8,12,39,32,0
Mihailo Ristić,SRB,"DF,MF",27,Celta Vigo,La Liga,9.0,15,9,9,6,0,9,12,75.0,3,9,2,7,10,25,23,0
Hugo Álvarez,ESP,"MF,DF",20,Celta Vigo,La Liga,8.5,14,9,8,3,3,9,20,45.0,11,4,1,3,5,19,9,0
Hugo Sotelo,ESP,MF,19,Celta Vigo,La Liga,8.0,19,17,3,13,3,8,20,40.0,12,7,1,6,2,21,5,0
Anastasios Douvikas,GRE,FW,23,Celta Vigo,La Liga,10.1,15,7,2,6,7,3,8,37.5,5,6,3,3,2,17,9,0
Carles Pérez,ESP,"MF,DF",25,Celta Vigo,La Liga,8.6,13,5,6,5,2,7,18,38.9,11,14,1,13,5,18,8,0
Carlos Dotor,ESP,MF,22,Celta Vigo,La Liga,7.9,14,7,3,8,3,4,13,30.8,9,12,2,10,4,18,4,0
Franco Cervi,ARG,"MF,DF",29,Celta Vigo,La Liga,6.1,24,18,13,9,2,13,24,54.2,11,16,0,16,9,33,4,0
Williot Swedberg,SWE,"FW,MF",19,Celta Vigo,La Liga,4.9,9,4,3,6,0,5,8,62.5,3,11,1,10,0,9,4,0
Joseph Aidoo,GHA,DF,27,Celta Vigo,La Liga,4.5,8,3,6,2,0,4,8,50.0,4,3,1,2,4,12,28,0
Damián Rodríguez,ESP,MF,20,Celta Vigo,La Liga,2.9,6,3,1,3,2,1,3,33.3,2,4,2,2,1,7,2,0
Tadeo Allende,ARG,"MF,FW",24,Celta Vigo,La Liga,3.7,6,1,3,2,1,4,6,66.7,2,3,0,3,3,9,3,0
Miguel Rodríguez,ESP,MF,20,Celta Vigo,La Liga,3.3,6,3,3,1,2,3,9,33.3,6,8,0,8,4,10,0,0
Yoel Lago,ESP,DF,19,Celta Vigo,La Liga,1.0,2,0,2,0,0,0,0,0.0,0,1,0,1,0,2,2,0
Javier Rueda Garcia,ESP,"MF,DF",21,Celta Vigo,La Liga,0.2,0,0,0,0,0,0,0,0.0,0,0,0,0,0,0,0,0
Gabriel Veiga,ESP,FW,21,Celta Vigo,La Liga,0.2,0,0,0,0,0,0,0,0.0,0,0,0,0,0,0,0,0
Lucas Ocampos,ARG,"FW,MF",29,Sevilla,La Liga,31.9,66,47,22,27,17,29,58,50.0,29,34,1,33,21,87,29,0
Youssef En-Nesyri,MAR,FW,26,Sevilla,La Liga,28.6,10,7,3,4,3,0,10,0.0,10,9,1,8,7,17,29,1
Sergio Ramos,ESP,DF,37,Sevilla,La Liga,28.0,45,30,32,11,2,27,40,67.5,13,35,30,5,41,86,156,0
Loïc Bade,FRA,DF,23,Sevilla,La Liga,25.3,65,41,53,12,0,30,49,61.2,19,23,15,8,38,103,116,2
Boubakary Soumaré,FRA,MF,24,Sevilla,La Liga,25.4,39,28,24,14,1,14,26,53.8,12,25,7,18,26,65,20,1
Jesús Navas,ESP,DF,37,Sevilla,La Liga,22.3,37,27,21,14,2,22,40,55.0,18,15,7,8,22,59,48,0
Orjan Nyland,NOR,GK,32,Sevilla,La Liga,24.0,0,0,0,0,0,0,1,0.0,1,0,0,0,0,0,9,1
Nemanja Gudelj,SRB,"DF,MF",31,Sevilla,La Liga,19.4,31,24,18,10,3,17,31,54.8,14,17,9,8,27,58,56,0
Kike Salas,ESP,DF,21,Sevilla,La Liga,17.8,41,23,26,12,3,22,36,61.1,14,25,14,11,26,67,91,1
Oliver Torres,ESP,MF,28,Sevilla,La Liga,18.0,37,22,17,15,5,22,57,38.6,35,40,4,36,6,43,6,0
Djibril Sow,SUI,MF,26,Sevilla,La Liga,16.2,28,21,15,8,5,9,25,36.0,16,20,3,17,17,45,8,1
Marcos Acuña,ARG,DF,31,Sevilla,La Liga,14.4,33,21,20,12,1,9,14,64.3,5,12,2,10,4,37,25,0
Ivan Rakitić,CRO,MF,35,Sevilla,La Liga,15.8,30,16,9,12,9,11,19,57.9,8,16,5,11,14,44,12,0
Adrià Pedrosa,ESP,DF,25,Sevilla,La Liga,19.5,46,26,28,14,4,23,34,67.6,11,26,6,20,15,61,54,0
Suso,ESP,"MF,FW",29,Sevilla,La Liga,16.9,24,17,14,8,2,8,28,28.6,20,9,0,9,5,29,4,0
Isaac Bernal,ESP,FW,23,Sevilla,La Liga,11.5,6,3,2,2,2,5,9,55.6,4,12,0,12,0,6,11,0
Marko Dmitrović,SRB,GK,31,Sevilla,La Liga,13.0,1,1,1,0,0,1,2,50.0,1,0,0,0,1,2,5,0
Dodi Lukebakio,BEL,"FW,MF",25,Sevilla,La Liga,12.5,5,2,2,2,1,1,6,16.7,5,9,2,7,2,7,5,0
Juanlu Sánchez,ESP,DF,19,Sevilla,La Liga,13.1,56,35,34,18,4,34,58,58.6,24,24,7,17,12,68,36,0
Lucien Agoume,FRA,MF,21,Sevilla,La Liga,8.6,23,18,7,14,2,9,12,75.0,3,6,1,5,7,30,8,0
Erik Lamela,ARG,"FW,MF",31,Sevilla,La Liga,5.1,21,14,4,10,7,10,15,66.7,5,12,0,12,1,22,5,0
Fernando,BRA,MF,36,Sevilla,La Liga,5.1,9,8,2,4,3,5,9,55.6,4,2,0,2,7,16,9,0
Joan Jordán,ESP,MF,29,Sevilla,La Liga,4.2,8,7,3,3,2,7,15,46.7,8,4,2,2,4,12,2,0
Rafa Mir,ESP,"FW,MF",26,Sevilla,La Liga,4.3,2,2,1,1,0,1,2,50.0,1,2,0,2,1,3,1,0
Marcão,BRA,DF,27,Sevilla,La Liga,3.9,9,6,5,4,0,6,10,60.0,4,8,6,2,4,13,11,1
Tanguy Nianzou,FRA,DF,21,Sevilla,La Liga,3.5,12,8,9,2,1,8,11,72.7,3,2,0,2,3,15,9,1
Mariano,DOM,"FW,MF",29,Sevilla,La Liga,2.7,1,1,0,1,0,0,1,0.0,1,1,0,1,0,1,2,0
Manuel Sebastián,ESP,MF,19,Sevilla,La Liga,1.3,4,2,4,0,0,3,3,100.0,0,3,0,3,0,4,1,0
Hannibal Mejbri,TUN,MF,20,Sevilla,La Liga,1.2,3,3,1,2,0,0,1,0.0,1,1,0,1,0,3,0,0
Yassine Bounou,MAR,GK,32,Sevilla,La Liga,1.0,0,0,0,0,0,0,0,0.0,0,0,0,0,0,0,0,0
Adnan Januzaj,BEL,"FW,MF",28,Sevilla,La Liga,2.1,3,3,2,0,1,0,1,0.0,1,2,0,2,1,4,0,0
Diego Iturralde,ESP,DF,20,Sevilla,La Liga,0.4,0,0,0,0,0,0,0,0.0,0,1,1,0,0,0,2,0
Alejo Véliz,ARG,FW,19,Sevilla,La Liga,0.4,1,0,0,1,0,1,2,50.0,1,0,0,0,0,1,1,0
Jesús Corona,MEX,"MF,DF",30,Sevilla,La Liga,0.2,0,0,0,0,0,0,0,0.0,0,0,0,0,1,1,0,0
Federico Gattoni,ARG,"DF,FW",24,Sevilla,La Liga,0.1,1,0,1,0,0,1,1,100.0,0,0,0,0,0,1,1,0
Predrag Rajković,SRB,GK,27,Mallorca,La Liga,36.0,2,1,2,0,0,2,2,100.0,0,0,0,0,0,2,14,0
Dani Rodríguez,ESP,MF,35,Mallorca,La Liga,29.1,47,24,21,20,6,21,45,46.7,24,34,5,29,15,62,21,0
Martin Valjent,SVK,DF,27,Mallorca,La Liga,26.1,34,18,19,13,2,18,30,60.0,12,26,11,15,29,63,112,1
Giovanni González,URU,DF,28,Mallorca,La Liga,27.4,73,45,37,32,4,40,81,49.4,41,24,3,21,31,104,60,2
Samu Costa,POR,MF,22,Mallorca,La Liga,25.6,91,50,40,46,5,46,93,49.5,47,28,14,14,39,130,59,3
Vedat Muriqi,KVX,FW,29,Mallorca,La Liga,25.9,11,6,4,3,4,2,14,14.3,12,11,4,7,6,17,26,0
Matija Nastasić,SRB,DF,30,Mallorca,La Liga,25.1,35,17,26,9,0,24,32,75.0,8,33,20,13,29,64,114,0
Antonio Raillo,ESP,DF,31,Mallorca,La Liga,24.4,30,23,18,12,0,17,23,73.9,6,44,30,14,37,67,104,2
Sergi Darder,ESP,MF,29,Mallorca,La Liga,24.0,39,26,13,21,5,12,31,38.7,19,20,4,16,16,55,16,0
Antonio Sánchez,ESP,MF,26,Mallorca,La Liga,16.1,25,11,13,10,2,11,32,34.4,21,24,5,19,13,38,13,0
Cyle Larin,CAN,FW,28,Mallorca,La Liga,20.3,17,8,6,4,7,2,7,28.6,5,16,5,11,3,20,17,0
Jaume Costa,ESP,DF,35,Mallorca,La Liga,18.7,38,22,23,10,5,18,29,62.1,11,14,4,10,16,54,35,0
Omar Mascarell,ESP,MF,30,Mallorca,La Liga,17.5,33,16,16,17,0,18,35,51.4,17,24,8,16,31,64,30,1
Pablo Maffeo,ESP,DF,26,Mallorca,La Liga,16.2,35,22,18,13,4,23,40,57.5,17,12,2,10,10,45,23,0
Copete,ESP,DF,23,Mallorca,La Liga,14.8,45,27,27,17,1,30,43,69.8,13,12,6,6,32,77,47,1
Manu Morlanes,ESP,MF,24,Mallorca,La Liga,17.9,50,29,23,26,1,23,53,43.4,30,13,1,12,20,70,21,0
Toni Lato,ESP,DF,25,Mallorca,La Liga,17.2,38,23,19,13,6,16,27,59.3,11,17,3,14,17,55,27,0
Abdón Prats,ESP,"FW,MF",30,Mallorca,La Liga,14.1,6,4,2,2,2,3,5,60.0,2,6,3,3,2,8,12,0
Nacho Vidal,ESP,DF,28,Mallorca,La Liga,4.6,12,5,4,5,3,6,13,46.2,7,5,2,3,3,15,9,0
Nemanja Radonjić,SRB,"MF,DF",27,Mallorca,La Liga,3.9,4,2,1,3,0,1,4,25.0,3,2,0,2,3,7,3,0
Siebe Van Der Heyden,BEL,DF,25,Mallorca,La Liga,3.2,9,2,7,2,0,4,6,66.7,2,1,1,0,7,16,12,0
Amath,SEN,"FW,MF",27,Mallorca,La Liga,4.4,9,6,7,2,0,2,10,20.0,8,2,0,2,3,12,6,0
Javier Llabrés,ESP,"MF,FW",20,Mallorca,La Liga,2.7,3,1,1,1,1,1,2,50.0,1,1,0,1,3,6,4,0
Iván Cuéllar,ESP,GK,39,Mallorca,La Liga,1.0,0,0,0,0,0,0,0,0.0,0,0,0,0,0,0,0,0
Dominik Greif,SVK,GK,26,Mallorca,La Liga,1.0,0,0,0,0,0,0,0,0.0,0,0,0,0,0,0,0,0
Alvaro Vallés,ESP,GK,26,Las Palmas,La Liga,36.3,3,2,3,0,0,3,8,37.5,5,0,0,0,0,3,40,1
Kirian Rodríguez,ESP,MF,27,Las Palmas,La Liga,35.7,52,32,22,25,5,24,67,35.8,43,39,3,36,28,80,23,1
Mika Màrmol,ESP,DF,21,Las Palmas,La Liga,35.3,70,42,44,24,2,35,53,66.0,18,39,19,20,44,114,147,2
Munir El Haddadi,MAR,FW,27,Las Palmas,La Liga,27.2,40,27,18,17,5,17,38,44.7,21,27,1,26,11,51,16,0
Sergi Cardona,ESP,DF,24,Las Palmas,La Liga,31.3,90,55,52,29,9,55,96,57.3,41,45,7,38,46,136,102,0
Javier Muñoz,ESP,MF,28,Las Palmas,La Liga,29.3,42,23,14,22,6,16,44,36.4,28,40,4,36,20,62,29,1
Alex Suárez,ESP,DF,30,Las Palmas,La Liga,28.5,53,36,33,15,5,31,37,83.8,6,33,14,19,18,71,84,0
Saúl Coco,EQG,DF,24,Las Palmas,La Liga,25.5,32,19,25,7,0,11,18,61.1,7,27,15,12,20,52,120,3
Sandro Ramírez,ESP,FW,28,Las Palmas,La Liga,20.1,12,8,4,6,2,6,15,40.0,9,13,1,12,4,16,14,1
Alberto Moleiro,ESP,"FW,MF",19,Las Palmas,La Liga,20.0,15,6,4,7,4,6,30,20.0,24,11,0,11,7,22,10,0
Máximo Perrone,ARG,MF,20,Las Palmas,La Liga,18.0,42,21,17,22,3,19,39,48.7,20,27,4,23,24,66,21,0
Enzo Loiodice,FRA,MF,22,Las Palmas,La Liga,19.9,62,35,15,34,13,20,42,47.6,22,20,2,18,12,74,16,1
Marvin,ESP,"FW,DF",23,Las Palmas,La Liga,20.6,39,25,18,17,4,18,36,50.0,18,28,2,26,14,53,18,1
Julian Araujo,MEX,DF,21,Las Palmas,La Liga,16.2,41,22,29,7,5,23,33,69.7,10,23,16,7,10,51,52,1
Sory Kaba,GUI,FW,28,Las Palmas,La Liga,8.0,2,0,0,2,0,0,5,0.0,5,6,0,6,0,2,9,0
Jonathan Viera,ESP,"MF,FW",33,Las Palmas,La Liga,6.9,6,3,1,2,3,1,9,11.1,8,0,0,0,0,6,1,0
Marc Cardona,ESP,FW,28,Las Palmas,La Liga,8.0,9,8,3,4,2,1,12,8.3,11,5,0,5,2,11,7,0
Francisco Jesús Crespo García,ESP,FW,27,Las Palmas,La Liga,5.6,12,8,3,6,3,6,18,33.3,12,4,0,4,2,14,5,0
Daley Sinkgraven,NED,DF,28,Las Palmas,La Liga,4.3,11,5,6,5,0,2,8,25.0,6,5,3,2,6,17,9,0
Juan Herzog,ESP,DF,20,Las Palmas,La Liga,3.2,6,5,5,1,0,3,6,50.0,3,4,1,3,2,8,17,0
Alvaro Lemos,ESP,DF,30,Las Palmas,La Liga,2.8,4,1,1,3,0,0,2,0.0,2,3,1,2,2,6,4,0
Benito Ramírez,ESP,"FW,MF",28,Las Palmas,La Liga,4.3,5,3,2,3,0,3,6,50.0,3,7,1,6,3,8,0,0
José Campaña,ESP,MF,30,Las Palmas,La Liga,1.9,2,2,1,1,0,0,2,0.0,2,3,2,1,2,4,3,0
Cristian Herrera,ESP,"FW,MF",32,Las Palmas,La Liga,1.8,1,1,0,1,0,1,2,50.0,1,1,0,1,0,1,2,0
Aarón Escandell,ESP,GK,27,Las Palmas,La Liga,1.7,0,0,0,0,0,0,0,0.0,0,0,0,0,0,0,1,1
Fabio González,ESP,MF,26,Las Palmas,La Liga,1.4,2,2,2,0,0,1,2,50.0,1,2,0,2,0,2,0,0
Eric Curbelo,ESP,"DF,MF",29,Las Palmas,La Liga,1.1,4,3,2,2,0,3,4,75.0,1,3,1,2,2,6,5,1
Omenuke Mfulu,COD,"MF,FW",29,Las Palmas,La Liga,0.9,4,3,3,1,0,0,1,0.0,1,1,1,0,2,6,5,0
Iñaki González,ESP,MF,19,Las Palmas,La Liga,0.1,1,0,1,0,0,0,0,0.0,0,0,0,0,0,1,1,0
Stole Dimitrievski,MKD,GK,29,Rayo Vallecano,La Liga,37.0,1,1,1,0,0,1,1,100.0,0,0,0,0,0,1,17,3
Florian Lejeune,FRA,DF,32,Rayo Vallecano,La Liga,37.0,39,25,26,11,2,19,30,63.3,11,33,18,15,23,62,155,1
Isaac Palazón Camacho,ESP,"MF,FW",28,Rayo Vallecano,La Liga,31.0,46,25,16,21,9,20,58,34.5,38,29,2,27,16,62,41,0
Iván Balliu,ALB,DF,31,Rayo Vallecano,La Liga,31.9,44,31,20,24,0,22,39,56.4,17,27,11,16,29,73,66,1
Oscar Valentín,ESP,MF,28,Rayo Vallecano,La Liga,29.9,107,66,39,62,6,46,101,45.5,55,62,10,52,35,142,52,1
Alvaro García,ESP,"FW,MF",30,Rayo Vallecano,La Liga,27.5,34,25,15,10,9,7,34,20.6,27,35,0,35,36,70,33,0
Alfonso Espino,URU,DF,31,Rayo Vallecano,La Liga,27.9,67,45,43,22,2,30,82,36.6,52,26,4,22,40,107,63,0
Unai López,ESP,MF,27,Rayo Vallecano,La Liga,23.4,48,24,18,23,7,21,53,39.6,32,24,3,21,16,64,15,2
Sergio Camello,ESP,FW,22,Rayo Vallecano,La Liga,18.5,16,5,3,10,3,6,15,40.0,9,10,2,8,3,19,15,0
Abdul Mumin,GHA,DF,25,Rayo Vallecano,La Liga,18.8,19,10,13,4,2,8,10,80.0,2,27,19,8,22,41,82,1
Aridane Hernández,ESP,DF,34,Rayo Vallecano,La Liga,18.8,10,8,5,4,1,4,11,36.4,7,19,14,5,14,24,98,1
Oscar Trejo,ARG,"FW,MF",35,Rayo Vallecano,La Liga,15.3,27,15,11,9,7,13,21,61.9,8,21,1,20,5,32,9,0
Pathé Ciss,SEN,MF,29,Rayo Vallecano,La Liga,18.5,44,24,16,26,2,16,29,55.2,13,27,10,17,30,74,54,0
Raúl de Tomás,ESP,FW,28,Rayo Vallecano,La Liga,14.1,9,5,4,3,2,3,6,50.0,3,3,0,3,1,10,8,0
Jorge de Frutos,ESP,"FW,MF",26,Rayo Vallecano,La Liga,17.2,19,8,5,8,6,7,22,31.8,15,12,0,12,7,26,18,0
Pep Chavarría,ESP,"DF,MF",25,Rayo Vallecano,La Liga,13.0,23,18,15,6,2,11,17,64.7,6,15,3,12,6,29,29,1
Kike Pérez,ESP,"MF,FW",26,Rayo Vallecano,La Liga,9.3,27,11,11,15,1,11,23,47.8,12,11,0,11,8,35,6,0
Andrei Ratiu,ROU,"DF,MF",25,Rayo Vallecano,La Liga,7.0,12,4,6,5,1,8,15,53.3,7,4,1,3,0,12,12,0
Crespo,POR,MF,26,Rayo Vallecano,La Liga,5.9,16,9,8,6,2,9,17,52.9,8,15,6,9,10,26,7,0
Randy Nteka,ANG,"FW,MF",25,Rayo Vallecano,La Liga,6.4,11,4,1,6,4,4,10,40.0,6,6,1,5,2,13,11,1
Radamel Falcao,COL,"FW,DF",37,Rayo Vallecano,La Liga,4.5,7,5,1,5,1,1,3,33.3,2,2,0,2,3,10,4,0
Cárdenas,ESP,GK,26,Rayo Vallecano,La Liga,1.0,0,0,0,0,0,0,0,0.0,0,0,0,0,0,0,1,0
Bebé,CPV,"MF,FW",33,Rayo Vallecano,La Liga,2.4,2,2,1,1,0,1,5,20.0,4,1,0,1,0,2,0,0
Salvi,ESP,MF,32,Rayo Vallecano,La Liga,0.3,0,0,0,0,0,0,4,0.0,4,0,0,0,1,1,0,0
José Pozo,ESP,MF,27,Rayo Vallecano,La Liga,0.2,1,1,0,1,0,1,1,100.0,0,1,0,1,0,1,0,0
Diego Méndez,ESP,MF,19,Rayo Vallecano,La Liga,0.1,1,1,1,0,0,1,1,100.0,0,0,0,0,1,2,0,0
Rubén Alcaraz,ESP,MF,32,Cádiz,La Liga,34.8,97,59,39,52,6,50,121,41.3,71,60,14,46,33,130,55,2
Jeremías Ledesma,ARG,GK,30,Cádiz,La Liga,33.9,1,1,1,0,0,1,4,25.0,3,0,0,0,0,1,15,3
Chris Ramos,ESP,"FW,MF",26,Cádiz,La Liga,29.0,28,15,9,15,4,8,27,29.6,19,23,7,16,9,37,44,0
Fali,ESP,DF,29,Cádiz,La Liga,28.3,41,26,29,11,1,21,36,58.3,15,38,24,14,27,68,120,0
Isaac Carcelen,ESP,DF,30,Cádiz,La Liga,29.0,50,31,30,15,5,25,45,55.6,20,24,7,17,27,77,87,2
Javi Hernández,ESP,DF,25,Cádiz,La Liga,27.9,43,24,26,12,5,25,46,54.3,21,34,9,25,19,62,72,1
Roberto Navarro,ESP,"MF,FW",21,Cádiz,La Liga,21.0,46,29,20,21,5,22,43,51.2,21,33,0,33,19,65,7,1
Víctor Chust,ESP,DF,23,Cádiz,La Liga,20.7,29,18,23,5,1,18,32,56.3,14,27,21,6,11,40,92,1
Iván Alejo,ESP,MF,28,Cádiz,La Liga,18.8,40,23,23,11,6,17,57,29.8,40,20,0,20,7,47,17,0
Gonzalo Escalante,ARG,MF,30,Cádiz,La Liga,18.9,39,24,16,14,9,20,55,36.4,35,23,5,18,26,65,33,2
Rubén Sobrino,ESP,"MF,FW",31,Cádiz,La Liga,18.3,52,28,18,26,8,22,51,43.1,29,26,2,24,16,68,18,0
Roger Martí,ESP,FW,32,Cádiz,La Liga,15.1,12,6,1,9,2,2,7,28.6,5,16,1,15,7,19,4,0
Lucas,BRA,DF,22,Cádiz,La Liga,17.1,47,27,32,11,4,32,55,58.2,23,27,4,23,17,64,45,0
Alex Fernández,ESP,MF,30,Cádiz,La Liga,14.3,19,9,10,9,0,11,22,50.0,11,17,5,12,15,34,30,0
Maxi Gómez,URU,FW,26,Cádiz,La Liga,12.9,6,4,2,3,1,3,5,60.0,2,8,3,5,3,9,3,0
Darwin Machís,VEN,MF,30,Cádiz,La Liga,8.7,23,14,7,9,7,13,24,54.2,11,8,1,7,4,27,2,0
Juanmi,ESP,FW,30,Cádiz,La Liga,9.7,9,4,2,7,0,2,9,22.2,7,6,0,6,6,15,3,0
Rominigue Kouamé,MLI,MF,26,Cádiz,La Liga,9.1,14,9,6,7,1,7,15,46.7,8,10,2,8,13,27,10,1
Joseba Zaldúa,ESP,DF,31,Cádiz,La Liga,7.8,20,12,17,2,1,13,21,61.9,8,6,4,2,2,22,20,0
Luis Hernández,ESP,DF,34,Cádiz,La Liga,8.0,7,3,4,3,0,4,8,50.0,4,3,2,1,8,15,25,0
Jorge Meré,ESP,DF,26,Cádiz,La Liga,7.5,8,7,6,2,0,4,7,57.1,3,5,3,2,8,16,33,0
Aiham Ousou,SYR,DF,23,Cádiz,La Liga,4.8,8,5,6,2,0,5,5,100.0,0,1,0,1,7,15,15,0
David Gil,ESP,GK,29,Cádiz,La Liga,4.1,0,0,0,0,0,0,1,0.0,1,0,0,0,0,0,3,0
Fede San Emeterio,ESP,MF,26,Cádiz,La Liga,1.7,3,2,2,1,0,1,4,25.0,3,3,2,1,2,5,1,0
Mamadou Mbaye,SEN,DF,25,Cádiz,La Liga,3.2,6,3,3,3,0,2,5,40.0,3,10,7,3,5,11,26,0
Sergi Guardiola,ESP,"FW,MF",32,Cádiz,La Liga,5.5,10,7,2,6,2,4,9,44.4,5,10,0,10,0,10,4,0
Brian Ocampo,URU,"MF,FW",24,Cádiz,La Liga,2.8,4,3,1,3,0,2,5,40.0,3,4,0,4,3,7,0,0
Diadie Samassékou,MLI,MF,27,Cádiz,La Liga,1.0,5,3,2,2,1,5,6,83.3,1,0,0,0,3,8,1,0
Alvaro Negredo,ESP,"FW,MF",37,Cádiz,La Liga,0.6,0,0,0,0,0,0,0,0.0,0,1,0,1,1,1,0,0
Karl Etta,CMR,FW,19,Cádiz,La Liga,0.2,1,1,0,1,0,0,0,0.0,0,0,0,0,0,1,0,0
José Mari,ESP,"MF,FW",35,Cádiz,La Liga,0.2,2,1,0,2,0,1,2,50.0,1,0,0,0,0,2,0,0
Milutin Osmajić,MNE,MF,24,Cádiz,La Liga,0.1,0,0,0,0,0,0,0,0.0,0,0,0,0,0,0,0,0
Borja Vázquez,ESP,FW,18,Cádiz,La Liga,0.0,1,0,1,0,0,1,1,100.0,0,0,0,0,0,1,1,0
Moussa Diakité,MLI,MF,19,Cádiz,La Liga,0.0,0,0,0,0,0,0,0,0.0,0,0,0,0,0,0,0,0
Luís Maximiano,POR,GK,24,Almería,La Liga,33.0,0,0,0,0,0,0,1,0.0,1,0,0,0,0,0,19,2
Edgar González,ESP,"DF,MF",26,Almería,La Liga,28.0,45,21,22,20,3,25,49,51.0,24,48,28,20,38,83,130,3
Adri Embarba,ESP,"FW,MF",31,Almería,La Liga,27.5,55,37,29,15,11,26,53,49.1,27,37,1,36,15,70,12,0
Lucas Robertone,ARG,MF,26,Almería,La Liga,26.5,61,33,28,23,10,25,50,50.0,25,43,9,34,51,112,43,0
Juan Brandáriz,ESP,DF,24,Almería,La Liga,27.0,34,22,22,12,0,16,26,61.5,10,38,23,15,14,48,107,3
Dion Lopy,SEN,MF,21,Almería,La Liga,21.3,62,37,36,20,6,17,44,38.6,27,23,5,18,15,77,22,2
Sergio Arribas,ESP,"MF,FW",21,Almería,La Liga,22.7,34,17,16,17,1,14,31,45.2,17,20,1,19,16,50,8,1
Pubill,ESP,DF,20,Almería,La Liga,20.9,47,23,35,8,4,22,39,56.4,17,20,8,12,15,62,83,1
Léo Baptistão,BRA,FW,30,Almería,La Liga,20.4,25,16,12,8,5,9,25,36.0,16,13,1,12,11,36,22,0
César Montes,MEX,DF,26,Almería,La Liga,19.9,22,13,13,9,0,9,18,50.0,9,21,9,12,11,33,94,0
Sergio Akieme,ESP,DF,25,Almería,La Liga,18.6,27,15,18,7,2,13,16,81.3,3,14,4,10,10,37,34,0
Largie Ramazani,BEL,"FW,MF",22,Almería,La Liga,17.3,12,7,5,6,1,6,26,23.1,20,16,2,14,34,46,10,0
Iddrisu Baba,GHA,MF,27,Almería,La Liga,15.9,46,26,27,18,1,17,39,43.6,22,20,6,14,11,57,27,2
Jonathan Viera,ESP,MF,33,Almería,La Liga,10.1,19,9,6,9,4,10,19,52.6,9,4,0,4,4,23,1,0
Alex Centelles,ESP,DF,25,Almería,La Liga,10.9,11,6,9,2,0,8,18,44.4,10,5,2,3,18,29,29,0
Gonzalo Melero,ESP,"MF,FW",29,Almería,La Liga,12.3,14,8,7,5,2,7,19,36.8,12,12,4,8,4,18,11,0
Luis Javier Suárez,COL,FW,25,Almería,La Liga,10.2,7,5,2,5,0,2,6,33.3,4,11,0,11,0,7,13,0
Anthony Lozano,HON,FW,30,Almería,La Liga,8.6,7,5,2,5,0,4,7,57.1,3,6,1,5,2,9,12,0
Alejandro Pozo Pozo,ESP,"DF,MF",24,Almería,La Liga,10.8,19,12,11,6,2,12,20,60.0,8,14,4,10,7,26,21,0
Bruno Langa,MOZ,DF,25,Almería,La Liga,9.1,17,12,10,5,2,6,14,42.9,8,11,4,7,4,21,33,2
Aleksandar Radovanović,SRB,DF,29,Almería,La Liga,6.3,8,7,7,1,0,6,6,100.0,0,8,8,0,11,19,48,0
Kaiky,BRA,DF,19,Almería,La Liga,5.8,7,4,6,0,1,3,6,50.0,3,9,7,2,3,10,29,1
Luka Romero,ARG,FW,18,Almería,La Liga,4.9,5,1,2,3,0,2,4,50.0,2,12,1,11,1,6,2,1
Marcos Peña,ESP,MF,18,Almería,La Liga,4.9,19,14,12,7,0,6,12,50.0,6,9,3,6,13,32,8,0
Houboulang Mendes,GNB,DF,25,Almería,La Liga,4.4,16,13,11,5,0,8,16,50.0,8,4,2,2,1,17,17,1
Fernando,ESP,GK,33,Almería,La Liga,4.0,0,0,0,0,0,0,0,0.0,0,1,0,1,0,0,2,0
Arnau Puigmal,ESP,"FW,DF",22,Almería,La Liga,2.8,2,1,1,1,0,1,3,33.3,2,3,0,3,3,5,2,0
Marko Milovanović,SRB,"FW,MF",19,Almería,La Liga,3.4,4,4,1,3,0,2,4,50.0,2,2,0,2,0,4,5,0
Lázaro,BRA,"FW,MF",21,Almería,La Liga,3.2,4,1,2,0,2,2,8,25.0,6,4,0,4,1,5,1,0
Ibrahima Koné,MLI,FW,24,Almería,La Liga,3.1,1,0,1,0,0,1,1,100.0,0,1,0,1,0,1,4,0
Srđan Babić,SRB,DF,27,Almería,La Liga,1.0,2,2,0,2,0,1,1,100.0,0,1,1,0,0,2,2,0
Diego Mariño,ESP,GK,33,Almería,La Liga,1.0,0,0,0,0,0,0,0,0.0,0,0,0,0,0,0,1,0
Marciano Sanca,GNB,"FW,MF",19,Almería,La Liga,0.5,0,0,0,0,0,0,0,0.0,0,0,0,0,0,0,0,0
Paco Sanz,ESP,DF,18,Almería,La Liga,0.3,0,0,0,0,0,0,1,0.0,1,0,0,0,0,0,4,0
Rachad Fettal,MAR,FW,18,Almería,La Liga,0.2,1,1,1,0,0,0,0,0.0,0,0,0,0,0,1,0,0
Carlos Neva,ESP,DF,27,Granada,La Liga,35.0,32,21,22,9,1,17,40,42.5,23,39,14,25,30,62,108,2
Ignasi Miquel,ESP,DF,30,Granada,La Liga,33.2,47,30,39,6,2,23,40,57.5,17,32,16,16,45,92,132,4
Gerard Gumbau,ESP,MF,28,Granada,La Liga,29.7,55,34,21,30,4,23,62,37.1,39,24,5,19,25,80,30,2
Lucas Boyé,ARG,FW,27,Granada,La Liga,28.2,50,25,14,25,11,14,34,41.2,20,35,5,30,10,60,46,0
Sergio Ruiz,ESP,MF,28,Granada,La Liga,27.7,83,46,43,36,4,38,84,45.2,46,24,6,18,28,111,43,1
Myrto Uzuni,ALB,FW,28,Granada,La Liga,27.2,18,14,8,7,3,6,27,22.2,21,19,3,16,4,22,7,0
Ricard Sánchez,ESP,DF,23,Granada,La Liga,25.5,29,18,15,8,6,12,24,50.0,12,32,4,28,13,42,64,0
Gonzalo Villar,ESP,MF,25,Granada,La Liga,20.0,51,33,26,20,5,26,41,63.4,15,32,10,22,6,57,26,1
Bryan Zaragoza,ESP,"MF,FW",22,Granada,La Liga,18.2,18,9,8,6,4,8,23,34.8,15,9,0,9,3,21,3,0
Miguel Ángel Rubio,ESP,DF,25,Granada,La Liga,17.3,20,12,14,6,0,14,21,66.7,7,31,18,13,28,48,74,2
Augusto Batalla,ARG,GK,27,Granada,La Liga,17.0,0,0,0,0,0,0,1,0.0,1,0,0,0,0,0,10,2
Bruno Méndez,URU,DF,23,Granada,La Liga,14.8,36,17,19,12,5,21,37,56.8,16,24,6,18,26,62,45,0
Oscar Melendo,ESP,"MF,FW",25,Granada,La Liga,12.5,14,6,4,10,0,4,12,33.3,8,13,0,13,5,19,4,1
André Ferreira,POR,GK,27,Granada,La Liga,14.9,0,0,0,0,0,0,1,0.0,1,0,0,0,0,0,9,2
Raúl Torrente,ESP,DF,21,Granada,La Liga,13.9,29,16,20,9,0,17,22,77.3,5,16,10,6,11,40,68,2
Facundo Pellistri,URU,"MF,FW",21,Granada,La Liga,13.7,29,19,12,10,7,6,21,28.6,15,18,0,18,4,33,7,0
José Callejón,ESP,"MF,FW",36,Granada,La Liga,8.9,13,6,10,3,0,8,22,36.4,14,7,1,6,5,18,10,0
Kamil Jóźwiak,POL,MF,25,Granada,La Liga,6.3,13,10,4,6,3,9,17,52.9,8,4,0,4,2,15,6,0
Antonio Puertas,ESP,"MF,FW",31,Granada,La Liga,8.1,12,8,6,5,1,6,15,40.0,9,5,0,5,6,18,4,0
Martin Hongla,CMR,"MF,DF",25,Granada,La Liga,6.2,7,3,2,5,0,3,9,33.3,6,6,3,3,6,13,13,1
Kamil Piątkowski,POL,DF,23,Granada,La Liga,5.6,18,10,16,1,1,10,14,71.4,4,6,5,1,8,26,28,1
Alvaro Carreras,ESP,"MF,FW",20,Granada,La Liga,5.3,13,8,8,4,1,5,11,45.5,6,5,1,4,7,20,9,1
Raúl Fernández,ESP,GK,35,Granada,La Liga,3.1,0,0,0,0,0,0,1,0.0,1,0,0,0,0,0,1,2
Matias Arezo,URU,FW,20,Granada,La Liga,4.1,7,3,2,5,0,1,5,20.0,4,4,1,3,1,8,4,0
Marc Martínez,ESP,GK,33,Granada,La Liga,3.0,0,0,0,0,0,0,1,0.0,1,0,0,0,0,0,1,0
Wilson Manafá,POR,"DF,MF",29,Granada,La Liga,2.7,6,4,3,2,1,4,7,57.1,3,1,0,1,1,7,4,1
Faitout Maouassa,FRA,"DF,MF",25,Granada,La Liga,2.5,8,5,6,1,1,4,5,80.0,1,6,0,6,1,9,3,0
Theo Corbeanu,CAN,"MF,FW",21,Granada,La Liga,2.0,5,2,2,3,0,1,3,33.3,2,3,0,3,3,8,2,0
Víctor Díaz,ESP,"DF,MF",35,Granada,La Liga,1.8,5,3,2,3,0,1,3,33.3,2,1,0,1,1,6,8,0
Sergio Rodelas,ESP,"FW,DF",18,Granada,La Liga,1.4,3,2,1,0,2,0,3,0.0,3,0,0,0,0,3,0,0
Jesús Vallejo,ESP,DF,26,Granada,La Liga,1.2,3,1,1,2,0,2,2,100.0,0,3,2,1,0,3,1,1
Samuel Omorodion,ESP,FW,19,Granada,La Liga,0.9,1,1,0,1,0,1,1,100.0,0,0,0,0,0,1,0,0
Njegoš Petrović,SRB,"MF,FW",24,Granada,La Liga,1.7,5,2,4,1,0,2,3,66.7,1,2,0,2,1,6,3,0
Famara Diedhiou,SEN,"FW,MF",30,Granada,La Liga,1.0,1,1,0,1,0,0,1,0.0,1,0,0,0,0,1,2,0
Brau,ESP,DF,21,Granada,La Liga,0.3,1,0,1,0,0,1,1,100.0,0,0,0,0,0,1,2,0
Adri Bosch,ESP,DF,22,Granada,La Liga,0.3,1,1,1,0,0,0,0,0.0,0,0,0,0,0,1,1,0
Pablo Saenz,SPA,MF,23,Granada,La Liga,0.2,3,3,2,0,1,1,3,33.3,2,0,0,0,0,3,0,0
Alberto Soro,ESP,MF,24,Granada,La Liga,0.1,0,0,0,0,0,0,0,0.0,0,0,0,0,0,0,0,0
Alberto Perea,ESP,"MF,FW",32,Granada,La Liga,0.0,0,0,0,0,0,0,2,0.0,2,0,0,0,0,0,0,0
Gianluigi Donnarumma,ITA,GK,24,Paris S-G,Ligue 1,24.1,0,0,0,0,0,0,0,0.0,0,0,0,0,1,1,9,4
Kylian Mbappé,FRA,FW,24,Paris S-G,Ligue 1,24.0,4,1,1,1,2,4,9,44.4,5,4,0,4,2,6,2,0
Vitinha,POR,MF,23,Paris S-G,Ligue 1,23.6,39,24,12,16,11,16,48,33.3,32,29,11,18,23,62,30,2
Lucas Hernández,FRA,DF,27,Paris S-G,Ligue 1,21.2,52,36,28,15,9,29,50,58.0,21,21,5,16,27,79,38,0
Danilo Pereira,POR,DF,31,Paris S-G,Ligue 1,22.2,22,12,14,6,2,9,17,52.9,8,29,26,3,23,45,100,1
Warren Zaire-Emery,FRA,"MF,DF",17,Paris S-G,Ligue 1,21.8,51,28,18,24,9,28,51,54.9,23,32,8,24,15,66,22,2
Manuel Ugarte Ribeiro,URU,MF,22,Paris S-G,Ligue 1,21.5,98,57,39,43,16,43,89,48.3,46,27,6,21,40,138,25,2
Achraf Hakimi,MAR,DF,24,Paris S-G,Ligue 1,21.5,29,19,14,9,6,17,34,50.0,17,28,4,24,12,41,28,2
Marquinhos,BRA,DF,29,Paris S-G,Ligue 1,17.1,19,11,10,7,2,11,17,64.7,6,29,19,10,17,36,58,1
Lee Kang-in,KOR,"FW,MF",22,Paris S-G,Ligue 1,16.3,26,13,7,9,10,15,36,41.7,21,7,0,7,6,32,3,0
Bradley Barcola,FRA,"FW,MF",20,Paris S-G,Ligue 1,15.2,34,16,12,13,9,7,25,28.0,18,27,2,25,10,44,13,1
Milan Škriniar,SVK,DF,28,Paris S-G,Ligue 1,18.1,24,18,17,7,0,14,22,63.6,8,19,10,9,12,36,51,2
Ousmane Dembélé,FRA,"MF,FW",26,Paris S-G,Ligue 1,16.7,19,14,2,7,10,6,13,46.2,7,11,0,11,5,24,4,1
Gonçalo Ramos,POR,FW,22,Paris S-G,Ligue 1,15.8,25,15,4,12,9,6,20,30.0,14,12,2,10,5,30,16,0
Fabián Ruiz Peña,ESP,MF,27,Paris S-G,Ligue 1,13.3,34,23,17,14,3,23,42,54.8,19,8,2,6,11,45,21,2
Randal Kolo Muani,FRA,"FW,MF",24,Paris S-G,Ligue 1,14.1,10,8,5,3,2,5,13,38.5,8,5,0,5,4,14,10,0
Marco Asensio,ESP,"MF,FW",27,Paris S-G,Ligue 1,12.4,12,10,4,7,1,4,13,30.8,9,7,0,7,5,17,2,0
Carlos Soler,ESP,"MF,DF",26,Paris S-G,Ligue 1,12.1,15,10,9,2,4,6,21,28.6,15,10,3,7,5,20,11,1
Lucas Beraldo,BRA,DF,19,Paris S-G,Ligue 1,11.2,22,14,14,8,0,10,25,40.0,15,15,6,9,20,42,25,0
Nordi Mukiele,FRA,DF,25,Paris S-G,Ligue 1,8.8,12,8,6,5,1,8,15,53.3,7,17,4,13,14,26,28,0
Arnau Tenas,ESP,GK,22,Paris S-G,Ligue 1,5.9,0,0,0,0,0,0,0,0.0,0,0,0,0,0,0,0,0
Yoram Zague,FRA,DF,17,Paris S-G,Ligue 1,4.1,18,8,11,4,3,11,24,45.8,13,3,0,3,4,22,9,1
Keylor Navas,CRC,GK,36,Paris S-G,Ligue 1,4.0,0,0,0,0,0,0,0,0.0,0,0,0,0,0,0,2,0
Senny Mayulu,FRA,"FW,MF",17,Paris S-G,Ligue 1,3.6,13,8,6,6,1,6,7,85.7,1,1,0,1,3,16,0,0
Nuno Mendes,POR,DF,21,Paris S-G,Ligue 1,3.0,5,5,4,1,0,4,7,57.1,3,4,0,4,4,9,2,0
Ethan Mbappé,FRA,"MF,DF",16,Paris S-G,Ligue 1,0.5,0,0,0,0,0,0,2,0.0,2,1,0,1,0,0,0,0
Cher Ndour,ITA,MF,19,Paris S-G,Ligue 1,0.3,2,2,0,2,0,1,2,50.0,1,0,0,0,0,2,0,0
Hugo Ekitike,FRA,FW,21,Paris S-G,Ligue 1,0.1,0,0,0,0,0,0,0,0.0,0,0,0,0,0,0,0,0
Layvin Kurzawa,FRA,DF,30,Paris S-G,Ligue 1,0.1,0,0,0,0,0,0,0,0.0,0,0,0,0,0,0,0,0
Youssouf Fofana,FRA,MF,24,Monaco,Ligue 1,30.0,61,39,19,36,6,30,66,45.5,36,35,7,28,37,98,31,1
Wissam Ben Yedder,FRA,FW,32,Monaco,Ligue 1,25.7,4,3,1,2,1,1,11,9.1,10,18,0,18,8,12,1,0
Aleksandr Golovin,RUS,"MF,FW",27,Monaco,Ligue 1,23.9,42,30,14,22,6,15,42,35.7,27,37,3,34,21,63,14,0
Takumi Minamino,JPN,MF,28,Monaco,Ligue 1,23.5,34,17,10,13,11,16,54,29.6,38,29,1,28,11,45,8,0
Wilfried Singo,CIV,DF,22,Monaco,Ligue 1,24.3,34,25,18,14,2,17,26,65.4,9,27,14,13,51,85,81,2
Denis Zakaria,SUI,"MF,DF",26,Monaco,Ligue 1,23.7,38,27,11,20,7,12,30,40.0,18,39,13,26,47,85,41,0
Philipp Köhn,SUI,GK,25,Monaco,Ligue 1,22.0,1,1,1,0,0,1,1,100.0,0,0,0,0,1,2,5,3
Guillermo Maripán,CHI,DF,29,Monaco,Ligue 1,19.6,22,8,15,6,1,10,27,37.0,17,26,13,13,30,52,106,4
Vanderson,BRA,DF,22,Monaco,Ligue 1,18.2,60,41,20,30,10,32,70,45.7,38,29,2,27,35,95,37,1
Folarin Balogun,USA,FW,22,Monaco,Ligue 1,18.8,12,4,3,8,1,5,13,38.5,8,10,0,10,3,15,4,0
Maghnes Akliouche,FRA,"MF,FW",21,Monaco,Ligue 1,17.9,37,23,12,20,5,12,36,33.3,24,21,0,21,9,46,3,0
Ismail Jakobs,SEN,DF,23,Monaco,Ligue 1,16.3,57,41,27,21,9,29,47,61.7,18,19,2,17,11,68,40,0
Soungoutou Magassa,FRA,"DF,MF",19,Monaco,Ligue 1,15.0,56,26,22,32,2,26,48,54.2,22,21,4,17,21,77,36,2
Thilo Kehrer,GER,DF,26,Monaco,Ligue 1,14.7,32,22,22,7,3,22,39,56.4,17,18,6,12,30,62,55,0
Mohamed Camara,MLI,MF,23,Monaco,Ligue 1,11.5,35,21,10,20,5,15,29,51.7,14,8,2,6,11,46,7,0
Krépin Diatta,SEN,"DF,FW",24,Monaco,Ligue 1,13.4,37,20,17,16,4,27,49,55.1,22,17,2,15,16,53,22,0
Radosław Majecki,POL,GK,23,Monaco,Ligue 1,12.0,0,0,0,0,0,0,0,0.0,0,1,0,1,0,0,5,1
Mohammed Salisu,GHA,DF,24,Monaco,Ligue 1,11.5,27,12,11,13,3,17,26,65.4,9,21,12,9,22,49,44,0
Kassoum Ouattara,FRA,"DF,FW",18,Monaco,Ligue 1,7.1,17,12,8,5,4,9,20,45.0,11,11,0,11,13,30,20,0
Caio Henrique Oliveira Silva,BRA,DF,26,Monaco,Ligue 1,6.9,13,7,3,7,3,6,9,66.7,3,8,2,6,6,19,9,0
Eliesse Ben Seghir,MAR,"MF,FW",18,Monaco,Ligue 1,4.8,9,6,2,5,2,3,7,42.9,4,6,0,6,2,11,2,0
Chrislain Matsima,FRA,DF,21,Monaco,Ligue 1,3.3,9,7,5,3,1,2,7,28.6,5,4,1,3,4,13,4,0
Breel Embolo,SUI,FW,26,Monaco,Ligue 1,2.0,3,3,0,2,1,1,4,25.0,3,1,0,1,1,4,2,0
Mamadou Coulibaly,FRA,MF,19,Monaco,Ligue 1,1.3,7,4,2,3,2,3,8,37.5,5,4,0,4,0,7,0,0
Edan Diop,FRA,"MF,DF",18,Monaco,Ligue 1,1.8,10,8,6,3,1,7,9,77.8,2,3,0,3,1,11,5,0
Eliot Matazo,BEL,MF,21,Monaco,Ligue 1,1.1,3,1,0,3,0,2,4,50.0,2,1,1,0,3,6,0,0
Myron Boadu,NED,FW,22,Monaco,Ligue 1,0.9,2,2,0,1,1,1,2,50.0,1,2,0,2,0,2,0,0
Saïmon Bouabré,FRA,MF,17,Monaco,Ligue 1,0.5,2,2,0,2,0,1,2,50.0,1,1,0,1,0,2,0,0
Antonin Cartillier,FRA,DF,19,Monaco,Ligue 1,0.1,0,0,0,0,0,0,0,0.0,0,1,0,1,0,0,0,0
Lucas Michel,FRA,FW,19,Monaco,Ligue 1,0.1,0,0,0,0,0,0,0,0.0,0,0,0,0,0,0,0,0
Brendan Chardonnet,FRA,DF,28,Brest,Ligue 1,33.0,57,34,33,22,2,32,63,50.8,31,58,34,24,53,110,139,3
Kenny Lala,MAD,DF,31,Brest,Ligue 1,33.0,78,51,39,28,11,30,56,53.6,26,27,6,21,28,106,75,1
Bradley Locko,FRA,DF,21,Brest,Ligue 1,32.9,97,55,57,34,6,47,80,58.8,33,28,1,27,40,137,69,0
Marco Bizot,NED,GK,32,Brest,Ligue 1,32.0,0,0,0,0,0,0,1,0.0,1,0,0,0,0,0,18,3
Lilian Brassier,FRA,DF,23,Brest,Ligue 1,29.7,31,18,18,13,0,12,24,50.0,12,28,21,7,41,72,93,0
Romain Del Castillo,FRA,FW,27,Brest,Ligue 1,27.7,46,29,14,18,14,18,70,25.7,52,33,1,32,9,55,8,0
Hugo Magnetti,FRA,MF,25,Brest,Ligue 1,26.0,49,27,18,26,5,24,58,41.4,34,19,1,18,18,67,18,0
Pierre Lees-Melou,FRA,MF,30,Brest,Ligue 1,28.0,96,67,51,41,4,49,129,38.0,80,61,11,50,43,139,64,3
Mahdi Camara,FRA,MF,25,Brest,Ligue 1,22.4,55,39,8,40,7,20,49,40.8,29,24,1,23,27,82,19,0
Martin Satriano,URU,FW,22,Brest,Ligue 1,20.7,24,16,6,13,5,10,25,40.0,15,19,7,12,7,31,28,0
Steve Mounié,BEN,FW,28,Brest,Ligue 1,19.7,8,7,0,3,5,3,11,27.3,8,13,3,10,2,10,18,0
Jérémy Le Douaron,FRA,FW,25,Brest,Ligue 1,18.0,21,10,7,9,5,11,26,42.3,15,14,1,13,2,23,10,0
Mathias Pereira Lage,POR,"FW,MF",26,Brest,Ligue 1,13.2,21,15,7,8,6,7,28,25.0,21,14,5,9,10,31,13,0
Jonas Martin,FRA,MF,33,Brest,Ligue 1,13.4,43,27,17,24,2,21,36,58.3,15,16,2,14,9,52,28,2
Kamory Doumbia,MLI,MF,20,Brest,Ligue 1,9.8,28,18,8,10,10,10,29,34.5,19,14,0,14,9,37,6,0
Julien Le Cardinal,FRA,DF,25,Brest,Ligue 1,5.3,19,11,11,7,1,8,12,66.7,4,6,3,3,13,32,26,0
Grégoire Coudert,FRA,GK,24,Brest,Ligue 1,2.0,0,0,0,0,0,0,0,0.0,0,0,0,0,0,0,0,0
Bilal Brahimi,ALG,"FW,MF",23,Brest,Ligue 1,2.5,0,0,0,0,0,0,3,0.0,3,3,0,3,0,0,0,0
Achraf Dari,MAR,"DF,FW",24,Brest,Ligue 1,1.3,1,1,1,0,0,0,2,0.0,2,2,0,2,5,6,9,1
Jordan Amavi,FRA,DF,29,Brest,Ligue 1,1.0,1,1,0,1,0,1,3,33.3,2,2,1,1,3,4,2,0
Axel Camblan,FRA,FW,19,Brest,Ligue 1,1.0,3,1,0,2,1,2,4,50.0,2,2,0,2,0,3,0,0
Adrien Lebeau,FRA,"MF,FW",24,Brest,Ligue 1,0.6,0,0,0,0,0,0,3,0.0,3,2,1,1,0,0,1,0
Karamoko Dembele,SCO,"MF,FW",20,Brest,Ligue 1,0.2,0,0,0,0,0,0,0,0.0,0,0,0,0,0,0,0,0
Luc Zogbé,CIV,DF,18,Brest,Ligue 1,0.1,0,0,0,0,0,0,1,0.0,1,1,1,0,1,1,0,0
Hianga Mananga Mbock,FRA,"MF,FW",23,Brest,Ligue 1,0.1,1,0,0,0,1,1,2,50.0,1,0,0,0,1,2,0,0
Lucas Chevalier,FRA,GK,21,Lille,Ligue 1,33.0,3,0,3,0,0,3,4,75.0,1,1,0,1,0,3,11,2
Leny Yoro,FRA,DF,17,Lille,Ligue 1,29.7,36,25,27,7,2,17,31,54.8,14,20,14,6,36,72,97,1
Jonathan David,CAN,FW,23,Lille,Ligue 1,29.2,26,15,6,13,7,8,26,30.8,18,16,0,16,9,35,4,0
Angel Gomes,ENG,MF,22,Lille,Ligue 1,28.6,26,13,4,15,7,14,32,43.8,18,23,6,17,18,44,28,1
Benjamin André,FRA,MF,32,Lille,Ligue 1,28.6,89,49,39,45,5,43,81,53.1,38,34,5,29,35,124,60,0
Ismaily,BRA,DF,33,Lille,Ligue 1,27.4,72,47,34,25,13,31,60,51.7,29,33,6,27,32,104,77,0
Tiago santos,POR,DF,21,Lille,Ligue 1,26.3,63,42,31,19,13,30,52,57.7,22,24,5,19,15,78,37,0
Edon Zhegrova,KVX,FW,24,Lille,Ligue 1,25.4,32,18,9,15,8,14,36,38.9,22,17,1,16,8,40,8,0
Alexsandro Ribeiro,BRA,DF,23,Lille,Ligue 1,24.7,32,22,24,8,0,16,31,51.6,15,25,15,10,35,67,116,5
Nabil Bentaleb,ALG,MF,28,Lille,Ligue 1,21.9,49,32,29,18,2,22,43,51.2,21,33,12,21,37,86,33,0
Bafodé Diakité,FRA,DF,22,Lille,Ligue 1,18.8,29,20,12,15,2,24,32,75.0,8,16,8,8,21,50,49,1
Yusuf Yazıcı,TUR,"MF,FW",26,Lille,Ligue 1,14.6,19,11,6,9,4,4,15,26.7,11,10,1,9,5,24,5,0
Hákon Arnar Haraldsson,ISL,"FW,MF",20,Lille,Ligue 1,14.3,12,8,4,7,1,5,21,23.8,16,7,2,5,3,15,5,0
Rémy Cabella,FRA,"FW,MF",33,Lille,Ligue 1,16.4,54,36,19,20,15,20,54,37.0,34,32,0,32,5,59,5,0
Gabriel Gudmundsson,SWE,"DF,FW",24,Lille,Ligue 1,14.1,22,16,7,13,2,12,20,60.0,8,14,3,11,15,37,25,0
Ivan Cavaleiro,POR,FW,29,Lille,Ligue 1,8.6,10,6,3,4,3,7,20,35.0,13,9,2,7,5,15,6,0
Adam Ounas,ALG,FW,26,Lille,Ligue 1,4.6,4,3,2,2,0,2,7,28.6,5,2,0,2,6,10,1,0
Samuel Umtiti,FRA,DF,29,Lille,Ligue 1,2.1,1,1,0,1,0,1,4,25.0,3,0,0,0,2,3,4,0
Ayyoub Bouaddi,FRA,MF,15,Lille,Ligue 1,1.5,6,2,6,0,0,2,5,40.0,3,2,0,2,1,7,3,0
Vito Mannone,ITA,GK,35,Lille,Ligue 1,1.0,0,0,0,0,0,0,0,0.0,0,0,0,0,0,0,0,0
Alan Virginius,FRA,FW,20,Lille,Ligue 1,0.8,1,1,1,0,0,0,1,0.0,1,0,0,0,0,1,0,0
Carlos Baleba,CMR,MF,19,Lille,Ligue 1,0.7,6,2,1,4,1,3,4,75.0,1,0,0,0,2,8,0,0
Ignacio Miramon,ARG,MF,20,Lille,Ligue 1,0.4,1,0,0,1,0,0,1,0.0,1,1,0,1,0,1,0,0
Tiago Fonseca Morais,POR,FW,19,Lille,Ligue 1,0.5,1,1,0,1,0,0,0,0.0,0,0,0,0,1,2,0,0
Trévis Dago,CIV,"FW,MF",18,Lille,Ligue 1,0.3,0,0,0,0,0,0,0,0.0,0,0,0,0,1,1,0,0
Andrej Ilic,SRB,FW,23,Lille,Ligue 1,0.1,0,0,0,0,0,0,0,0.0,0,0,0,0,0,0,0,0
Ichem Ferrah,FRA,FW,17,Lille,Ligue 1,0.0,0,0,0,0,0,0,0,0.0,0,0,0,0,0,0,0,0
Aaron Malouda,FRA,FW,17,Lille,Ligue 1,0.0,0,0,0,0,0,0,0,0.0,0,0,0,0,0,0,0,0
Marcin Bułka,POL,GK,23,Nice,Ligue 1,34.0,0,0,0,0,0,0,2,0.0,2,0,0,0,0,0,9,3
Dante,BRA,DF,39,Nice,Ligue 1,31.6,62,30,44,16,2,38,52,73.1,14,43,22,21,37,99,77,2
Melvin Bard,FRA,DF,22,Nice,Ligue 1,29.5,69,38,28,30,11,37,63,58.7,26,46,12,34,42,111,46,0
Jean-Clair Todibo,FRA,DF,23,Nice,Ligue 1,29.5,58,28,35,17,6,34,56,60.7,22,34,15,19,38,96,97,1
Khéphren Thuram,FRA,MF,22,Nice,Ligue 1,23.4,42,29,13,23,6,20,40,50.0,20,21,10,11,18,60,37,0
Jeremie Boga,CIV,FW,26,Nice,Ligue 1,22.2,18,7,6,10,2,10,20,50.0,10,26,2,24,8,26,4,0
Morgan Sanson,FRA,MF,28,Nice,Ligue 1,21.8,26,19,12,7,7,12,31,38.7,19,34,5,29,20,46,16,0
Terem Moffi,NGA,FW,24,Nice,Ligue 1,21.7,7,4,0,5,2,3,12,25.0,9,14,1,13,3,10,15,0
Gaëtan Laborde,FRA,"FW,MF",29,Nice,Ligue 1,21.2,18,12,8,4,6,11,30,36.7,19,20,2,18,6,24,8,1
Pablo Rosario,NED,"MF,DF",26,Nice,Ligue 1,22.3,36,25,15,16,5,23,34,67.6,11,27,13,14,29,65,39,0
Jordan Lotomba,SUI,DF,24,Nice,Ligue 1,20.0,36,28,18,9,9,25,35,71.4,10,30,9,21,16,52,26,1
Youssouf Ndayishimiye,BDI,"MF,DF",24,Nice,Ligue 1,19.0,31,20,17,12,2,12,23,52.2,11,19,11,8,12,43,47,1
Hicham Boudaoui,ALG,MF,23,Nice,Ligue 1,17.9,41,19,16,22,3,21,30,70.0,9,15,1,14,11,52,15,0
Evann Guessand,FRA,FW,22,Nice,Ligue 1,17.3,16,7,2,7,7,6,7,85.7,1,12,1,11,12,28,7,0
Mohamed Ali Cho,FRA,FW,19,Nice,Ligue 1,9.6,12,9,4,7,1,3,11,27.3,8,10,0,10,3,15,6,0
Sofiane Diop,FRA,FW,23,Nice,Ligue 1,5.5,8,6,3,4,1,4,10,40.0,6,4,0,4,3,11,3,0
Youcef Atal,ALG,DF,27,Nice,Ligue 1,4.0,9,3,6,2,1,6,8,75.0,2,7,1,6,4,13,1,0
Alexis Claude-Maurice,FRA,MF,25,Nice,Ligue 1,5.6,12,5,3,6,3,1,5,20.0,4,4,1,3,5,17,7,0
Antoine Mendy,FRA,DF,19,Nice,Ligue 1,4.6,7,5,4,3,0,3,7,42.9,4,4,1,3,8,15,16,0
Tom Louchet,FRA,"MF,DF",20,Nice,Ligue 1,4.5,14,5,6,6,2,7,11,63.6,4,7,3,4,3,17,9,0
Romain Perraud,FRA,"DF,FW",25,Nice,Ligue 1,4.1,7,6,5,1,1,4,11,36.4,7,4,0,4,6,13,15,1
Badredine Bouanani,ALG,FW,18,Nice,Ligue 1,1.8,3,2,1,1,1,3,4,75.0,1,5,0,5,3,6,0,0
Aliou Badara Baldé,SEN,"FW,DF",20,Nice,Ligue 1,0.8,4,1,0,3,1,1,1,100.0,0,2,1,1,3,7,0,0
Valentin Rosier,FRA,"DF,MF",26,Nice,Ligue 1,0.6,1,0,1,0,0,0,0,0.0,0,1,0,1,2,3,5,0
Reda Belahyane,FRA,MF,19,Nice,Ligue 1,0.3,1,0,0,1,0,1,1,100.0,0,0,0,0,0,1,0,0
Daouda Traoré,FRA,MF,17,Nice,Ligue 1,0.2,0,0,0,0,0,0,0,0.0,0,0,0,0,0,0,0,0
Bilal Brahimi,ALG,FW,23,Nice,Ligue 1,0.1,0,0,0,0,0,0,1,0.0,1,0,0,0,0,0,0,0
Maxence Caqueret,FRA,MF,23,Lyon,Ligue 1,33.6,91,64,39,37,15,38,107,35.5,69,40,9,31,48,139,26,2
Anthony Lopes,POR,GK,32,Lyon,Ligue 1,31.0,0,0,0,0,0,0,0,0.0,0,0,0,0,0,0,16,0
Jake O'Brien,IRL,DF,22,Lyon,Ligue 1,26.3,22,16,16,5,1,14,20,70.0,6,23,18,5,12,34,98,1
Alexandre Lacazette,FRA,FW,32,Lyon,Ligue 1,25.5,19,12,8,9,2,5,17,29.4,12,22,3,19,8,27,9,0
Clinton Mata,ANG,DF,30,Lyon,Ligue 1,24.7,43,24,29,8,6,23,40,57.5,17,35,16,19,40,83,61,0
Nicolás Tagliafico,ARG,DF,30,Lyon,Ligue 1,23.6,54,34,23,22,9,22,49,44.9,27,25,8,17,28,82,43,0
Duje Ćaleta-Car,CRO,DF,26,Lyon,Ligue 1,22.1,26,11,19,6,1,18,22,81.8,4,27,14,13,18,44,94,1
Ernest Nuamah,GHA,"FW,MF",19,Lyon,Ligue 1,20.4,28,14,18,6,4,12,38,31.6,26,15,1,14,8,36,9,0
Corentin Tolisso,FRA,MF,28,Lyon,Ligue 1,19.3,33,21,13,11,9,14,33,42.4,19,26,9,17,10,43,18,0
Rayan Cherki,FRA,"MF,FW",19,Lyon,Ligue 1,19.1,28,15,4,16,8,17,46,37.0,29,13,3,10,7,35,1,0
Ainsley Maitland-Niles,ENG,"DF,MF",25,Lyon,Ligue 1,15.9,34,18,12,14,8,19,37,51.4,18,16,6,10,17,51,29,1
Nemanja Matić,SRB,MF,34,Lyon,Ligue 1,13.9,17,11,8,7,2,9,19,47.4,10,17,6,11,16,33,17,1
Sinaly Diomande,CIV,DF,22,Lyon,Ligue 1,9.9,10,4,5,3,2,9,16,56.3,7,12,9,3,15,25,26,1
Saïd Benrahma,ALG,"FW,MF",27,Lyon,Ligue 1,8.6,9,7,1,6,2,5,7,71.4,2,7,0,7,1,10,3,0
Sael Kumbedi,FRA,DF,18,Lyon,Ligue 1,10.3,30,20,14,12,4,9,22,40.9,13,12,3,9,14,44,18,2
Dejan Lovren,CRO,DF,34,Lyon,Ligue 1,8.0,9,7,6,3,0,3,7,42.9,4,6,5,1,12,21,37,0
Henrique,BRA,DF,29,Lyon,Ligue 1,6.7,10,6,6,4,0,6,11,54.5,5,8,2,6,10,20,3,0
Skelly Alvero,FRA,MF,21,Lyon,Ligue 1,4.7,8,7,5,2,1,2,9,22.2,7,5,1,4,2,10,5,0
Gift Orban,NGA,FW,21,Lyon,Ligue 1,5.3,4,3,0,1,3,1,4,25.0,3,2,0,2,1,5,2,1
Malick Fofana,BEL,FW,18,Lyon,Ligue 1,6.2,5,4,3,1,1,4,9,44.4,5,3,0,3,5,10,9,0
Mama Samba Baldé,GNB,"FW,MF",27,Lyon,Ligue 1,6.1,8,5,1,2,5,3,9,33.3,6,0,0,0,3,11,1,1
Orel Mangala,BEL,MF,25,Lyon,Ligue 1,4.4,5,3,0,2,3,1,3,33.3,2,3,2,1,5,10,6,0
Mahamadou Diawara,FRA,MF,18,Lyon,Ligue 1,4.0,9,6,4,5,0,3,11,27.3,8,4,1,3,4,13,4,0
Paul Akouokou,CIV,MF,25,Lyon,Ligue 1,3.4,14,9,2,10,2,6,7,85.7,1,5,1,4,6,20,11,0
Diego Moreira,POR,"FW,MF",18,Lyon,Ligue 1,3.0,0,0,0,0,0,0,3,0.0,3,3,0,3,2,2,5,0
Jeffinho,BRA,"FW,MF",23,Lyon,Ligue 1,3.4,11,4,3,5,3,4,11,36.4,7,1,0,1,0,11,0,0
Bradley Barcola,FRA,FW,20,Lyon,Ligue 1,3.0,5,2,0,2,3,1,7,14.3,6,4,0,4,2,7,0,0
Rémy Riou,FRA,GK,35,Lyon,Ligue 1,3.0,0,0,0,0,0,0,1,0.0,1,0,0,0,0,0,1,1
Tino Kadewere,ZIM,"FW,MF",27,Lyon,Ligue 1,3.3,1,1,0,1,0,1,5,20.0,4,3,1,2,5,6,7,0
Johann Lepenant,FRA,MF,20,Lyon,Ligue 1,2.8,4,3,2,2,0,1,8,12.5,7,5,0,5,4,8,0,0
Amin Sarr,SWE,"FW,MF",22,Lyon,Ligue 1,1.1,1,0,0,1,0,0,0,0.0,0,1,0,1,0,1,1,0
Chaim El Djebali,TUN,MF,19,Lyon,Ligue 1,0.1,0,0,0,0,0,0,0,0.0,0,0,0,0,0,0,0,0
Mamadou Sarr,FRA,DF,17,Lyon,Ligue 1,0.1,0,0,0,0,0,0,0,0.0,0,0,0,0,0,0,0,0
Adryelson,BRA,"DF,FW",25,Lyon,Ligue 1,0.1,0,0,0,0,0,0,0,0.0,0,0,0,0,1,1,3,0
Mohamed El Arouch,FRA,FW,19,Lyon,Ligue 1,0.0,0,0,0,0,0,0,0,0.0,0,0,0,0,0,0,0,0
Brice Samba,FRA,GK,29,Lens,Ligue 1,33.0,1,1,1,0,0,1,1,100.0,0,0,0,0,0,1,10,3
Facundo Medina,ARG,DF,24,Lens,Ligue 1,30.2,64,38,25,31,8,44,69,63.8,25,38,13,25,24,88,59,2
Kevin Danso,AUT,DF,24,Lens,Ligue 1,29.5,24,14,12,11,1,15,30,50.0,15,43,30,13,23,47,115,1
Florian Sotoca,FRA,"MF,FW",32,Lens,Ligue 1,28.9,33,22,9,21,3,17,38,44.7,21,41,4,37,20,53,34,0
Jonathan Gradit,FRA,DF,30,Lens,Ligue 1,23.5,32,20,15,14,3,19,35,54.3,16,30,17,13,37,69,61,0
Przemysław Frankowski,POL,DF,28,Lens,Ligue 1,24.4,60,39,25,26,9,31,74,41.9,43,30,7,23,25,85,36,0
Ruben Aguilar,FRA,DF,30,Lens,Ligue 1,21.4,53,31,27,23,3,27,45,60.0,18,35,5,30,26,79,46,0
Elye Wahi,FRA,FW,20,Lens,Ligue 1,18.8,6,4,1,3,2,2,10,20.0,8,5,1,4,3,9,3,0
Neil El Aynaoui,FRA,MF,22,Lens,Ligue 1,17.4,37,20,13,20,4,20,46,43.5,26,20,6,14,32,69,21,1
Salis Abdul Samed,GHA,MF,23,Lens,Ligue 1,16.9,21,14,8,10,3,8,18,44.4,10,12,1,11,12,33,18,0
David Pereira da Costa,POR,MF,22,Lens,Ligue 1,16.6,18,10,5,12,1,10,23,43.5,13,21,4,17,16,34,8,1
Angelo Fulgini,FRA,MF,26,Lens,Ligue 1,15.3,23,14,6,13,4,11,19,57.9,8,22,1,21,8,31,11,0
Andy Diouf,FRA,MF,20,Lens,Ligue 1,14.6,28,19,12,11,5,14,22,63.6,8,13,3,10,3,31,5,1
Adrien Thomasson,FRA,MF,29,Lens,Ligue 1,13.3,25,14,4,16,5,11,34,32.4,23,14,0,14,9,34,10,1
Deiver Machado,COL,DF,29,Lens,Ligue 1,12.5,24,18,10,10,4,15,20,75.0,5,13,2,11,7,31,8,0
Nampalys Mendy,SEN,MF,31,Lens,Ligue 1,11.7,29,18,10,13,6,16,20,80.0,4,11,4,7,14,43,14,1
Wesley Saïd,FRA,"FW,MF",28,Lens,Ligue 1,11.3,8,4,1,2,5,2,9,22.2,7,4,0,4,4,12,3,0
Abduqodir Xusanov,UZB,DF,19,Lens,Ligue 1,9.0,21,12,13,8,0,9,17,52.9,8,13,8,5,13,34,32,2
Massadio Haïdara,MLI,DF,30,Lens,Ligue 1,8.2,9,8,5,3,1,4,6,66.7,2,7,2,5,11,20,32,3
Jhoanner Chávez,ECU,DF,21,Lens,Ligue 1,5.3,6,5,2,2,2,3,9,33.3,6,2,0,2,5,11,11,0
Morgan Guilavogui,GUI,"FW,MF",25,Lens,Ligue 1,6.3,21,10,4,12,5,5,11,45.5,6,11,2,9,4,25,7,0
Stijn Spierings,NED,MF,27,Lens,Ligue 1,1.3,1,0,0,1,0,1,1,100.0,0,2,1,1,2,3,1,0
Jean-Louis Leca,FRA,GK,37,Lens,Ligue 1,1.0,0,0,0,0,0,0,0,0.0,0,0,0,0,0,0,1,0
Faitout Maouassa,FRA,"MF,DF",25,Lens,Ligue 1,0.8,1,1,1,0,0,1,1,100.0,0,1,0,1,0,1,3,0
Ayanda Sishuba,BEL,"MF,FW",18,Lens,Ligue 1,0.7,3,1,0,2,1,1,2,50.0,1,1,0,1,0,3,0,0
Julien Le Cardinal,FRA,DF,25,Lens,Ligue 1,0.6,6,2,4,2,0,4,9,44.4,5,2,1,1,0,6,0,0
Oscar Cortés,COL,"FW,MF",19,Lens,Ligue 1,0.5,0,0,0,0,0,0,0,0.0,0,1,0,1,0,0,0,0
Pau López,ESP,GK,28,Marseille,Ligue 1,32.7,0,0,0,0,0,0,2,0.0,2,0,0,0,0,0,10,1
Pierre-Emerick Aubameyang,GAB,FW,34,Marseille,Ligue 1,29.1,22,14,4,11,7,7,26,26.9,19,30,5,25,9,31,26,0
Leonardo Balerdi,ARG,DF,24,Marseille,Ligue 1,25.2,79,50,55,23,1,49,67,73.1,18,38,15,23,51,130,91,0
Chancel Mbemba,COD,DF,28,Marseille,Ligue 1,24.5,33,21,25,7,1,17,30,56.7,13,21,13,8,13,46,95,1
Jonathan Clauss,FRA,DF,30,Marseille,Ligue 1,23.0,47,20,22,19,6,26,49,53.1,23,17,3,14,36,83,46,0
Jordan Veretout,FRA,MF,30,Marseille,Ligue 1,24.3,38,22,19,13,6,18,39,46.2,21,20,4,16,13,51,25,0
Amine Harit,MAR,"MF,FW",26,Marseille,Ligue 1,20.2,28,16,8,17,3,13,37,35.1,24,31,4,27,12,40,4,0
Samuel Gigot,FRA,DF,29,Marseille,Ligue 1,19.2,33,22,16,13,4,13,19,68.4,6,28,18,10,25,58,93,1
Iliman Ndiaye,SEN,"FW,MF",23,Marseille,Ligue 1,18.0,21,18,5,11,5,11,29,37.9,18,14,2,12,6,27,6,0
Geoffrey Kondogbia,CTA,MF,30,Marseille,Ligue 1,16.3,48,31,18,25,5,13,32,40.6,19,21,4,17,30,78,25,0
Ismaila Sarr,SEN,"FW,MF",25,Marseille,Ligue 1,16.1,14,8,2,10,2,6,17,35.3,11,21,6,15,13,27,11,0
Azzedine Ounahi,MAR,MF,23,Marseille,Ligue 1,13.4,25,11,9,14,2,11,32,34.4,21,6,1,5,11,36,8,0
Renan Lodi,BRA,DF,25,Marseille,Ligue 1,13.7,24,16,8,13,3,13,21,61.9,8,7,2,5,16,40,35,0
Michael Amir Murillo,PAN,DF,27,Marseille,Ligue 1,11.1,23,11,13,6,4,15,23,65.2,8,9,2,7,11,34,34,2
Vitinha,POR,FW,23,Marseille,Ligue 1,10.3,14,8,3,5,6,3,12,25.0,9,11,2,9,5,19,8,0
Ulisses Garcia,SUI,DF,27,Marseille,Ligue 1,10.1,21,16,6,13,2,13,20,65.0,7,8,3,5,7,28,13,2
Valentin Rongier,FRA,MF,28,Marseille,Ligue 1,9.5,23,12,9,12,2,14,26,53.8,12,16,4,12,15,38,18,0
Pape Gueye,SEN,"MF,DF",24,Marseille,Ligue 1,8.5,33,21,11,19,3,13,19,68.4,6,17,3,14,13,46,12,0
Luis Henrique,BRA,"FW,DF",21,Marseille,Ligue 1,8.7,8,7,4,1,3,4,7,57.1,3,9,0,9,8,16,3,0
Quentin Merlin,FRA,DF,21,Marseille,Ligue 1,7.8,13,12,7,5,1,8,20,40.0,12,4,0,4,6,19,14,0
Bamo Meïté,CIV,DF,21,Marseille,Ligue 1,7.1,16,10,13,3,0,8,12,66.7,4,11,5,6,11,27,35,0
Joaquín Correa,ARG,"FW,MF",28,Marseille,Ligue 1,4.8,7,5,4,2,1,0,8,0.0,8,2,0,2,1,8,1,0
Jean Onana,CMR,MF,23,Marseille,Ligue 1,6.3,23,14,6,14,3,13,25,52.0,12,10,2,8,11,34,11,1
Faris Pemi Moumbagna,CMR,FW,23,Marseille,Ligue 1,6.1,2,1,0,2,0,0,3,0.0,3,4,0,4,3,5,1,0
François Mughe,CMR,"MF,DF",19,Marseille,Ligue 1,2.0,0,0,0,0,0,0,3,0.0,3,2,0,2,1,1,1,0
Rubén Blanco,ESP,GK,28,Marseille,Ligue 1,1.3,0,0,0,0,0,0,0,0.0,0,0,0,0,0,0,0,0
Bilal Nadir,FRA,"MF,FW",19,Marseille,Ligue 1,1.3,4,3,2,2,0,1,2,50.0,1,0,0,0,2,6,2,0
Emran Soglo,ENG,"MF,DF",18,Marseille,Ligue 1,1.2,2,1,0,2,0,1,3,33.3,2,6,0,6,1,3,3,0
Raimane Daou,COM,"DF,MF",18,Marseille,Ligue 1,0.3,1,1,1,0,0,1,2,50.0,1,0,0,0,0,1,2,0
Mattéo Guendouzi,FRA,MF,24,Marseille,Ligue 1,0.2,0,0,0,0,0,0,0,0.0,0,1,1,0,0,0,0,0
Sofiane Sidi Ali,FRA,MF,28,Marseille,Ligue 1,0.2,2,0,0,2,0,1,2,50.0,1,1,0,1,2,4,0,0
Keyliane Abdallah,FRA,FW,17,Marseille,Ligue 1,0.0,0,0,0,0,0,0,0,0.0,0,0,0,0,0,0,0,0
Noam Mayoka-Tika,BEL,MF,19,Marseille,Ligue 1,0.0,0,0,0,0,0,0,0,0.0,0,0,0,0,0,0,0,0
Yehvann Diouf,FRA,GK,23,Reims,Ligue 1,34.0,0,0,0,0,0,0,1,0.0,1,0,0,0,1,1,19,3
Yunis Abdelhamid,MAR,DF,35,Reims,Ligue 1,30.9,64,35,36,23,5,26,45,57.8,19,51,32,19,39,103,109,2
Junya Ito,JPN,"FW,MF",30,Reims,Ligue 1,30.2,33,15,11,14,8,10,36,27.8,26,23,1,22,14,47,7,0
Emmanuel Agbadou,CIV,DF,26,Reims,Ligue 1,28.8,65,41,38,23,4,44,64,68.8,20,47,25,22,55,120,116,1
Marshall Munetsi,ZIM,MF,27,Reims,Ligue 1,24.1,61,39,18,34,9,33,61,54.1,28,21,7,14,14,75,33,0
Teddy Teuma,MLT,MF,29,Reims,Ligue 1,23.5,54,36,19,21,14,25,62,40.3,37,33,4,29,20,74,6,0
Thomas Foket,BEL,DF,28,Reims,Ligue 1,20.4,32,17,21,8,3,20,45,44.4,25,34,12,22,25,57,36,0
Thibault De Smet,BEL,DF,25,Reims,Ligue 1,20.3,56,35,36,16,4,33,59,55.9,26,25,5,20,21,77,51,1
Joseph Okumu,KEN,DF,26,Reims,Ligue 1,19.4,44,28,28,14,2,24,38,63.2,14,27,19,8,35,79,112,2
Mohammed Daramy,DEN,"FW,MF",21,Reims,Ligue 1,18.3,10,9,4,4,2,6,16,37.5,10,5,1,4,4,14,4,0
Oumar Diakité,CIV,FW,19,Reims,Ligue 1,17.6,25,12,10,9,6,7,21,33.3,14,13,0,13,7,32,7,0
Keito Nakamura,JPN,"FW,MF",23,Reims,Ligue 1,15.3,28,11,9,10,9,17,37,45.9,20,15,2,13,6,34,7,0
Azor Matusiwa,NED,MF,25,Reims,Ligue 1,15.4,39,27,17,19,3,22,32,68.8,10,21,3,18,33,72,32,1
Reda Khadra,GER,"FW,MF",22,Reims,Ligue 1,15.2,16,10,5,4,7,8,20,40.0,12,8,2,6,3,19,13,0
Amir Richardson,MAR,MF,21,Reims,Ligue 1,15.0,33,23,12,18,3,10,22,45.5,12,26,5,21,15,48,30,0
Sergio Akieme,ESP,DF,25,Reims,Ligue 1,9.1,11,5,6,3,2,8,11,72.7,3,9,3,6,10,21,25,0
Valentin Atangana Edoa,FRA,MF,17,Reims,Ligue 1,6.2,19,13,6,9,4,5,13,38.5,8,5,1,4,6,25,9,0
Josh Wilson-Esbrand,ENG,"DF,MF",20,Reims,Ligue 1,5.1,5,4,2,3,0,2,8,25.0,6,5,2,3,6,11,7,0
Amadou Koné,MLI,MF,18,Reims,Ligue 1,5.3,13,8,11,2,0,6,10,60.0,4,8,3,5,10,23,10,0
Therence Koudou,FRA,DF,18,Reims,Ligue 1,3.5,2,2,1,1,0,0,2,0.0,2,4,3,1,4,6,9,0
Benjamin Stambouli,FRA,MF,32,Reims,Ligue 1,3.2,9,7,3,5,1,6,11,54.5,5,3,1,2,2,11,8,0
Abdoul Koné,FRA,DF,18,Reims,Ligue 1,2.1,7,7,5,2,0,4,11,36.4,7,2,0,2,2,9,9,0
Amine Salama,FRA,FW,23,Reims,Ligue 1,3.5,0,0,0,0,0,0,0,0.0,0,1,0,1,1,1,1,0
Mamadou Diakhon,FRA,"FW,MF",17,Reims,Ligue 1,2.3,5,3,2,1,2,3,9,33.3,6,1,0,1,1,6,1,0
Maxime Busi,BEL,"FW,DF",23,Reims,Ligue 1,1.8,2,0,0,1,1,0,2,0.0,2,6,1,5,4,6,5,0
Ibrahim Diakité,GUI,DF,19,Reims,Ligue 1,1.2,1,0,0,1,0,0,1,0.0,1,3,0,3,2,3,5,0
Adama Bojang,GAM,FW,19,Reims,Ligue 1,0.9,2,1,1,0,1,0,0,0.0,0,2,1,1,1,3,0,0
Yaya Kader Fofana,MLI,"MF,DF",19,Reims,Ligue 1,0.4,3,3,1,1,1,0,1,0.0,1,0,0,0,1,4,0,0
Christ Mbondi,FRA,FW,18,Reims,Ligue 1,0.0,1,1,1,0,0,1,1,100.0,0,0,0,0,0,1,0,0
Steve Mandanda,FRA,GK,38,Rennes,Ligue 1,34.0,2,0,2,0,0,2,4,50.0,2,0,0,0,0,2,6,1
Benjamin Bourigeaud,FRA,"MF,FW",29,Rennes,Ligue 1,26.9,31,18,14,9,8,13,44,29.5,31,31,2,29,22,53,39,2
Arthur Theate,BEL,DF,23,Rennes,Ligue 1,25.5,30,17,19,6,5,24,37,64.9,13,40,23,17,31,61,90,2
Arnaud Kalimuendo,FRA,FW,21,Rennes,Ligue 1,23.8,5,4,2,2,1,2,5,40.0,3,13,2,11,4,9,4,0
Adrien Truffert,FRA,DF,21,Rennes,Ligue 1,23.8,39,21,23,10,6,25,40,62.5,15,31,5,26,19,58,49,0
Amine Gouiri,ALG,"FW,MF",23,Rennes,Ligue 1,23.0,20,10,4,11,5,8,19,42.1,11,18,1,17,14,34,12,0
Warmed Omari,FRA,DF,23,Rennes,Ligue 1,23.0,32,19,23,7,2,16,28,57.1,12,30,20,10,33,65,77,2
Baptiste Santamaria,FRA,MF,28,Rennes,Ligue 1,21.4,52,33,21,25,6,29,46,63.0,17,15,6,9,34,86,33,1
Enzo Le Fée,FRA,MF,23,Rennes,Ligue 1,17.0,50,35,23,17,10,23,47,48.9,24,17,3,14,19,69,20,0
Martin Terrier,FRA,"FW,MF",26,Rennes,Ligue 1,17.0,14,9,3,8,3,6,14,42.9,8,21,4,17,9,23,17,0
Ludovic Blas,FRA,"FW,MF",25,Rennes,Ligue 1,17.4,30,14,16,13,1,12,28,42.9,16,13,1,12,6,36,9,0
Désiré Doué,FRA,"MF,FW",18,Rennes,Ligue 1,18.1,32,18,11,14,7,10,33,30.3,23,30,1,29,14,46,8,0
Jeanuël Belocian,FRA,DF,18,Rennes,Ligue 1,16.1,32,22,23,8,1,22,28,78.6,6,18,10,8,13,45,49,0
Christopher Wooh,CMR,DF,21,Rennes,Ligue 1,15.4,18,12,12,6,0,8,15,53.3,7,19,9,10,18,36,51,0
Guela Doué,CIV,DF,20,Rennes,Ligue 1,13.7,28,21,14,12,2,22,32,68.8,10,12,1,11,15,43,65,1
Lorenz Assignon,TOG,DF,23,Rennes,Ligue 1,11.2,24,12,12,8,4,9,24,37.5,15,9,4,5,9,33,27,1
Nemanja Matić,SRB,MF,34,Rennes,Ligue 1,11.4,19,10,7,9,3,9,12,75.0,3,15,7,8,27,46,19,0
Azor Matusiwa,NED,MF,25,Rennes,Ligue 1,8.8,7,3,3,4,0,4,7,57.1,3,9,2,7,11,18,17,0
Alidu Seidu,GHA,DF,23,Rennes,Ligue 1,6.6,21,9,17,3,1,14,19,73.7,5,11,3,8,10,31,13,0
Ibrahim Salah,MAR,"FW,MF",21,Rennes,Ligue 1,5.8,15,7,5,6,4,11,18,61.1,7,4,0,4,10,25,5,0
Bertuğ Yıldırım,TUR,FW,21,Rennes,Ligue 1,5.2,7,5,2,3,2,3,8,37.5,5,8,0,8,0,7,4,0
Fabian Rieder,SUI,MF,21,Rennes,Ligue 1,4.1,13,7,2,9,2,6,11,54.5,5,3,1,2,5,18,2,0
Jeremy Doku,BEL,FW,21,Rennes,Ligue 1,1.2,2,2,1,0,1,1,1,100.0,0,0,0,0,0,2,0,0
Mahamadou Nagida,CMR,DF,18,Rennes,Ligue 1,1.2,1,1,0,0,1,0,2,0.0,2,2,1,1,4,5,0,0
Lovro Majer,CRO,MF,25,Rennes,Ligue 1,0.2,0,0,0,0,0,0,0,0.0,0,0,0,0,0,0,1,0
Birger Meling,NOR,DF,28,Rennes,Ligue 1,0.2,1,1,1,0,0,1,1,100.0,0,1,0,1,0,1,0,0
Mathis Lambourde,FRA,FW,17,Rennes,Ligue 1,0.1,0,0,0,0,0,0,1,0.0,1,1,0,1,0,0,1,0
Jérémy Jacquet,FRA,MF,18,Rennes,Ligue 1,0.1,1,1,1,0,0,0,1,0.0,1,0,0,0,1,2,0,0
Djaoui Cissé,FRA,MF,19,Rennes,Ligue 1,0.0,0,0,0,0,0,0,0,0.0,0,0,0,0,0,0,0,0
Guillaume Restes,FRA,GK,18,Toulouse,Ligue 1,34.0,0,0,0,0,0,0,3,0.0,3,0,0,0,0,0,19,1
Rasmus Nicolaisen,DEN,DF,26,Toulouse,Ligue 1,32.5,50,30,39,11,0,26,44,59.1,18,44,33,11,42,92,158,1
Logan Costa,CPV,DF,22,Toulouse,Ligue 1,29.4,40,24,31,9,0,15,24,62.5,9,42,27,15,23,63,120,1
Thijs Dallinga,NED,FW,22,Toulouse,Ligue 1,27.9,29,15,6,11,12,9,15,60.0,6,11,4,7,3,32,35,0
Gabriel Suazo,CHI,DF,25,Toulouse,Ligue 1,26.2,66,32,40,19,7,38,86,44.2,48,37,4,33,26,92,33,0
Vincent Sierro,SUI,MF,27,Toulouse,Ligue 1,25.1,41,24,15,20,6,27,77,35.1,50,37,13,24,27,68,33,0
Cristian Cásseres Jr.,VEN,MF,23,Toulouse,Ligue 1,21.6,70,34,31,33,6,29,61,47.5,32,34,4,30,27,97,33,1
Aron Dønnum,NOR,"FW,MF",25,Toulouse,Ligue 1,17.7,16,10,3,8,5,7,22,31.8,15,13,0,13,8,24,16,1
Mikkel Desler,DEN,DF,28,Toulouse,Ligue 1,17.2,18,12,8,7,3,9,17,52.9,8,32,13,19,19,37,38,0
Stijn Spierings,NED,MF,27,Toulouse,Ligue 1,16.8,53,40,26,20,7,29,52,55.8,23,22,5,17,26,79,32,0
Moussa Diarra,MLI,DF,22,Toulouse,Ligue 1,15.5,32,12,16,15,1,13,27,48.1,14,30,14,16,20,52,43,0
Niklas Schmidt,GER,MF,25,Toulouse,Ligue 1,14.1,36,21,13,19,4,16,33,48.5,17,14,7,7,4,40,13,0
Frank Magri,CMR,"FW,MF",23,Toulouse,Ligue 1,16.0,22,14,5,12,5,15,21,71.4,6,16,4,12,4,26,17,0
Yann Gboho,FRA,"MF,FW",22,Toulouse,Ligue 1,13.3,14,4,6,6,2,8,23,34.8,15,21,1,20,4,18,2,0
Waren Kamanzi,NOR,"DF,FW",22,Toulouse,Ligue 1,13.2,36,24,16,16,4,13,23,56.5,10,11,3,8,9,45,35,0
Christian Mawissa,FRA,DF,18,Toulouse,Ligue 1,12.4,22,15,14,4,4,9,23,39.1,14,22,11,11,22,44,41,1
Gelabert,ESP,"MF,FW",22,Toulouse,Ligue 1,8.4,14,8,5,6,3,7,20,35.0,13,8,2,6,5,19,8,0
Zakaria Aboukhlal,MAR,"MF,FW",23,Toulouse,Ligue 1,8.4,9,8,1,5,3,3,12,25.0,9,9,1,8,1,10,2,0
Kévin Keben Biakolo,CMR,DF,19,Toulouse,Ligue 1,5.8,4,2,4,0,0,3,6,50.0,3,7,0,7,8,12,17,0
Denis Genreau,AUS,"MF,FW",24,Toulouse,Ligue 1,5.2,12,9,6,6,0,8,15,53.3,7,8,1,7,6,18,8,0
Shavy Babicka,GAB,"FW,MF",23,Toulouse,Ligue 1,4.1,11,8,2,7,2,2,5,40.0,3,6,1,5,0,11,2,0
Yanis Begraoui,MAR,"FW,MF",22,Toulouse,Ligue 1,3.3,5,3,1,3,1,3,9,33.3,6,4,0,4,5,10,5,0
Ibrahim Cissoko,NED,"FW,MF",20,Toulouse,Ligue 1,2.7,4,3,3,1,0,1,3,33.3,2,3,0,3,1,5,0,0
Naatan Skyttä,FIN,"MF,FW",21,Toulouse,Ligue 1,1.3,4,4,2,1,1,1,1,100.0,0,0,0,0,0,4,0,0
Mamady Bangré,BFA,"FW,MF",22,Toulouse,Ligue 1,1.1,4,2,2,2,0,3,4,75.0,1,0,0,0,4,8,3,0
Fares Chaïbi,ALG,"FW,MF",20,Toulouse,Ligue 1,0.6,0,0,0,0,0,0,0,0.0,0,0,0,0,0,0,2,0
Téji Savanier,FRA,MF,31,Montpellier,Ligue 1,30.7,37,20,16,15,6,14,63,22.2,49,36,8,28,33,70,28,1
Benjamin Lecomte,FRA,GK,32,Montpellier,Ligue 1,30.0,0,0,0,0,0,0,1,0.0,1,0,0,0,0,0,16,1
Joris Chotard,FRA,MF,21,Montpellier,Ligue 1,28.7,81,52,45,25,11,48,96,50.0,48,47,21,26,44,125,60,0
Akor Adams,NGA,FW,23,Montpellier,Ligue 1,25.0,12,4,3,4,5,3,7,42.9,4,9,2,7,5,17,11,0
Becir Omeragic,SUI,"DF,MF",21,Montpellier,Ligue 1,25.7,48,29,31,13,4,20,33,60.6,13,51,29,22,27,75,65,0
Musa Al-Taamari,JOR,FW,26,Montpellier,Ligue 1,21.4,20,16,10,5,5,9,21,42.9,12,18,2,16,4,24,5,0
Jordan Ferri,FRA,MF,31,Montpellier,Ligue 1,22.6,36,22,16,17,3,20,67,29.9,47,19,1,18,13,49,23,0
Boubakar Kouyaté,MLI,DF,26,Montpellier,Ligue 1,21.4,49,30,39,8,2,28,51,54.9,23,31,20,11,29,78,123,1
Issiaga Sylla,GUI,"DF,FW",29,Montpellier,Ligue 1,16.2,28,17,20,6,2,16,34,47.1,18,21,7,14,23,51,53,0
Falaye Sacko,MLI,DF,28,Montpellier,Ligue 1,15.4,28,16,13,10,5,21,32,65.6,11,19,7,12,24,52,37,0
Arnaud Nordin,FRA,"FW,MF",25,Montpellier,Ligue 1,13.8,12,6,3,5,4,6,16,37.5,10,11,0,11,2,14,10,0
Christopher Jullien,FRA,DF,30,Montpellier,Ligue 1,13.7,16,12,11,5,0,6,17,35.3,11,25,20,5,12,28,106,2
Wahbi Khazri,TUN,FW,32,Montpellier,Ligue 1,12.6,24,17,8,12,4,14,35,40.0,21,10,0,10,3,27,7,0
Modibo Sagnan,MLI,DF,24,Montpellier,Ligue 1,11.7,34,22,23,9,2,15,25,60.0,10,13,9,4,15,49,67,0
Maxime Estève,FRA,DF,21,Montpellier,Ligue 1,11.1,16,12,11,5,0,10,15,66.7,5,13,9,4,18,34,50,0
Lucas Mincarelli,FRA,"DF,MF",19,Montpellier,Ligue 1,10.9,29,16,19,6,4,17,34,50.0,17,17,4,13,8,37,27,0
Enzo Tchato,CMR,DF,20,Montpellier,Ligue 1,12.5,26,17,18,4,4,11,25,44.0,14,20,7,13,11,37,25,0
Khalil Fayad,FRA,"FW,MF",19,Montpellier,Ligue 1,11.4,28,15,17,7,4,9,22,40.9,13,15,3,12,14,42,6,0
Silvan Hefti,SUI,"DF,FW",25,Montpellier,Ligue 1,7.9,21,15,10,7,4,15,29,51.7,14,7,2,5,8,29,11,0
Tanguy Coulibaly,FRA,"FW,MF",22,Montpellier,Ligue 1,6.9,13,11,8,4,1,4,9,44.4,5,11,1,10,2,15,2,0
Dimitry Bertaud,COD,GK,25,Montpellier,Ligue 1,4.0,0,0,0,0,0,0,0,0.0,0,0,0,0,0,0,0,0
Léo Leroy,FRA,MF,23,Montpellier,Ligue 1,5.5,19,10,8,8,3,6,21,28.6,15,12,3,9,7,26,8,0
Théo Sainte-Luce,FRA,DF,24,Montpellier,Ligue 1,3.8,17,7,10,6,1,11,19,57.9,8,9,4,5,3,20,15,0
Yann Karamoh,FRA,"FW,MF",25,Montpellier,Ligue 1,3.2,1,0,0,0,1,1,2,50.0,1,3,0,3,0,1,0,0
Axel Gueguin,FRA,"DF,FW",18,Montpellier,Ligue 1,1.5,9,5,6,2,1,2,6,33.3,4,2,0,2,2,11,6,0
Othmane Maamma,FRA,FW,17,Montpellier,Ligue 1,1.0,3,3,2,0,1,1,1,100.0,0,3,0,3,0,3,0,0
Kelvin Yeboah,ITA,FW,23,Montpellier,Ligue 1,3.1,4,2,2,2,0,1,3,33.3,2,3,2,1,1,5,3,0
Sacha Delaye,FRA,"MF,FW",21,Montpellier,Ligue 1,1.4,7,2,2,2,3,1,6,16.7,5,2,0,2,0,7,1,0
Elye Wahi,FRA,FW,20,Montpellier,Ligue 1,0.2,0,0,0,0,0,0,0,0.0,0,0,0,0,0,0,0,0
Yanis Issoufou,FRA,MF,16,Montpellier,Ligue 1,0.1,0,0,0,0,0,0,0,0.0,0,0,0,0,0,0,0,0
Mamadou Sakho,FRA,DF,33,Montpellier,Ligue 1,0.1,1,1,1,0,0,1,1,100.0,0,0,0,0,0,1,1,0
Lucas Perrin,FRA,DF,24,Strasbourg,Ligue 1,30.3,47,30,33,14,0,28,46,60.9,18,45,32,13,28,75,113,0
Frederic Guilbert,FRA,"DF,MF",28,Strasbourg,Ligue 1,27.7,87,50,49,30,8,47,72,65.3,25,39,10,29,71,158,99,1
Habib Diarra,SEN,"MF,FW",19,Strasbourg,Ligue 1,25.6,30,23,8,20,2,9,33,27.3,24,23,4,19,17,47,15,0
Dilane Bakwa,FRA,"FW,MF",20,Strasbourg,Ligue 1,24.2,30,22,12,13,5,11,40,27.5,29,26,1,25,20,50,11,0
Thomas Delaine,FRA,"DF,MF",31,Strasbourg,Ligue 1,22.7,38,19,29,8,1,20,42,47.6,22,18,2,16,17,55,51,0
Marvin Senaya,TOG,"DF,MF",22,Strasbourg,Ligue 1,23.8,72,53,38,25,9,42,68,61.8,26,40,13,27,41,113,68,0
Emanuel Emegha,NED,FW,20,Strasbourg,Ligue 1,23.1,8,5,2,4,2,4,9,44.4,5,13,3,10,2,10,25,0
Abakar Sylla,CIV,DF,20,Strasbourg,Ligue 1,19.9,54,23,30,19,5,29,40,72.5,11,40,11,29,26,80,70,2
Matz Sels,BEL,GK,31,Strasbourg,Ligue 1,19.0,0,0,0,0,0,0,0,0.0,0,2,0,2,0,0,13,1
Ismaël Doukouré,FRA,"MF,DF",20,Strasbourg,Ligue 1,18.4,23,16,7,14,2,13,21,61.9,8,19,7,12,19,42,29,2
Ibrahima Sissoko,MLI,MF,25,Strasbourg,Ligue 1,18.2,47,33,13,25,9,23,30,76.7,7,21,8,13,19,66,30,0
Junior Mwanga,FRA,"MF,FW",20,Strasbourg,Ligue 1,16.1,40,20,23,12,5,12,24,50.0,12,20,5,15,18,58,19,0
Alaa Bellaarouch,MAR,GK,21,Strasbourg,Ligue 1,15.0,0,0,0,0,0,0,0,0.0,0,0,0,0,1,1,11,2
Kévin Gameiro,FRA,"FW,MF",36,Strasbourg,Ligue 1,15.0,10,10,5,3,2,2,17,11.8,15,9,0,9,3,13,7,0
Gerzino Nyamsi,FRA,DF,26,Strasbourg,Ligue 1,12.1,18,14,13,5,0,12,18,66.7,6,19,11,8,10,28,43,0
Angelo Borges,BRA,"FW,MF",18,Strasbourg,Ligue 1,12.2,24,11,9,7,8,11,31,35.5,20,18,0,18,9,33,2,0
Andrey Santos,BRA,MF,19,Strasbourg,Ligue 1,9.2,29,18,15,13,1,17,26,65.4,9,8,0,8,10,39,11,1
Jessy Deminguet,FRA,"MF,FW",25,Strasbourg,Ligue 1,7.7,14,9,6,8,0,6,18,33.3,12,8,0,8,9,23,5,1
Saidou Sow,GUI,DF,21,Strasbourg,Ligue 1,8.0,20,12,17,3,0,9,13,69.2,4,7,4,3,12,32,36,3
Dion Moise Sahi,CIV,"MF,FW",21,Strasbourg,Ligue 1,7.0,5,5,1,2,2,0,3,0.0,3,11,1,10,1,6,7,0
Lebo Mothiba,RSA,FW,27,Strasbourg,Ligue 1,6.9,5,2,1,4,0,3,4,75.0,1,6,1,5,0,5,11,0
Jean-Ricner Bellegarde,FRA,"MF,FW",25,Strasbourg,Ligue 1,3.0,5,3,3,2,0,3,6,50.0,3,4,0,4,4,9,0,0
Jérémy Sebas,MTQ,"FW,MF",20,Strasbourg,Ligue 1,4.4,7,1,2,3,2,3,5,60.0,2,3,1,2,1,8,1,0
Rabby Nzingoula,CGO,"MF,FW",17,Strasbourg,Ligue 1,1.5,3,3,0,3,0,3,4,75.0,1,4,0,4,5,8,0,0
Aboubacar Ali,FRA,"MF,FW",17,Strasbourg,Ligue 1,1.4,2,0,0,2,0,0,0,0.0,0,1,0,1,1,3,2,0
Sanjin Prcić,BIH,MF,29,Strasbourg,Ligue 1,1.0,0,0,0,0,0,0,1,0.0,1,2,1,1,3,3,1,0
Eduard Sobol,UKR,DF,28,Strasbourg,Ligue 1,0.3,0,0,0,0,0,0,0,0.0,0,0,0,0,0,0,1,0
Mohamed Bechikh,FRA,"FW,MF",18,Strasbourg,Ligue 1,0.2,0,0,0,0,0,0,0,0.0,0,0,0,0,0,0,0,0
Patrick Ouotro,CIV,FW,17,Strasbourg,Ligue 1,0.1,0,0,0,0,0,0,0,0.0,0,0,0,0,0,0,0,0
Steven Baseya,FRA,DF,18,Strasbourg,Ligue 1,0.1,2,1,1,1,0,1,1,100.0,0,0,0,0,0,2,1,0
Pedro Chirivella,ESP,MF,26,Nantes,Ligue 1,28.8,50,28,20,29,1,30,76,39.5,46,22,5,17,31,81,28,0
Alban Lafont,FRA,GK,24,Nantes,Ligue 1,27.7,0,0,0,0,0,0,2,0.0,2,0,0,0,0,0,14,0
Jean-Charles Castelletto,CMR,DF,28,Nantes,Ligue 1,27.4,34,26,22,10,2,18,29,62.1,11,19,10,9,32,66,81,0
Florent Mollet,FRA,"MF,FW",31,Nantes,Ligue 1,23.1,18,11,8,6,4,10,31,32.3,21,18,5,13,13,31,17,0
Mostafa Mohamed,EGY,FW,25,Nantes,Ligue 1,22.2,21,14,7,11,3,6,28,21.4,22,21,5,16,12,33,29,0
Eray Cömert,SUI,DF,25,Nantes,Ligue 1,22.2,42,28,28,13,1,28,38,73.7,10,35,18,17,36,78,78,1
Douglas,BRA,MF,26,Nantes,Ligue 1,19.7,70,42,34,30,6,30,59,50.8,29,22,8,14,26,96,30,0
Moussa Sissoko,FRA,MF,33,Nantes,Ligue 1,20.2,27,16,13,8,6,12,25,48.0,13,8,2,6,12,39,31,0
Moses Simon,NGA,"FW,MF",28,Nantes,Ligue 1,19.9,7,5,2,5,0,2,8,25.0,6,9,1,8,3,10,5,1
Marcus Coco,FRA,"DF,FW",27,Nantes,Ligue 1,16.5,43,26,29,10,4,28,60,46.7,32,19,1,18,21,64,38,0
Nicolas Pallois,FRA,DF,35,Nantes,Ligue 1,17.7,34,19,21,11,2,19,35,54.3,16,37,26,11,26,60,111,0
Jean-Kevin Duverne,HAI,DF,26,Nantes,Ligue 1,15.0,37,19,16,17,4,18,44,40.9,26,17,5,12,18,55,34,0
Quentin Merlin,FRA,DF,21,Nantes,Ligue 1,14.3,29,20,15,12,2,16,25,64.0,9,22,1,21,18,47,22,0
Matthis Abline,FRA,FW,20,Nantes,Ligue 1,11.6,9,4,4,3,2,3,8,37.5,5,3,0,3,3,12,5,0
Samuel Moutoussamy,COD,MF,26,Nantes,Ligue 1,12.3,38,20,14,17,7,17,37,45.9,20,16,3,13,11,49,13,0
Nathan Zeze,FRA,DF,18,Nantes,Ligue 1,11.4,11,6,9,2,0,7,14,50.0,7,12,3,9,12,23,47,1
Kelvin Amian,FRA,DF,25,Nantes,Ligue 1,8.9,16,7,12,4,0,11,15,73.3,4,6,0,6,7,23,28,0
Nicolas Cozza,FRA,DF,24,Nantes,Ligue 1,9.9,35,23,23,10,2,17,24,70.8,7,7,0,7,14,49,32,0
Tino Kadewere,ZIM,"FW,MF",27,Nantes,Ligue 1,8.7,9,4,3,3,3,6,11,54.5,5,10,1,9,10,19,8,0
Ronaël Pierre-Gabriel,FRA,DF,25,Nantes,Ligue 1,6.6,15,9,12,2,1,5,7,71.4,2,13,4,9,8,23,25,0
Rémy Descamps,FRA,GK,27,Nantes,Ligue 1,6.0,0,0,0,0,0,0,0,0.0,0,0,0,0,0,0,7,0
Bénie Adama Traore,CIV,"FW,MF",20,Nantes,Ligue 1,5.6,8,4,2,5,1,3,7,42.9,4,3,0,3,1,9,1,0
Adson,BRA,"MF,FW",22,Nantes,Ligue 1,2.6,7,6,1,6,0,2,2,100.0,0,5,0,5,2,9,2,0
Ignatius Ganago,CMR,"FW,MF",24,Nantes,Ligue 1,2.0,0,0,0,0,0,0,1,0.0,1,1,0,1,1,1,1,0
Abdoul Kader Bamba,FRA,"FW,MF",29,Nantes,Ligue 1,6.8,10,7,2,5,3,5,15,33.3,10,4,0,4,4,14,4,1
Marquinhos,BRA,"FW,MF",20,Nantes,Ligue 1,1.7,3,2,2,0,1,1,4,25.0,3,7,2,5,6,9,1,0
Fabien Centonze,FRA,DF,27,Nantes,Ligue 1,1.0,2,1,2,0,0,2,3,66.7,1,2,1,1,0,2,1,0
Bastien Meupiyou,FRA,DF,17,Nantes,Ligue 1,0.1,0,0,0,0,0,0,0,0.0,0,0,0,0,0,0,1,0
Jaouen Hadjam,ALG,DF,20,Nantes,Ligue 1,1.2,6,4,5,1,0,1,2,50.0,1,0,0,0,3,9,2,0
Stredair Appuah,FRA,"FW,MF",19,Nantes,Ligue 1,0.9,0,0,0,0,0,0,3,0.0,3,0,0,0,1,1,1,0
Denis Petrić,SRB,GK,35,Nantes,Ligue 1,0.3,0,0,0,0,0,0,0,0.0,0,0,0,0,0,0,0,0
Hugo Boutsingkham,FRA,"MF,FW",20,Nantes,Ligue 1,0.1,0,0,0,0,0,0,0,0.0,0,0,0,0,0,0,1,0
Adel Mahamoud,COM,FW,20,Nantes,Ligue 1,0.1,0,0,0,0,0,0,1,0.0,1,0,0,0,0,0,0,0
Enzo Mongo,FRA,DF,18,Nantes,Ligue 1,0.1,1,1,1,0,0,1,2,50.0,1,1,1,0,1,2,0,0
Lamine Diack,SEN,MF,22,Nantes,Ligue 1,0.0,0,0,0,0,0,0,0,0.0,0,0,0,0,0,0,0,0
Arthur Desmas,FRA,GK,29,Le Havre,Ligue 1,33.0,0,0,0,0,0,0,2,0.0,2,0,0,0,0,0,13,1
Gautier Lloris,FRA,DF,28,Le Havre,Ligue 1,30.9,50,28,40,9,1,28,42,66.7,14,50,30,20,32,82,142,1
Arouna Sangante,SEN,DF,21,Le Havre,Ligue 1,29.9,53,33,27,23,3,24,40,60.0,16,35,18,17,66,119,93,2
Christopher Operi,CIV,DF,26,Le Havre,Ligue 1,27.2,55,36,37,15,3,32,59,54.2,27,45,7,38,35,90,68,1
Abdoulaye Touré,GUI,MF,29,Le Havre,Ligue 1,25.4,47,28,22,22,3,30,60,50.0,30,30,8,22,25,72,33,0
Josué Casimir,FRA,"FW,DF",21,Le Havre,Ligue 1,22.4,31,18,14,14,3,7,18,38.9,11,23,2,21,13,44,25,0
Daler Kuzyaev,RUS,MF,30,Le Havre,Ligue 1,23.2,34,19,11,13,10,15,43,34.9,28,18,5,13,22,56,18,1
Etienne Youte Kinkoue,FRA,DF,21,Le Havre,Ligue 1,21.6,15,9,13,2,0,7,11,63.6,4,21,16,5,44,59,104,0
Yassine Kechta,MAR,MF,21,Le Havre,Ligue 1,20.5,46,24,24,19,3,31,73,42.5,42,20,3,17,23,69,16,1
Emmanuel Sabbi,USA,"FW,MF",25,Le Havre,Ligue 1,17.6,38,19,15,15,8,16,39,41.0,23,26,2,24,19,57,7,0
Yoann Salmier,GUF,DF,30,Le Havre,Ligue 1,17.4,22,10,13,6,3,13,20,65.0,7,21,15,6,21,43,57,0
Loïc Nego,HUN,"DF,MF",32,Le Havre,Ligue 1,17.3,37,26,21,12,4,18,30,60.0,12,12,2,10,16,53,17,0
Mohamed Lamine Bayo,GUI,FW,25,Le Havre,Ligue 1,15.4,13,5,2,5,6,2,10,20.0,8,8,1,7,2,15,11,0
André Ayew,GHA,FW,33,Le Havre,Ligue 1,12.3,15,11,7,6,2,6,9,66.7,3,8,3,5,2,17,11,0
Oussama Targhalline,MAR,MF,21,Le Havre,Ligue 1,11.4,23,11,16,7,0,15,25,60.0,10,9,3,6,20,43,14,2
Nabil Alioui,FRA,"MF,FW",24,Le Havre,Ligue 1,11.2,3,2,2,1,0,2,4,50.0,2,6,1,5,3,6,4,0
Antoine Joujou,FRA,"FW,MF",20,Le Havre,Ligue 1,8.7,20,12,7,7,6,11,21,52.4,10,11,2,9,7,27,5,0
Rassoul Ndiaye,SEN,"MF,FW",21,Le Havre,Ligue 1,5.8,25,17,8,16,1,12,24,50.0,12,2,1,1,4,29,5,0
Samuel Grandsir,FRA,"MF,FW",26,Le Havre,Ligue 1,6.7,16,12,5,9,2,8,18,44.4,10,4,0,4,3,19,3,1
Oualid El Hajjam,MAR,"DF,MF",32,Le Havre,Ligue 1,4.4,8,7,5,2,1,2,9,22.2,7,5,1,4,6,14,10,0
Issa Soumaré,SEN,"FW,MF",22,Le Havre,Ligue 1,2.6,2,0,2,0,0,0,4,0.0,4,0,0,0,0,2,2,0
Andy Logbo,FRA,FW,19,Le Havre,Ligue 1,2.8,0,0,0,0,0,0,3,0.0,3,7,3,4,0,0,2,0
Steve Ngoura,FRA,"FW,MF",18,Le Havre,Ligue 1,2.5,2,1,1,1,0,1,4,25.0,3,0,0,0,0,2,3,0
Mathieu Gorgelin,FRA,GK,32,Le Havre,Ligue 1,1.0,0,0,0,0,0,0,0,0.0,0,0,0,0,0,0,0,0
Nolan Mbemba,CGO,MF,28,Le Havre,Ligue 1,0.2,2,1,0,1,1,1,2,50.0,1,0,0,0,0,2,0,0
Simon Ebonog,CMR,MF,18,Le Havre,Ligue 1,0.2,1,1,0,1,0,1,1,100.0,0,1,1,0,0,1,1,0
Alois Confais,FRA,"MF,FW",26,Le Havre,Ligue 1,0.1,2,2,1,1,0,1,1,100.0,0,0,0,0,0,2,0,0
Alexandre Oukidja,ALG,GK,35,Metz,Ligue 1,33.2,2,1,2,0,0,1,2,50.0,1,1,0,1,3,5,24,3
Matthieu Udol,FRA,DF,27,Metz,Ligue 1,30.0,55,37,38,12,5,38,56,67.9,18,62,16,46,50,105,108,0
Danley Jean-Jacques,HAI,MF,23,Metz,Ligue 1,29.8,54,28,24,21,9,19,56,33.9,37,48,7,41,44,98,44,0
Lamine Camara,SEN,MF,19,Metz,Ligue 1,25.1,62,42,26,30,6,24,49,49.0,25,35,2,33,28,90,34,0
Ismaël Traoré,CIV,DF,36,Metz,Ligue 1,24.7,19,12,13,6,0,8,21,38.1,13,33,20,13,30,49,86,0
Maxime Colin,FRA,DF,31,Metz,Ligue 1,20.4,39,23,25,7,7,16,29,55.2,13,22,7,15,20,59,71,0
Kévin Van Den Kerkhof,ALG,"FW,MF",27,Metz,Ligue 1,21.3,31,24,11,13,7,13,32,40.6,19,15,2,13,11,42,32,1
Fali Candé,GNB,DF,25,Metz,Ligue 1,20.5,40,19,31,9,0,20,35,57.1,15,41,28,13,20,60,107,1
Georges Mikautadze,GEO,FW,22,Metz,Ligue 1,19.4,4,3,1,2,1,0,9,0.0,9,11,0,11,8,12,3,0
Christophe Hérelle,MTQ,DF,30,Metz,Ligue 1,18.0,32,15,24,7,1,13,23,56.5,10,16,9,7,18,50,68,2
Kévin N'Doram,FRA,MF,27,Metz,Ligue 1,17.8,31,22,20,9,2,17,38,44.7,21,17,8,9,27,58,38,0
Cheikh Tidiane Sabaly,SEN,"FW,MF",24,Metz,Ligue 1,15.3,40,20,23,12,5,16,40,40.0,24,19,2,17,10,50,14,0
Arthur Atta,FRA,"MF,FW",20,Metz,Ligue 1,10.3,18,14,8,7,3,8,19,42.1,11,13,3,10,10,28,23,0
Ablie Jallow,GAM,"MF,FW",24,Metz,Ligue 1,10.2,8,5,2,3,3,3,5,60.0,2,4,0,4,8,16,3,0
Koffi Kouao,CIV,DF,25,Metz,Ligue 1,9.6,20,13,12,7,1,11,17,64.7,6,9,6,3,13,33,38,1
Joel Asoro,SWE,"FW,MF",24,Metz,Ligue 1,9.4,13,9,7,6,0,3,10,30.0,7,7,1,6,6,19,9,0
Papa Amadou Diallo,SEN,FW,19,Metz,Ligue 1,9.9,18,8,10,7,1,7,21,33.3,14,11,1,10,11,29,16,0
Sadibou Sané,SEN,DF,19,Metz,Ligue 1,9.4,19,12,16,2,1,6,7,85.7,1,14,9,5,8,27,64,0
Simon Elisor,FRA,FW,24,Metz,Ligue 1,8.5,9,2,3,2,4,2,6,33.3,4,6,1,5,0,9,9,0
Joseph Nduquidi,FRA,"MF,DF",18,Metz,Ligue 1,8.3,11,4,6,3,2,1,9,11.1,8,11,3,8,11,22,15,1
Didier Lamkel Zé,CMR,"FW,MF",26,Metz,Ligue 1,6.1,7,2,2,4,1,2,5,40.0,3,4,0,4,0,7,11,0
Oscar Estupiñan,COL,FW,26,Metz,Ligue 1,2.9,5,4,0,3,2,1,2,50.0,1,2,0,2,0,5,0,0
Abou Lô,SEN,"MF,DF",23,Metz,Ligue 1,2.2,3,1,2,1,0,1,4,25.0,3,5,2,3,4,7,8,0
Youssef Maziz,FRA,"FW,MF",25,Metz,Ligue 1,1.4,0,0,0,0,0,0,2,0.0,2,1,0,1,1,1,2,0
Benjamin Tetteh,GHA,"FW,MF",26,Metz,Ligue 1,3.1,6,6,1,5,0,4,7,57.1,3,0,0,0,0,6,1,0
Malick Mbaye,SEN,"MF,FW",19,Metz,Ligue 1,1.7,5,1,0,1,4,1,2,50.0,1,1,0,1,1,6,2,0
Habib Maïga,CIV,"MF,FW",27,Metz,Ligue 1,1.6,2,2,1,0,1,1,3,33.3,2,2,0,2,4,6,2,0
Jean Frederic N'Guessan,CIV,"MF,FW",20,Metz,Ligue 1,1.2,3,1,0,3,0,0,3,0.0,3,3,0,3,1,4,0,0
Ibou Sané,SEN,"MF,FW",18,Metz,Ligue 1,1.4,6,4,2,1,3,2,2,100.0,0,3,0,3,1,7,2,0
Guillaume Dietsch,FRA,GK,22,Metz,Ligue 1,0.8,0,0,0,0,0,0,0,0.0,0,0,0,0,0,0,0,0
Yvon Mvogo,SUI,GK,29,Lorient,Ligue 1,34.0,0,0,0,0,0,0,1,0.0,1,0,0,0,0,0,15,3
Laurent Abergel,FRA,MF,30,Lorient,Ligue 1,31.8,85,52,43,34,8,38,96,39.6,58,29,6,23,61,146,61,3
Julien Ponceau,FRA,MF,22,Lorient,Ligue 1,24.9,32,15,12,14,6,9,30,30.0,21,22,1,21,19,51,20,0
Montassar Talbi,TUN,DF,25,Lorient,Ligue 1,24.5,38,22,23,13,2,19,32,59.4,13,39,23,16,32,70,114,0
Souleymane Touré,FRA,DF,20,Lorient,Ligue 1,22.8,25,12,16,9,0,8,14,57.1,6,38,20,18,36,61,101,2
Julien Laporte,FRA,DF,29,Lorient,Ligue 1,20.2,23,14,15,7,1,16,36,44.4,20,36,26,10,11,34,116,1
Romain Faivre,FRA,"MF,FW",25,Lorient,Ligue 1,16.1,13,6,5,4,4,6,15,40.0,9,6,1,5,7,20,3,1
Théo Le Bris,FRA,"DF,MF",20,Lorient,Ligue 1,16.8,35,22,25,7,3,19,40,47.5,21,24,3,21,12,47,42,0
Tiemoué Bakayoko,FRA,MF,28,Lorient,Ligue 1,14.6,34,17,14,17,3,15,28,53.6,13,10,4,6,26,60,15,1
Nathaniel Adjei,GHA,DF,20,Lorient,Ligue 1,13.8,13,9,8,3,2,6,7,85.7,1,15,8,7,18,31,64,1
Mohamed Bamba,CIV,FW,21,Lorient,Ligue 1,12.6,14,9,3,8,3,4,10,40.0,6,7,1,6,2,16,3,0
Formose Mendy,SEN,DF,22,Lorient,Ligue 1,14.0,33,19,24,8,1,20,33,60.6,13,23,12,11,20,53,59,1
Panos Katseris,GRE,DF,22,Lorient,Ligue 1,11.6,26,20,16,8,2,16,25,64.0,9,20,4,16,8,34,18,0
Ayman Kari,FRA,MF,18,Lorient,Ligue 1,9.9,18,14,9,9,0,12,19,63.2,7,19,2,17,6,24,9,1
Darlin Yongwa,CMR,DF,22,Lorient,Ligue 1,12.9,30,23,17,11,2,14,25,56.0,11,14,2,12,15,45,36,0
Eli Junior Kroupi,FRA,"FW,MF",17,Lorient,Ligue 1,12.0,7,4,2,2,3,1,9,11.1,8,6,0,6,10,17,5,0
Gedeon Kalulu,COD,DF,25,Lorient,Ligue 1,10.8,23,17,13,8,2,12,22,54.5,10,18,2,16,5,28,30,0
Tosin Aiyegun,BEN,"MF,FW",25,Lorient,Ligue 1,10.0,6,4,2,3,1,3,9,33.3,6,4,1,3,2,8,8,0
Imran Louza,MAR,MF,24,Lorient,Ligue 1,9.6,13,7,2,8,3,2,8,25.0,6,8,1,7,9,22,4,0
Vincent Le Goff,FRA,"DF,MF",33,Lorient,Ligue 1,6.0,5,0,4,0,1,4,8,50.0,4,11,3,8,3,8,10,0
Benjamin Mendy,FRA,DF,29,Lorient,Ligue 1,7.9,3,1,2,1,0,1,5,20.0,4,8,2,6,7,10,20,0
Bamba Dieng,SEN,FW,23,Lorient,Ligue 1,6.1,3,3,0,3,0,1,3,33.3,2,3,0,3,0,3,7,0
Jean-Victor Makengo,FRA,"MF,FW",25,Lorient,Ligue 1,5.3,5,4,3,2,0,2,6,33.3,4,12,1,11,8,13,5,0
Siriné Doucouré,MLI,FW,21,Lorient,Ligue 1,4.7,8,6,0,4,4,3,3,100.0,0,4,0,4,1,9,6,0
Badredine Bouanani,ALG,MF,18,Lorient,Ligue 1,4.9,4,2,1,1,2,2,4,50.0,2,3,0,3,2,6,3,0
Bonke Innocent,NGA,MF,27,Lorient,Ligue 1,2.3,6,4,2,2,2,2,9,22.2,7,2,1,1,4,10,2,0
Pablo Pagis,FRA,MF,20,Lorient,Ligue 1,1.8,10,6,5,4,1,6,10,60.0,4,2,0,2,3,13,1,0
Igor Carioca,BRA,"DF,MF",26,Lorient,Ligue 1,2.9,8,6,6,1,1,4,6,66.7,2,0,0,0,3,11,6,0
Bamo Meïté,CIV,DF,21,Lorient,Ligue 1,1.6,2,1,2,0,0,0,1,0.0,1,3,2,1,3,5,9,0
Loris Mouyokolo,FRA,DF,22,Lorient,Ligue 1,1.0,4,1,4,0,0,1,1,100.0,0,1,0,1,0,4,3,0
Aurélien Pelon,FRA,DF,19,Lorient,Ligue 1,1.0,1,0,1,0,0,0,2,0.0,2,2,2,0,0,1,7,0
Bassirou Ndiaye,SEN,FW,21,Lorient,Ligue 1,1.7,5,2,2,2,1,3,5,60.0,2,1,1,0,1,6,0,0
Dembo Sylla,GUI,DF,20,Lorient,Ligue 1,0.5,1,1,0,1,0,0,0,0.0,0,0,0,0,1,2,2,0
Ibrahima Koné,MLI,FW,24,Lorient,Ligue 1,0.4,0,0,0,0,0,0,1,0.0,1,0,0,0,0,0,0,0
Adrian Grbić,AUT,FW,26,Lorient,Ligue 1,0.3,0,0,0,0,0,0,0,0.0,0,0,0,0,0,0,0,0
Joel Mvuka,NOR,"DF,FW",20,Lorient,Ligue 1,0.2,5,0,3,1,1,3,7,42.9,4,1,0,1,0,5,1,0
Royce Openda Owaga,GAB,FW,21,Lorient,Ligue 1,0.2,0,0,0,0,0,0,0,0.0,0,0,0,0,0,0,0,0
Gino Caoki,FRA,MF,19,Lorient,Ligue 1,0.1,0,0,0,0,0,0,1,0.0,1,0,0,0,0,0,0,0
Andy Pelmard,FRA,DF,23,Clermont Foot,Ligue 1,33.2,51,38,41,9,1,32,40,80.0,8,37,20,17,33,84,99,2
Mory Diaw,SEN,GK,30,Clermont Foot,Ligue 1,30.0,1,1,1,0,0,1,2,50.0,1,0,0,0,1,2,13,5
Muhammed Cham,AUT,"MF,FW",22,Clermont Foot,Ligue 1,28.4,25,14,10,13,2,11,27,40.7,16,20,2,18,8,33,5,1
Neto Borges,BRA,DF,26,Clermont Foot,Ligue 1,28.0,48,24,25,18,5,28,63,44.4,35,28,6,22,57,105,84,0
Johan Gastien,FRA,MF,35,Clermont Foot,Ligue 1,25.1,43,22,18,21,4,23,81,28.4,58,31,9,22,36,79,24,4
Jim Allevinah,GAB,"MF,DF",28,Clermont Foot,Ligue 1,20.7,30,18,11,14,5,14,35,40.0,21,20,3,17,13,43,30,0
Maximiliano Caufriez,BEL,DF,26,Clermont Foot,Ligue 1,18.4,38,28,31,5,2,19,29,65.5,10,18,12,6,18,56,69,2
Yohann Magnin,FRA,MF,26,Clermont Foot,Ligue 1,18.7,49,31,12,32,5,22,47,46.8,25,38,13,25,19,68,26,1
Shamar Nicholson,JAM,FW,26,Clermont Foot,Ligue 1,16.5,6,2,0,4,2,1,4,25.0,3,6,2,4,0,6,15,0
Maxime Gonalons,FRA,MF,34,Clermont Foot,Ligue 1,14.4,47,33,14,27,6,25,57,43.9,32,18,3,15,20,67,11,0
Mehdi Zeffane,ALG,"DF,MF",31,Clermont Foot,Ligue 1,13.7,31,20,17,11,3,17,34,50.0,17,14,3,11,16,47,34,0
Elba Rashani,KVX,"MF,FW",30,Clermont Foot,Ligue 1,13.1,30,18,4,17,9,11,24,45.8,13,17,3,14,12,42,15,0
Chrislain Matsima,FRA,DF,21,Clermont Foot,Ligue 1,13.1,18,11,11,7,0,10,18,55.6,8,14,10,4,13,31,74,1
Alidu Seidu,GHA,DF,23,Clermont Foot,Ligue 1,12.6,32,24,17,15,0,24,31,77.4,7,15,7,8,25,57,37,0
Habib Keita,MLI,MF,21,Clermont Foot,Ligue 1,14.2,34,19,14,15,5,17,28,60.7,11,27,10,17,29,63,30,0
Cheick Konaté,MLI,DF,19,Clermont Foot,Ligue 1,11.9,26,15,17,9,0,20,36,55.6,16,16,2,14,13,39,21,0
Alan Virginius,FRA,FW,20,Clermont Foot,Ligue 1,10.4,9,5,4,4,1,4,11,36.4,7,7,0,7,3,12,7,0
Grejohn Kyei,FRA,FW,27,Clermont Foot,Ligue 1,11.4,6,4,2,2,2,2,3,66.7,1,5,1,4,1,7,10,0
Bilal Boutobba,FRA,"FW,MF",24,Clermont Foot,Ligue 1,10.3,22,12,6,10,6,10,23,43.5,13,9,0,9,8,30,3,0
Florent Ogier,FRA,DF,34,Clermont Foot,Ligue 1,10.5,19,9,13,6,0,11,18,61.1,7,25,19,6,9,28,35,3
Massamba Ndiaye,SEN,GK,21,Clermont Foot,Ligue 1,4.0,0,0,0,0,0,0,0,0.0,0,0,0,0,0,0,2,0
Jérémy Jacquet,FRA,DF,18,Clermont Foot,Ligue 1,2.8,4,3,4,0,0,3,3,100.0,0,7,3,4,6,10,10,0
Yoël Armougom,FRA,"DF,MF",25,Clermont Foot,Ligue 1,2.6,3,3,2,0,1,2,3,66.7,1,1,0,1,1,4,3,0
Mateusz Wieteska,POL,DF,26,Clermont Foot,Ligue 1,1.9,4,1,3,1,0,3,5,60.0,2,4,2,2,5,9,8,0
Jérémie Bela,ANG,"MF,FW",30,Clermont Foot,Ligue 1,2.3,1,1,0,1,0,1,3,33.3,2,1,0,1,0,1,1,0
Komnen Andrić,SRB,FW,28,Clermont Foot,Ligue 1,1.9,2,1,0,1,1,0,4,0.0,4,2,0,2,0,2,1,0
Ilhan Fakili,FRA,"MF,FW",17,Clermont Foot,Ligue 1,1.0,0,0,0,0,0,0,1,0.0,1,1,0,1,1,1,0,0
Aïman Maurer,MAR,"MF,FW",18,Clermont Foot,Ligue 1,0.6,1,1,1,0,0,1,3,33.3,2,0,0,0,0,1,0,0
Mohamed Bouchenna,FRA,"MF,FW",17,Clermont Foot,Ligue 1,0.3,1,0,1,0,0,0,0,0.0,0,0,0,0,0,1,0,0
Joshua M'Bahia,CIV,MF,18,Clermont Foot,Ligue 1,0.2,0,0,0,0,0,0,0,0.0,0,0,0,0,0,0,0,0
Abdellah Baallal,MAR,MF,18,Clermont Foot,Ligue 1,0.0,0,0,0,0,0,0,0,0.0,0,1,0,1,0,0,0,0
Rodri,ESP,MF,27,Manchester City,Premier League,32.6,70,43,25,33,12,29,60,48.3,31,32,8,24,26,96,41,4
Phil Foden,ENG,"FW,MF",23,Manchester City,Premier League,31.7,31,20,11,10,10,13,31,41.9,18,30,0,30,13,44,18,1
Ederson,BRA,GK,29,Manchester City,Premier League,30.9,0,0,0,0,0,0,1,0.0,1,0,0,0,0,0,10,1
Julián Álvarez,ARG,"MF,FW",23,Manchester City,Premier League,29.4,24,13,5,8,11,8,32,25.0,24,30,0,30,2,26,14,1
Kyle Walker,ENG,DF,33,Manchester City,Premier League,30.7,38,24,19,17,2,19,39,48.7,20,19,6,13,27,65,40,1
Bernardo Silva,POR,"MF,FW",28,Manchester City,Premier League,28.6,51,23,13,25,13,25,57,43.9,32,32,4,28,17,68,15,1
Erling Haaland,NOR,FW,23,Manchester City,Premier League,28.4,6,3,0,3,3,2,3,66.7,1,11,1,10,2,8,16,0
Rúben Dias,POR,DF,26,Manchester City,Premier League,28.4,39,20,14,21,4,19,26,73.1,7,32,17,15,30,69,77,0
Manuel Akanji,SUI,"DF,MF",28,Manchester City,Premier League,27.9,42,28,16,18,8,22,39,56.4,17,28,12,16,23,65,70,3
Joško Gvardiol,CRO,DF,21,Manchester City,Premier League,25.9,55,33,21,24,10,21,38,55.3,17,36,12,24,27,82,37,3
Nathan Aké,NED,DF,28,Manchester City,Premier League,22.7,26,16,15,8,3,13,20,65.0,7,17,2,15,14,40,54,0
Jeremy Doku,BEL,"FW,MF",21,Manchester City,Premier League,17.7,39,22,13,12,14,9,20,45.0,11,14,0,14,9,48,5,0
Mateo Kovačić,CRO,MF,29,Manchester City,Premier League,17.2,36,25,16,15,5,18,28,64.3,10,23,1,22,10,46,10,0
Kevin De Bruyne,BEL,MF,32,Manchester City,Premier League,13.6,14,9,1,5,8,7,20,35.0,13,5,0,5,4,18,4,0
John Stones,ENG,"DF,MF",29,Manchester City,Premier League,11.8,2,1,1,0,1,0,3,0.0,3,11,7,4,10,12,21,0
Jack Grealish,ENG,"FW,MF",27,Manchester City,Premier League,11.2,13,8,6,7,0,6,12,50.0,6,13,2,11,6,19,5,0
Rico Lewis,ENG,"DF,MF",18,Manchester City,Premier League,9.0,10,7,4,4,2,3,7,42.9,4,7,1,6,4,14,6,0
Matheus Nunes,POR,MF,24,Manchester City,Premier League,7.3,10,4,1,7,2,5,16,31.3,11,7,1,6,1,11,8,1
Stefan Ortega,GER,GK,30,Manchester City,Premier League,7.1,0,0,0,0,0,0,0,0.0,0,0,0,0,0,0,2,1
Oscar Bobb,NOR,"FW,MF",20,Manchester City,Premier League,3.4,7,3,1,2,4,2,4,50.0,2,4,0,4,5,12,1,0
Kalvin Phillips,ENG,MF,27,Manchester City,Premier League,1.0,3,3,1,1,1,0,0,0.0,0,0,0,0,2,5,2,0
Sergio Gómez,ESP,"FW,MF",22,Manchester City,Premier League,0.6,1,0,0,1,0,1,2,50.0,1,0,0,0,1,2,0,0
Aymeric Laporte,ESP,DF,29,Manchester City,Premier League,0.1,0,0,0,0,0,0,0,0.0,0,1,1,0,0,0,1,0
Cole Palmer,ENG,MF,21,Manchester City,Premier League,0.1,0,0,0,0,0,0,0,0.0,0,0,0,0,0,0,0,0
James Mcatee,ENG,MF,20,Manchester City,Premier League,0.0,0,0,0,0,0,0,0,0.0,0,1,0,1,0,0,0,0
William Saliba,FRA,DF,22,Arsenal,Premier League,38.0,41,26,28,12,1,20,27,74.1,7,32,17,15,29,70,81,3
Declan Rice,ENG,MF,24,Arsenal,Premier League,35.8,83,51,37,38,8,32,57,56.1,25,37,11,26,44,127,52,0
Martin Ødegaard,NOR,MF,24,Arsenal,Premier League,34.3,49,17,18,21,10,17,58,29.3,41,23,1,22,15,64,5,0
Ben White,ENG,DF,25,Arsenal,Premier League,33.2,48,28,20,22,6,26,58,44.8,32,48,22,26,32,80,77,1
Bukayo Saka,ENG,FW,21,Arsenal,Premier League,32.4,66,35,22,24,20,26,59,44.1,33,43,2,41,15,81,24,1
Gabriel Magalhães,BRA,DF,25,Arsenal,Premier League,33.8,48,28,24,22,2,17,22,77.3,5,44,33,11,31,79,100,1
David Raya,ESP,GK,27,Arsenal,Premier League,32.0,1,1,1,0,0,1,1,100.0,0,0,0,0,0,1,8,5
Kai Havertz,GER,"MF,FW",24,Arsenal,Premier League,29.3,35,15,7,21,7,14,39,35.9,25,26,1,25,20,55,22,0
Gabriel Martinelli,BRA,FW,22,Arsenal,Premier League,22.4,30,24,9,12,9,13,32,40.6,19,23,1,22,5,35,9,1
Oleksandr Zinchenko,UKR,DF,26,Arsenal,Premier League,19.1,50,30,19,24,7,35,52,67.3,17,18,3,15,20,70,26,2
Leandro Trossard,BEL,"FW,MF",28,Arsenal,Premier League,18.3,27,16,8,9,10,9,25,36.0,16,27,1,26,8,35,6,0
Gabriel Jesus,BRA,FW,26,Arsenal,Premier League,16.4,24,17,11,5,8,5,18,27.8,13,23,1,22,13,37,12,0
Jakub Kiwior,POL,DF,23,Arsenal,Premier League,10.5,20,12,11,8,1,14,19,73.7,5,11,3,8,8,28,28,1
Takehiro Tomiyasu,JPN,DF,24,Arsenal,Premier League,12.8,20,9,15,4,1,11,18,61.1,7,10,4,6,18,38,33,0
Eddie Nketiah,ENG,FW,24,Arsenal,Premier League,12.0,12,7,2,6,4,2,7,28.6,5,11,0,11,4,16,4,0
Jorginho,ITA,MF,31,Arsenal,Premier League,10.2,24,10,6,10,8,11,23,47.8,12,17,1,16,12,36,7,1
Thomas Partey,GHA,"MF,DF",30,Arsenal,Premier League,8.8,14,11,9,4,1,5,10,50.0,5,9,3,6,11,25,9,0
Aaron Ramsdale,ENG,GK,25,Arsenal,Premier League,6.0,0,0,0,0,0,0,0,0.0,0,0,0,0,0,0,3,2
Emile Smith Rowe,ENG,MF,23,Arsenal,Premier League,3.9,4,1,2,2,0,2,4,50.0,2,3,1,2,3,7,1,0
Fabio Vieira,POR,"MF,FW",23,Arsenal,Premier League,3.3,3,2,2,0,1,3,3,100.0,0,0,0,0,2,5,2,0
Reiss Nelson,ENG,FW,23,Arsenal,Premier League,3.0,9,6,5,1,3,8,10,80.0,2,5,1,4,1,10,5,0
Jurriën Timber,NED,DF,22,Arsenal,Premier League,0.8,2,2,1,1,0,0,0,0.0,0,1,0,1,0,2,1,0
Cédric Soares,POR,DF,31,Arsenal,Premier League,0.7,0,0,0,0,0,0,0,0.0,0,0,0,0,0,0,0,0
Mohamed Elneny,EGY,MF,31,Arsenal,Premier League,0.3,0,0,0,0,0,0,1,0.0,1,0,0,0,1,1,0,0
Ethan Nwaneri,ENG,FW,16,Arsenal,Premier League,0.2,0,0,0,0,0,0,0,0.0,0,1,0,1,0,0,0,0
Virgil van Dijk,NED,DF,32,Liverpool,Premier League,35.3,40,23,24,13,3,12,14,85.7,2,47,34,13,39,79,144,0
Luis Díaz,COL,FW,26,Liverpool,Premier League,29.2,35,25,5,17,13,7,30,23.3,23,15,0,15,3,38,8,0
Alexis Mac Allister,ARG,MF,24,Liverpool,Premier League,28.9,99,55,35,50,14,59,125,47.2,66,65,8,57,35,134,25,1
Mohamed Salah,EGY,FW,31,Liverpool,Premier League,28.2,17,11,1,8,8,6,21,28.6,15,19,1,18,2,19,1,0
Alisson,BRA,GK,30,Liverpool,Premier League,28.0,0,0,0,0,0,0,1,0.0,1,0,0,0,0,0,11,4
Trent Alexander-Arnold,ENG,DF,24,Liverpool,Premier League,23.9,39,26,26,11,2,27,87,31.0,60,22,2,20,31,70,48,5
Dominik Szoboszlai,HUN,MF,22,Liverpool,Premier League,23.4,32,19,12,12,8,16,50,32.0,34,37,2,35,15,47,16,1
Darwin Núñez,URU,FW,24,Liverpool,Premier League,22.7,22,12,2,10,10,11,23,47.8,12,18,6,12,3,25,9,0
Wataru Endo,JPN,MF,30,Liverpool,Premier League,19.1,48,28,11,31,6,20,61,32.8,41,24,2,22,20,68,31,3
Andrew Robertson,SCO,DF,29,Liverpool,Premier League,18.8,35,24,21,11,3,26,43,60.5,17,20,6,14,13,48,40,0
Joe Gomez,ENG,DF,26,Liverpool,Premier League,19.8,47,31,24,16,7,30,63,47.6,33,26,4,22,19,66,50,2
Cody Gakpo,NED,"FW,MF",24,Liverpool,Premier League,18.3,27,17,8,14,5,8,25,32.0,17,21,4,17,14,41,7,0
Ibrahima Konaté,FRA,DF,24,Liverpool,Premier League,17.5,36,22,22,13,1,18,24,75.0,6,18,12,6,20,56,51,1
Curtis Jones,ENG,MF,22,Liverpool,Premier League,13.0,27,14,12,12,3,10,23,43.5,13,22,0,22,7,34,8,0
Diogo Jota,POR,FW,26,Liverpool,Premier League,12.7,23,13,6,13,4,10,23,43.5,13,9,1,8,7,30,4,0
Jarell Quansah,ENG,DF,20,Liverpool,Premier League,13.2,25,22,17,7,1,14,20,70.0,6,16,8,8,17,42,39,1
Ryan Gravenberch,NED,MF,21,Liverpool,Premier League,12.5,26,12,5,13,8,12,29,41.4,17,20,2,18,14,40,11,0
Harvey Elliott,ENG,"MF,FW",20,Liverpool,Premier League,15.0,27,17,8,14,5,10,31,32.3,21,27,0,27,6,33,7,0
Caoimhín Kelleher,IRL,GK,24,Liverpool,Premier League,10.0,0,0,0,0,0,0,0,0.0,0,0,0,0,0,0,4,1
Conor Bradley,NIR,DF,20,Liverpool,Premier League,8.4,33,25,14,12,7,24,38,63.2,14,17,1,16,10,43,14,0
Joël Matip,CMR,DF,31,Liverpool,Premier League,8.7,12,6,7,4,1,8,12,66.7,4,16,12,4,9,21,43,0
Kostas Tsimikas,GRE,DF,27,Liverpool,Premier League,7.5,19,13,9,6,4,9,15,60.0,6,9,1,8,6,25,10,0
Bobby Clark,ENG,MF,18,Liverpool,Premier League,1.0,2,1,1,1,0,1,5,20.0,4,6,2,4,1,3,1,0
Stefan Bajcetic,ESP,MF,18,Liverpool,Premier League,0.3,4,1,3,1,0,3,5,60.0,2,0,0,0,0,4,0,0
Ben Doak,SCO,FW,17,Liverpool,Premier League,0.2,0,0,0,0,0,0,0,0.0,0,0,0,0,0,0,0,0
Jayden Danns,ENG,FW,17,Liverpool,Premier League,0.1,0,0,0,0,0,0,0,0.0,0,0,0,0,0,0,0,0
Owen Beck,WAL,DF,20,Liverpool,Premier League,0.1,2,1,1,1,0,0,0,0.0,0,0,0,0,0,2,1,0
Thiago Alcántara,ESP,MF,32,Liverpool,Premier League,0.1,0,0,0,0,0,0,0,0.0,0,0,0,0,0,0,0,0
James McConnell,ENG,MF,18,Liverpool,Premier League,0.0,0,0,0,0,0,0,0,0.0,0,1,0,1,1,1,0,0
Kaide Gordon,ENG,FW,18,Liverpool,Premier League,0.0,0,0,0,0,0,0,0,0.0,0,0,0,0,0,0,0,0
Ollie Watkins,ENG,FW,27,Aston Villa,Premier League,35.7,12,7,0,5,7,5,11,45.5,6,26,4,22,4,16,20,0
Ezri Konsa,ENG,DF,25,Aston Villa,Premier League,34.1,54,32,28,23,3,23,27,85.2,4,36,20,16,28,82,73,3
John McGinn,SCO,"MF,FW",28,Aston Villa,Premier League,33.3,59,35,18,34,7,32,77,41.6,45,33,4,29,21,80,21,0
Douglas Luiz,BRA,MF,25,Aston Villa,Premier League,33.3,58,38,21,27,10,25,53,47.2,28,32,8,24,23,81,18,2
Emiliano Martínez,ARG,GK,30,Aston Villa,Premier League,33.5,0,0,0,0,0,0,0,0.0,0,0,0,0,0,0,12,3
Pau Torres,ESP,DF,26,Aston Villa,Premier League,27.4,29,18,17,11,1,14,30,46.7,16,28,12,16,14,43,75,0
Lucas Digne,FRA,DF,30,Aston Villa,Premier League,26.8,47,19,35,9,3,25,44,56.8,19,20,2,18,26,73,67,0
Moussa Diaby,FRA,"FW,MF",24,Aston Villa,Premier League,24.2,12,5,5,4,3,4,22,18.2,18,8,1,7,9,21,6,0
Matty Cash,POL,DF,25,Aston Villa,Premier League,23.8,54,31,24,24,6,29,59,49.2,30,35,14,21,18,72,59,0
Leon Bailey,JAM,"MF,FW",25,Aston Villa,Premier League,23.0,13,7,7,4,2,5,20,25.0,15,18,1,17,9,22,6,0
Diego Carlos,BRA,DF,30,Aston Villa,Premier League,20.2,27,16,22,4,1,13,21,61.9,8,24,19,5,13,40,78,3
Boubacar Kamara,FRA,MF,23,Aston Villa,Premier League,18.4,43,29,16,21,6,24,47,51.1,23,21,7,14,21,64,16,0
Youri Tielemans,BEL,"MF,FW",26,Aston Villa,Premier League,18.0,41,20,17,18,6,16,40,40.0,24,23,3,20,15,56,9,0
Clément Lenglet,FRA,DF,28,Aston Villa,Premier League,12.8,13,9,7,5,1,7,13,53.8,6,19,11,8,7,20,47,1
Alex Moreno,ESP,DF,30,Aston Villa,Premier League,11.5,18,12,18,0,0,12,19,63.2,7,11,2,9,13,31,37,0
Nicolò Zaniolo,ITA,"FW,MF",24,Aston Villa,Premier League,9.3,19,9,10,7,2,9,17,52.9,8,13,0,13,1,20,11,0
Jacob Ramsey,ENG,"FW,MF",22,Aston Villa,Premier League,9.5,16,8,7,6,3,5,15,33.3,10,15,2,13,3,19,8,0
Morgan Rogers,ENG,"MF,FW",21,Aston Villa,Premier League,7.1,8,1,3,2,3,2,11,18.2,9,11,0,11,3,11,11,0
Robin Olsen,SWE,GK,33,Aston Villa,Premier League,4.5,0,0,0,0,0,0,0,0.0,0,0,0,0,0,0,1,0
Jhon Durán,COL,"FW,MF",19,Aston Villa,Premier League,5.3,6,5,3,1,2,1,6,16.7,5,6,0,6,1,7,10,0
Tim Iroegbunam,ENG,MF,20,Aston Villa,Premier League,1.8,7,5,4,2,1,4,9,44.4,5,3,0,3,2,9,3,0
Calum Chambers,ENG,"MF,DF",28,Aston Villa,Premier League,1.7,3,0,3,0,0,0,1,0.0,1,2,1,1,2,5,4,0
Leander Dendoncker,BEL,MF,28,Aston Villa,Premier League,1.3,6,4,3,2,1,4,5,80.0,1,5,2,3,2,8,3,1
Tyrone Mings,ENG,DF,30,Aston Villa,Premier League,0.3,0,0,0,0,0,0,0,0.0,0,0,0,0,1,1,1,0
Omari Kellyman,ENG,FW,17,Aston Villa,Premier League,0.4,1,0,0,1,0,1,2,50.0,1,0,0,0,0,1,0,0
Philippe Coutinho,BRA,"MF,FW",31,Aston Villa,Premier League,0.3,0,0,0,0,0,0,1,0.0,1,0,0,0,0,0,0,0
Bertrand Traoré,BFA,"DF,FW",27,Aston Villa,Premier League,0.1,1,1,1,0,0,0,0,0.0,0,0,0,0,0,1,1,0
Cameron Archer,ENG,MF,22,Aston Villa,Premier League,0.1,0,0,0,0,0,0,0,0.0,0,0,0,0,0,0,0,0
Kaine Kesler-Hayden,ENG,"MF,DF",20,Aston Villa,Premier League,0.1,0,0,0,0,0,0,0,0.0,0,0,0,0,0,0,0,0
Finley Munroe,ENG,MF,18,Aston Villa,Premier League,0.0,0,0,0,0,0,0,0,0.0,0,0,0,0,0,0,0,0
Jaden Philogene Bidace,ENG,FW,21,Aston Villa,Premier League,0.0,0,0,0,0,0,0,0,0.0,0,0,0,0,0,0,0,0
Guglielmo Vicario,ITA,GK,26,Tottenham,Premier League,38.0,0,0,0,0,0,0,1,0.0,1,0,0,0,1,1,31,2
Pedro Porro,ESP,DF,23,Tottenham,Premier League,34.3,91,63,43,34,14,62,120,51.7,58,63,18,45,34,125,102,3
Son Heung-min,KOR,FW,31,Tottenham,Premier League,32.6,21,13,6,7,8,10,21,47.6,11,4,1,3,8,29,4,0
Cristian Romero,ARG,DF,25,Tottenham,Premier League,31.0,66,40,35,25,6,32,44,72.7,12,46,22,24,44,110,106,1
Dejan Kulusevski,SWE,"FW,MF",23,Tottenham,Premier League,30.7,62,33,19,20,23,25,67,37.3,42,24,1,23,18,80,2,1
Destiny Udogie,ITA,DF,20,Tottenham,Premier League,26.6,68,33,41,16,11,27,49,55.1,22,27,8,19,37,105,80,5
Micky van de Ven,NED,DF,22,Tottenham,Premier League,26.0,49,35,34,12,3,24,33,72.7,9,25,15,10,18,67,78,1
Pape Matar Sarr,SEN,MF,20,Tottenham,Premier League,23.0,34,24,11,17,6,15,36,41.7,21,21,5,16,31,65,28,1
James Maddison,ENG,MF,26,Tottenham,Premier League,23.7,33,19,5,18,10,15,29,51.7,14,15,3,12,13,46,10,1
Yves Bissouma,MLI,MF,26,Tottenham,Premier League,23.0,80,52,32,36,12,41,61,67.2,20,28,5,23,37,117,43,3
Brennan Johnson,WAL,FW,22,Tottenham,Premier League,23.2,26,15,14,5,7,12,31,38.7,19,37,1,36,10,36,12,1
Richarlison,BRA,FW,26,Tottenham,Premier League,16.6,16,11,4,8,4,2,10,20.0,8,32,6,26,8,24,23,0
Rodrigo Bentancur,URU,MF,26,Tottenham,Premier League,11.2,23,15,10,11,2,10,24,41.7,14,15,4,11,17,40,16,1
Ben Davies,WAL,DF,30,Tottenham,Premier League,12.1,24,17,13,8,3,16,21,76.2,5,17,15,2,10,34,35,0
Emerson,BRA,DF,24,Tottenham,Premier League,12.9,36,24,23,10,3,21,43,48.8,22,23,10,13,20,56,50,1
Timo Werner,GER,FW,27,Tottenham,Premier League,9.0,7,4,3,4,0,5,18,27.8,13,12,0,12,3,10,2,0
Pierre Højbjerg,DEN,MF,27,Tottenham,Premier League,14.6,32,18,13,17,2,13,34,38.2,21,21,7,14,19,51,30,3
Oliver Skipp,ENG,"MF,DF",22,Tottenham,Premier League,7.9,18,12,9,6,3,11,18,61.1,7,12,1,11,3,21,9,0
Giovani Lo Celso,ARG,MF,27,Tottenham,Premier League,5.6,22,13,10,8,4,9,14,64.3,5,4,1,3,5,27,2,0
Radu Drăgușin,ROU,DF,21,Tottenham,Premier League,4.8,5,3,5,0,0,3,3,100.0,0,5,4,1,8,13,19,0
Bryan Gil,ESP,"FW,MF",22,Tottenham,Premier League,2.3,1,0,0,0,1,1,4,25.0,3,3,0,3,3,4,4,0
Eric Dier,ENG,DF,29,Tottenham,Premier League,2.2,2,1,2,0,0,2,2,100.0,0,3,3,0,2,4,12,0
Ivan Perišić,CRO,FW,34,Tottenham,Premier League,1.1,3,2,1,1,1,3,5,60.0,2,1,0,1,2,5,1,0
Davinson Sánchez,COL,DF,27,Tottenham,Premier League,0.9,0,0,0,0,0,0,0,0.0,0,3,2,1,1,1,2,0
Alejo Véliz,ARG,FW,19,Tottenham,Premier League,0.6,1,0,1,0,0,0,0,0.0,0,0,0,0,0,1,0,0
Dane Scarlett,ENG,FW,19,Tottenham,Premier League,0.2,1,1,0,0,1,0,1,0.0,1,0,0,0,0,1,0,0
Mikey Moore,ENG,MF,15,Tottenham,Premier League,0.0,0,0,0,0,0,0,0,0.0,0,0,0,0,0,0,1,0
Jamie Donley,ENG,FW,18,Tottenham,Premier League,0.0,0,0,0,0,0,0,0,0.0,0,0,0,0,0,0,3,0
Conor Gallagher,ENG,MF,23,Chelsea,Premier League,34.8,85,52,37,31,17,33,77,42.9,44,50,11,39,43,128,34,0
Moisés Caicedo,ECU,MF,21,Chelsea,Premier League,31.8,91,46,38,42,11,36,60,60.0,24,59,25,34,37,128,44,4
Nicolas Jackson,SEN,FW,22,Chelsea,Premier League,31.1,21,13,5,8,8,5,24,20.8,19,20,5,15,4,25,17,0
Cole Palmer,ENG,"FW,MF",21,Chelsea,Premier League,29.0,23,12,9,6,8,8,19,42.1,11,20,2,18,20,43,13,2
Axel Disasi,FRA,DF,25,Chelsea,Premier League,28.7,33,19,20,10,3,23,30,76.7,7,26,19,7,18,51,102,2
Thiago Silva,BRA,DF,38,Chelsea,Premier League,28.1,29,15,22,6,1,20,34,58.8,14,33,24,9,26,55,153,4
Enzo Fernández,ARG,MF,22,Chelsea,Premier League,24.5,50,22,22,18,10,27,65,41.5,38,36,13,23,17,67,28,0
Dorđe Petrović,SRB,GK,23,Chelsea,Premier League,22.1,0,0,0,0,0,0,0,0.0,0,0,0,0,0,0,12,3
Raheem Sterling,ENG,"FW,MF",28,Chelsea,Premier League,22.0,21,10,7,8,6,12,26,46.2,14,13,0,13,13,34,9,1
Levi Colwill,ENG,DF,20,Chelsea,Premier League,20.0,48,30,26,17,5,26,34,76.5,8,28,10,18,26,74,66,0
Marc Cucurella,ESP,DF,25,Chelsea,Premier League,19.8,62,38,36,21,5,34,64,53.1,30,36,13,23,22,84,48,0
Malo Gusto,FRA,DF,20,Chelsea,Premier League,19.5,55,27,34,15,6,35,52,67.3,17,28,4,24,17,72,43,1
Mykhailo Mudryk,UKR,FW,22,Chelsea,Premier League,17.5,21,12,9,7,5,10,32,31.3,22,14,1,13,9,30,9,0
Robert Sánchez,ESP,GK,25,Chelsea,Premier League,15.9,0,0,0,0,0,0,0,0.0,0,0,0,0,0,0,11,3
Benoît Badiashile,FRA,DF,22,Chelsea,Premier League,14.9,21,15,12,9,0,9,14,64.3,5,21,14,7,18,39,66,2
Noni Madueke,ENG,FW,21,Chelsea,Premier League,11.7,16,10,8,4,4,11,34,32.4,23,11,0,11,4,20,14,0
Trevoh Chalobah,ENG,DF,24,Chelsea,Premier League,10.6,16,12,10,2,4,10,15,66.7,5,8,7,1,8,24,51,0
Ben Chilwell,ENG,DF,26,Chelsea,Premier League,8.4,15,10,5,9,1,5,8,62.5,3,11,3,8,4,19,19,1
Armando Broja,ALB,FW,21,Chelsea,Premier League,5.0,3,0,0,1,2,1,2,50.0,1,5,1,4,0,3,3,0
Reece James,ENG,DF,23,Chelsea,Premier League,4.7,14,9,10,3,1,8,10,80.0,2,4,4,0,3,17,7,1
Lesley Ugochukwu,FRA,MF,19,Chelsea,Premier League,3.3,14,10,4,8,2,4,10,40.0,6,6,2,4,1,15,5,0
Christopher Nkunku,FRA,"FW,MF",25,Chelsea,Premier League,4.9,5,4,0,4,1,1,2,50.0,1,4,1,3,2,7,4,0
Carney Chukwuemeka,ENG,"MF,FW",19,Chelsea,Premier League,2.5,6,4,3,3,0,1,3,33.3,2,1,1,0,0,6,1,0
Alfie Gilchrist,ENG,DF,19,Chelsea,Premier League,2.3,4,0,4,0,0,2,5,40.0,3,6,3,3,3,7,11,0
Ian Maatsen,NED,"FW,MF",21,Chelsea,Premier League,2.3,3,2,1,1,1,0,4,0.0,4,4,0,4,3,6,10,0
Cesare Casadei,ITA,"FW,MF",20,Chelsea,Premier League,0.9,5,3,2,1,2,2,5,40.0,3,1,0,1,0,5,4,0
Roméo Lavia,BEL,MF,19,Chelsea,Premier League,0.4,1,0,0,1,0,0,0,0.0,0,0,0,0,0,1,1,0
Deivid Washington,BRA,"DF,FW",18,Chelsea,Premier League,0.1,1,1,1,0,0,0,1,0.0,1,0,0,0,0,1,0,0
Mason Burstow,ENG,FW,19,Chelsea,Premier League,0.1,0,0,0,0,0,0,0,0.0,0,0,0,0,0,0,0,0
Joshua Acheampong,ENG,DF,17,Chelsea,Premier League,0.1,0,0,0,0,0,0,0,0.0,0,3,3,0,0,0,0,0
Alex Matos,ENG,MF,18,Chelsea,Premier League,0.0,0,0,0,0,0,0,0,0.0,0,0,0,0,0,0,0,0
Jimi Tauriainen,ENG,FW,19,Chelsea,Premier League,0.0,0,0,0,0,0,0,0,0.0,0,0,0,0,0,0,0,0
Bruno Guimarães,BRA,MF,25,Newcastle Utd,Premier League,36.3,88,53,45,32,11,40,77,51.9,37,52,14,38,34,122,20,0
Fabian Schär,SUI,DF,31,Newcastle Utd,Premier League,33.9,42,24,27,13,2,18,40,45.0,22,50,38,12,36,78,131,1
Anthony Gordon,ENG,FW,22,Newcastle Utd,Premier League,32.1,55,34,16,28,11,22,64,34.4,42,27,0,27,7,62,7,0
Dan Burn,ENG,DF,31,Newcastle Utd,Premier League,30.3,61,33,37,20,4,26,61,42.6,35,55,25,30,37,98,124,1
Sean Longstaff,ENG,MF,25,Newcastle Utd,Premier League,30.5,54,30,17,29,8,24,63,38.1,39,43,7,36,17,71,23,0
Alexander Isak,SWE,FW,23,Newcastle Utd,Premier League,25.1,5,0,2,1,2,2,8,25.0,6,16,1,15,6,11,13,0
Kieran Trippier,ENG,DF,32,Newcastle Utd,Premier League,24.8,57,27,30,16,11,37,77,48.1,40,41,8,33,24,81,56,3
Miguel Almirón,PAR,FW,29,Newcastle Utd,Premier League,21.5,36,24,13,15,8,11,29,37.9,18,29,2,27,10,46,13,0
Martin Dúbravka,SVK,GK,34,Newcastle Utd,Premier League,22.1,0,0,0,0,0,0,4,0.0,4,0,0,0,0,0,8,1
Sven Botman,NED,DF,23,Newcastle Utd,Premier League,15.3,20,13,14,6,0,8,13,61.5,5,20,16,4,9,29,61,3
Nick Pope,ENG,GK,31,Newcastle Utd,Premier League,14.9,0,0,0,0,0,0,1,0.0,1,0,0,0,0,0,7,2
Joelinton,BRA,"MF,FW",26,Newcastle Utd,Premier League,14.2,39,27,21,15,3,14,38,36.8,24,23,7,16,19,58,11,1
Lewis Miley,ENG,MF,17,Newcastle Utd,Premier League,13.4,33,21,6,20,7,15,32,46.9,17,20,3,17,8,41,18,2
Jacob Murphy,ENG,"FW,DF",28,Newcastle Utd,Premier League,13.2,20,10,8,4,8,12,26,46.2,14,18,0,18,5,25,16,0
Jamaal Lascelles,ENG,DF,29,Newcastle Utd,Premier League,12.0,14,9,7,7,0,6,11,54.5,5,17,12,5,5,19,42,0
Valentino Livramento,ENG,DF,20,Newcastle Utd,Premier League,14.6,23,13,15,6,2,10,21,47.6,11,16,7,9,25,48,41,1
Elliot Anderson,SCO,"MF,FW",20,Newcastle Utd,Premier League,11.4,24,18,12,9,3,15,29,51.7,14,23,4,19,8,32,23,0
Callum Wilson,ENG,FW,31,Newcastle Utd,Premier League,11.0,5,3,0,2,3,0,4,0.0,4,6,0,6,2,7,4,0
Emil Krafth,SWE,DF,28,Newcastle Utd,Premier League,10.1,21,14,10,7,4,12,25,48.0,13,8,3,5,9,30,21,0
Lewis Hall,ENG,DF,18,Newcastle Utd,Premier League,8.7,28,18,17,10,1,17,28,60.7,11,17,2,15,13,41,21,1
Harvey Barnes,ENG,"FW,MF",25,Newcastle Utd,Premier League,8.9,6,1,3,2,1,1,2,50.0,1,1,0,1,5,11,3,0
Sandro Tonali,ITA,MF,23,Newcastle Utd,Premier League,4.9,7,7,4,2,1,3,9,33.3,6,3,0,3,2,9,4,0
Joe Willock,ENG,MF,23,Newcastle Utd,Premier League,4.7,13,7,7,6,0,4,11,36.4,7,7,0,7,1,14,1,0
Loris Karius,GER,GK,30,Newcastle Utd,Premier League,1.0,0,0,0,0,0,0,0,0.0,0,0,0,0,0,0,1,0
Matt Targett,ENG,DF,27,Newcastle Utd,Premier League,0.9,2,0,1,1,0,1,1,100.0,0,1,0,1,0,2,2,0
Matt Ritchie,SCO,"FW,MF",33,Newcastle Utd,Premier League,1.4,5,3,2,2,1,2,4,50.0,2,3,2,1,1,6,5,0
Ben Parkinson,ENG,FW,18,Newcastle Utd,Premier League,0.3,0,0,0,0,0,0,0,0.0,0,1,0,1,0,0,1,0
Paul Dummett,WAL,DF,31,Newcastle Utd,Premier League,0.2,1,0,1,0,0,1,1,100.0,0,0,0,0,0,1,1,0
Alex Murphy,IRL,"DF,FW",19,Newcastle Utd,Premier League,0.1,1,1,0,1,0,1,2,50.0,1,1,0,1,1,2,0,0
Joe White,ENG,MF,20,Newcastle Utd,Premier League,0.1,1,1,1,0,0,0,0,0.0,0,0,0,0,0,1,0,0
Amadou Diallo,ENG,MF,20,Newcastle Utd,Premier League,0.0,0,0,0,0,0,0,0,0.0,0,0,0,0,0,0,0,0
Michael Ndiweni,ENG,FW,19,Newcastle Utd,Premier League,0.0,0,0,0,0,0,0,0,0.0,0,0,0,0,0,0,0,0
André Onana,CMR,GK,27,Manchester Utd,Premier League,38.0,2,0,2,0,0,2,2,100.0,0,0,0,0,0,2,11,2
Diogo Dalot,POR,DF,24,Manchester Utd,Premier League,35.3,81,51,58,12,11,51,74,68.9,23,44,16,28,37,118,109,0
Bruno Fernandes,POR,"MF,FW",28,Manchester Utd,Premier League,34.6,68,38,27,25,16,30,88,34.1,58,49,6,43,27,95,49,2
Alejandro Garnacho,ARG,FW,19,Manchester Utd,Premier League,28.5,22,15,7,6,9,12,45,26.7,33,26,2,24,18,40,18,0
Marcus Rashford,ENG,FW,25,Manchester Utd,Premier League,25.2,19,12,9,4,6,9,26,34.6,17,15,1,14,4,23,20,0
Rasmus Højlund,DEN,FW,20,Manchester Utd,Premier League,24.0,11,7,2,3,6,5,13,38.5,8,9,1,8,1,12,19,0
Casemiro,BRA,"MF,DF",31,Manchester Utd,Premier League,22.0,83,56,43,32,8,51,106,48.1,55,74,33,41,17,100,71,1
Kobbie Mainoo,ENG,MF,18,Manchester Utd,Premier League,21.4,47,27,20,16,11,21,45,46.7,24,20,12,8,22,69,30,1
Aaron Wan-Bissaka,ENG,DF,25,Manchester Utd,Premier League,19.8,42,25,18,20,4,19,26,73.1,7,30,15,15,41,83,68,1
Scott McTominay,SCO,"MF,FW",26,Manchester Utd,Premier League,21.1,48,24,23,23,2,22,33,66.7,11,34,12,22,14,62,53,0
Harry Maguire,ENG,DF,30,Manchester Utd,Premier League,18.4,24,17,14,10,0,12,22,54.5,10,33,24,9,25,49,83,1
Raphaël Varane,FRA,DF,30,Manchester Utd,Premier League,15.3,18,11,10,7,1,10,14,71.4,4,23,18,5,15,33,88,0
Jonny Evans,NIR,DF,35,Manchester Utd,Premier League,15.5,22,14,20,2,0,12,21,57.1,9,25,18,7,23,45,75,0
Antony,BRA,FW,23,Manchester Utd,Premier League,14.7,40,21,15,19,6,20,40,50.0,20,29,1,28,12,52,9,0
Victor Lindelöf,SWE,DF,29,Manchester Utd,Premier League,14.8,15,10,8,7,0,5,13,38.5,8,18,9,9,12,27,40,1
Christian Eriksen,DEN,MF,31,Manchester Utd,Premier League,12.7,18,13,5,10,3,12,33,36.4,21,17,6,11,4,22,13,0
Luke Shaw,ENG,DF,28,Manchester Utd,Premier League,10.7,11,8,7,3,1,9,15,60.0,6,18,11,7,6,17,39,0
Sofyan Amrabat,MAR,"MF,DF",26,Manchester Utd,Premier League,10.4,27,16,17,8,2,17,31,54.8,14,19,7,12,8,35,19,2
Lisandro Martínez,ARG,DF,25,Manchester Utd,Premier League,7.2,12,8,8,4,0,5,12,41.7,7,10,8,2,5,17,26,0
Mason Mount,ENG,"MF,FW",24,Manchester Utd,Premier League,5.7,22,14,6,10,6,6,16,37.5,10,6,1,5,6,28,3,0
Anthony Martial,FRA,FW,27,Manchester Utd,Premier League,5.0,4,1,1,1,2,1,1,100.0,0,4,0,4,0,4,3,0
Sergio Reguilón,ESP,DF,26,Manchester Utd,Premier League,4.6,13,8,6,2,5,8,17,47.1,9,10,0,10,5,18,7,0
Amad Diallo,CIV,"FW,MF",21,Manchester Utd,Premier League,4.3,10,3,1,6,3,3,4,75.0,1,3,1,2,1,11,6,0
Willy Kambwala,FRA,DF,18,Manchester Utd,Premier League,3.7,3,1,1,2,0,1,3,33.3,2,6,3,3,4,7,14,1
Facundo Pellistri,URU,"FW,MF",21,Manchester Utd,Premier League,1.9,5,3,4,1,0,1,3,33.3,2,7,1,6,1,6,5,0
Hannibal Mejbri,TUN,"MF,FW",20,Manchester Utd,Premier League,1.5,3,3,1,2,0,1,3,33.3,2,1,1,0,0,3,0,0
Omari Forson,ENG,FW,19,Manchester Utd,Premier League,0.8,2,0,0,2,0,1,1,100.0,0,0,0,0,0,2,0,0
Jadon Sancho,ENG,"FW,MF",23,Manchester Utd,Premier League,0.9,1,0,1,0,0,1,3,33.3,2,1,0,1,1,2,0,0
Ethan Wheatley,ENG,FW,17,Manchester Utd,Premier League,0.2,1,1,0,1,0,1,1,100.0,0,2,0,2,2,3,0,0
Donny van de Beek,NED,DF,26,Manchester Utd,Premier League,0.0,0,0,0,0,0,0,0,0.0,0,1,0,1,0,0,0,0
Daniel Gore,ENG,MF,18,Manchester Utd,Premier League,0.0,1,1,0,1,0,1,1,100.0,0,0,0,0,1,2,0,0
Vladimír Coufal,CZE,DF,30,West Ham,Premier League,34.8,64,41,50,12,2,38,75,50.7,37,49,15,34,43,107,97,0
Emerson Palmieri,ITA,DF,28,West Ham,Premier League,34.9,106,68,48,42,16,57,90,63.3,33,47,15,32,43,149,96,0
Jarrod Bowen,ENG,FW,26,West Ham,Premier League,33.5,42,28,14,14,14,13,35,37.1,22,37,5,32,19,61,14,0
James Ward-Prowse,ENG,MF,28,West Ham,Premier League,33.3,45,29,14,23,8,18,44,40.9,26,31,9,22,38,83,49,0
Tomáš Souček,CZE,MF,28,West Ham,Premier League,31.9,53,35,24,26,3,21,47,44.7,26,55,28,27,37,90,109,0
Kurt Zouma,FRA,DF,28,West Ham,Premier League,31.5,23,17,14,9,0,10,16,62.5,6,38,28,10,29,52,160,0
Alphonse Areola,FRA,GK,30,West Ham,Premier League,30.0,1,1,1,0,0,1,3,33.3,2,0,0,0,1,2,16,0
Lucas Paquetá,BRA,"FW,MF",25,West Ham,Premier League,29.1,71,48,38,26,7,25,52,48.1,27,28,1,27,21,92,28,2
Edson Álvarez,MEX,MF,25,West Ham,Premier League,26.4,80,39,47,26,7,31,66,47.0,35,59,20,39,42,122,81,0
Mohammed Kudus,GHA,"FW,MF",22,West Ham,Premier League,27.6,65,47,27,27,11,20,40,50.0,20,25,0,25,11,76,9,1
Nayef Aguerd,MAR,DF,27,West Ham,Premier League,20.6,26,14,19,7,0,16,22,72.7,6,33,24,9,17,43,85,2
Michail Antonio,JAM,FW,33,West Ham,Premier League,18.8,15,8,5,6,4,3,11,27.3,8,16,3,13,4,19,4,0
Konstantinos Mavropanos,GRE,DF,25,West Ham,Premier League,16.7,28,16,17,9,2,17,21,81.0,4,21,13,8,23,51,79,3
Lukasz Fabiański,POL,GK,38,West Ham,Premier League,8.0,1,0,1,0,0,1,2,50.0,1,0,0,0,1,2,4,0
Angelo Ogbonna,ITA,DF,35,West Ham,Premier League,7.1,11,5,9,2,0,6,7,85.7,1,13,10,3,3,14,29,0
Saïd Benrahma,ALG,"FW,MF",27,West Ham,Premier League,6.9,8,4,5,3,0,4,15,26.7,11,8,0,8,5,13,7,0
Ben Johnson,ENG,"DF,FW",23,West Ham,Premier League,6.0,11,7,7,3,1,9,14,64.3,5,2,1,1,5,16,14,0
Aaron Cresswell,ENG,"DF,FW",33,West Ham,Premier League,4.8,3,2,1,1,1,2,3,66.7,1,5,3,2,3,6,7,0
Pablo Fornals,ESP,"MF,FW",27,West Ham,Premier League,4.7,10,6,4,3,3,5,16,31.3,11,8,1,7,6,16,7,0
Danny Ings,ENG,FW,31,West Ham,Premier League,4.5,6,2,0,6,0,4,13,30.8,9,4,1,3,3,9,7,0
Kalvin Phillips,ENG,MF,27,West Ham,Premier League,3.4,11,6,2,8,1,5,9,55.6,4,4,1,3,4,15,2,1
Maxwel Cornet,CIV,"MF,FW",26,West Ham,Premier League,1.2,3,2,3,0,0,1,5,20.0,4,2,0,2,2,5,1,0
Divin Mubama,ENG,FW,18,West Ham,Premier League,0.9,0,0,0,0,0,0,0,0.0,0,0,0,0,0,0,0,0
George Earthy,ENG,FW,18,West Ham,Premier League,0.4,0,0,0,0,0,0,1,0.0,1,0,0,0,1,1,0,0
Thilo Kehrer,GER,"DF,MF",26,West Ham,Premier League,0.2,1,1,0,1,0,0,0,0.0,0,2,2,0,0,1,0,0
Kaelan Casey,ENG,DF,18,West Ham,Premier League,0.0,0,0,0,0,0,0,0,0.0,0,0,0,0,0,0,1,0
Joachim Andersen,DEN,DF,27,Crystal Palace,Premier League,37.9,56,35,33,21,2,29,39,74.4,10,33,18,15,41,97,207,1
Tyrick Mitchell,ENG,"DF,MF",23,Crystal Palace,Premier League,35.6,105,60,75,21,9,43,60,71.7,17,63,10,53,26,131,104,0
Jordan Ayew,GHA,"FW,MF",31,Crystal Palace,Premier League,28.3,65,36,23,28,14,21,42,50.0,21,43,2,41,16,81,15,0
Jefferson Lerma,COL,"MF,DF",28,Crystal Palace,Premier League,26.7,42,25,15,23,4,19,40,47.5,21,31,12,19,36,78,72,0
Jean-Philippe Mateta,FRA,FW,26,Crystal Palace,Premier League,25.4,22,15,4,11,7,6,10,60.0,4,13,4,9,4,26,14,0
Eberechi Eze,ENG,"MF,FW",25,Crystal Palace,Premier League,22.8,35,17,4,18,13,15,31,48.4,16,27,2,25,11,46,6,0
Chris Richards,USA,"DF,MF",23,Crystal Palace,Premier League,23.3,46,28,21,22,3,20,30,66.7,10,32,12,20,27,73,109,0
Marc Guéhi,ENG,DF,23,Crystal Palace,Premier League,22.5,28,19,21,7,0,14,24,58.3,10,22,17,5,18,46,89,1
Joel Ward,ENG,DF,33,Crystal Palace,Premier League,22.0,45,28,26,18,1,30,47,63.8,17,17,10,7,14,59,94,1
Will Hughes,ENG,MF,28,Crystal Palace,Premier League,21.0,61,33,30,20,11,24,48,50.0,24,36,14,22,21,82,25,0
Sam Johnstone,ENG,GK,30,Crystal Palace,Premier League,20.0,1,0,1,0,0,1,1,100.0,0,0,0,0,1,2,5,0
Dean Henderson,ENG,GK,26,Crystal Palace,Premier League,18.0,1,1,1,0,0,1,2,50.0,1,0,0,0,0,1,8,2
Odsonne Édouard,FRA,"FW,MF",25,Crystal Palace,Premier League,17.3,24,12,8,8,8,4,19,21.1,15,17,1,16,6,30,19,0
Jeffrey Schlupp,GHA,"FW,MF",30,Crystal Palace,Premier League,15.0,38,24,14,16,8,9,18,50.0,9,13,2,11,8,46,24,0
Daniel Muñoz,COL,"DF,MF",27,Crystal Palace,Premier League,16.0,55,35,31,14,10,19,38,50.0,19,29,7,22,24,79,47,0
Adam Wharton,ENG,MF,19,Crystal Palace,Premier League,14.4,48,32,18,22,8,23,46,50.0,23,17,3,14,20,68,24,1
Nathaniel Clyne,ENG,DF,32,Crystal Palace,Premier League,14.9,24,15,11,11,2,14,21,66.7,7,18,6,12,10,34,33,0
Michael Olise,FRA,"FW,MF",21,Crystal Palace,Premier League,14.2,19,10,7,10,2,8,24,33.3,16,21,0,21,11,30,9,0
Cheick Doucouré,MLI,MF,23,Crystal Palace,Premier League,10.2,34,17,15,13,6,18,30,60.0,12,13,2,11,20,54,12,0
Jaïro Riedewald,NED,"MF,FW",26,Crystal Palace,Premier League,2.6,9,3,2,4,3,3,6,50.0,3,0,0,0,2,11,2,0
Matheus França,BRA,"MF,FW",19,Crystal Palace,Premier League,2.6,3,3,2,1,0,1,7,14.3,6,4,0,4,1,4,1,0
Naouirou Ahamada,FRA,"MF,FW",21,Crystal Palace,Premier League,3.9,13,9,5,6,2,8,17,47.1,9,3,0,3,2,15,4,0
David Ozoh,ENG,"MF,DF",18,Crystal Palace,Premier League,1.7,10,6,3,6,1,5,6,83.3,1,2,0,2,0,10,2,0
Jesurun Rak Sakyi,ENG,"MF,FW",20,Crystal Palace,Premier League,1.5,4,1,3,1,0,2,3,66.7,1,2,0,2,3,7,1,0
James Tomkins,ENG,DF,34,Crystal Palace,Premier League,0.1,0,0,0,0,0,0,0,0.0,0,0,0,0,1,1,0,0
Remi Matthews,ENG,GK,29,Crystal Palace,Premier League,0.0,0,0,0,0,0,0,0,0.0,0,0,0,0,0,0,1,0
Pascal Groß,GER,"MF,DF",32,Brighton,Premier League,34.6,70,46,33,21,16,31,72,43.1,41,41,8,33,22,92,32,3
Lewis Dunk,ENG,DF,31,Brighton,Premier League,31.9,27,14,17,9,1,13,36,36.1,23,49,37,12,31,58,90,1
Jan Paul van Hecke,NED,DF,23,Brighton,Premier League,26.3,47,26,25,19,3,27,45,60.0,18,49,27,22,30,77,76,4
Simon Adingra,CIV,FW,21,Brighton,Premier League,24.7,45,20,23,11,11,19,42,45.2,23,31,1,30,19,64,22,0
Billy Gilmour,SCO,MF,22,Brighton,Premier League,23.6,26,16,14,10,2,11,35,31.4,24,23,9,14,11,37,14,1
Bart Verbruggen,NED,GK,20,Brighton,Premier League,21.0,1,1,1,0,0,1,2,50.0,1,0,0,0,0,1,11,3
Danny Welbeck,ENG,"FW,MF",32,Brighton,Premier League,18.8,35,17,9,17,9,10,17,58.8,7,12,0,12,9,44,17,1
João Pedro,BRA,"FW,MF",21,Brighton,Premier League,22.7,31,14,10,13,8,14,24,58.3,10,15,2,13,11,42,28,0
Igor,BRA,DF,25,Brighton,Premier League,18.2,25,18,7,16,2,17,29,58.6,12,22,9,13,14,39,52,1
Joël Veltman,NED,DF,31,Brighton,Premier League,17.6,54,41,32,17,5,39,58,67.2,19,17,7,10,18,72,57,1
Jason Steele,ENG,GK,32,Brighton,Premier League,17.0,0,0,0,0,0,0,3,0.0,3,0,0,0,0,0,8,1
Facundo Buonanotte,ARG,"FW,MF",18,Brighton,Premier League,15.2,42,22,13,22,7,14,44,31.8,30,22,3,19,8,50,5,0
Kaoru Mitoma,JPN,FW,26,Brighton,Premier League,16.5,13,6,3,7,3,5,19,26.3,14,15,1,14,5,18,12,0
Evan Ferguson,IRL,FW,18,Brighton,Premier League,15.2,14,6,4,7,3,5,14,35.7,9,10,3,7,2,16,8,0
Carlos Baleba,CMR,MF,19,Brighton,Premier League,14.7,40,20,17,19,4,23,46,50.0,23,35,7,28,18,58,30,3
Pervis Estupiñán,ECU,DF,25,Brighton,Premier League,13.8,26,13,12,11,3,14,30,46.7,16,14,4,10,21,47,20,0
Adam Webster,ENG,DF,28,Brighton,Premier League,12.7,14,12,8,5,1,6,18,33.3,12,16,12,4,16,30,43,1
Adam Lallana,ENG,"MF,FW",35,Brighton,Premier League,9.4,8,3,4,4,0,0,4,0.0,4,2,1,1,3,11,1,0
James Milner,ENG,"DF,MF",37,Brighton,Premier League,8.6,20,14,9,10,1,9,14,64.3,5,9,0,9,8,28,16,0
Tariq Lamptey,GHA,"DF,FW",22,Brighton,Premier League,10.2,21,14,14,5,2,13,22,59.1,9,7,3,4,6,27,6,0
Jack Hinshelwood,ENG,DF,18,Brighton,Premier League,9.7,14,5,7,4,3,5,13,38.5,8,6,2,4,14,28,18,0
Solly March,ENG,"FW,DF",29,Brighton,Premier League,6.2,19,14,9,7,3,8,14,57.1,6,5,0,5,11,30,8,0
Jakub Moder,POL,"MF,DF",24,Brighton,Premier League,6.9,19,10,9,5,5,9,18,50.0,9,8,2,6,2,21,12,0
Mahmoud Dahoud,GER,MF,27,Brighton,Premier League,5.0,9,4,2,4,3,3,9,33.3,6,4,1,3,1,10,5,0
Julio Enciso,PAR,"MF,FW",19,Brighton,Premier League,5.3,6,2,3,2,1,2,7,28.6,5,11,0,11,0,6,3,0
Ansu Fati,ESP,"MF,FW",20,Brighton,Premier League,5.8,5,3,1,2,2,1,11,9.1,10,8,0,8,3,8,3,0
Valentín Barco,ARG,"DF,FW",19,Brighton,Premier League,3.4,11,5,4,5,2,6,8,75.0,2,3,0,3,4,15,3,1
Odeluga Offiah,ENG,DF,20,Brighton,Premier League,1.4,1,0,1,0,0,1,1,100.0,0,0,0,0,1,2,0,0
Mark O'Mahony,IRL,FW,18,Brighton,Premier League,0.7,1,0,1,0,0,1,2,50.0,1,2,1,1,0,1,1,0
Benicio Boaitey,ENG,"FW,DF",19,Brighton,Premier League,0.4,0,0,0,0,0,0,1,0.0,1,1,0,1,0,0,2,0
Illia Zabarnyi,UKR,DF,20,Bournemouth,Premier League,37.0,59,32,29,29,1,23,50,46.0,27,53,34,19,33,92,143,4
Dominic Solanke,ENG,FW,25,Bournemouth,Premier League,36.9,23,11,3,13,7,10,29,34.5,19,24,5,19,7,30,43,0
Ryan Christie,SCO,MF,28,Bournemouth,Premier League,32.3,86,44,34,35,17,39,92,42.4,53,52,11,41,52,138,53,1
Neto,BRA,GK,34,Bournemouth,Premier League,32.0,0,0,0,0,0,0,0,0.0,0,1,0,1,1,1,12,3
Lewis Cook,ENG,MF,26,Bournemouth,Premier League,31.0,61,41,24,30,7,34,63,54.0,29,32,11,21,65,126,46,1
Marcos Senesi,ARG,DF,26,Bournemouth,Premier League,24.9,55,32,28,23,4,24,56,42.9,32,50,23,27,35,90,109,1
Justin Kluivert,NED,"MF,FW",24,Bournemouth,Premier League,21.3,28,14,5,12,11,8,30,26.7,22,16,1,15,8,36,11,0
Adam Smith,ENG,DF,32,Bournemouth,Premier League,23.9,37,23,18,11,8,19,39,48.7,20,28,11,17,21,58,62,0
Marcus Tavernier,ENG,FW,24,Bournemouth,Premier League,23.5,53,34,25,22,6,26,48,54.2,22,31,3,28,5,58,23,0
Antoine Semenyo,GHA,FW,23,Bournemouth,Premier League,23.4,24,17,7,9,8,9,27,33.3,18,39,2,37,6,30,21,0
Milos Kerkez,HUN,DF,19,Bournemouth,Premier League,21.9,47,26,31,13,3,30,42,71.4,12,31,11,20,20,67,60,2
Lloyd Kelly,ENG,DF,24,Bournemouth,Premier League,17.3,24,19,10,9,5,14,25,56.0,11,22,12,10,13,37,67,0
Philip Billing,DEN,MF,27,Bournemouth,Premier League,15.5,33,16,7,22,4,9,27,33.3,18,31,5,26,20,53,28,1
Max Aarons,ENG,DF,23,Bournemouth,Premier League,13.7,29,19,20,7,2,20,34,58.8,14,9,5,4,8,37,27,0
Dango Ouattara,BFA,"FW,DF",21,Bournemouth,Premier League,13.7,45,27,22,11,12,19,34,55.9,15,18,3,15,22,67,35,0
Alex Scott,ENG,MF,19,Bournemouth,Premier League,11.3,24,15,8,10,6,12,28,42.9,16,14,4,10,12,36,18,2
Luis Sinisterra,COL,"FW,MF",24,Bournemouth,Premier League,7.8,23,12,9,10,4,9,16,56.3,7,18,0,18,8,31,4,0
Chris Mepham,WAL,DF,25,Bournemouth,Premier League,6.9,12,11,9,3,0,9,14,64.3,5,13,6,7,7,19,30,1
Mark Travers,IRL,GK,24,Bournemouth,Premier League,4.0,0,0,0,0,0,0,0,0.0,0,0,0,0,0,0,2,0
Joe Rothwell,ENG,MF,28,Bournemouth,Premier League,4.3,7,2,4,2,1,2,8,25.0,6,4,2,2,3,10,2,0
Enes Ünal,TUR,"FW,MF",26,Bournemouth,Premier League,3.6,6,4,2,3,1,2,5,40.0,3,4,2,2,1,7,6,0
David Brooks,WAL,"FW,MF",26,Bournemouth,Premier League,3.1,5,4,2,1,2,2,4,50.0,2,3,0,3,2,7,2,0
Ionuț Radu,ROU,GK,26,Bournemouth,Premier League,2.0,0,0,0,0,0,0,0,0.0,0,0,0,0,0,0,0,0
Jaidon Anthony,ENG,FW,23,Bournemouth,Premier League,1.7,3,1,1,0,2,1,7,14.3,6,3,0,3,1,4,3,0
Tyler Adams,USA,MF,24,Bournemouth,Premier League,1.3,4,3,1,3,0,2,3,66.7,1,2,0,2,4,8,2,0
James Hill,ENG,DF,21,Bournemouth,Premier League,0.8,3,2,1,2,0,1,1,100.0,0,3,2,1,3,6,8,0
Kieffer Moore,WAL,"FW,MF",30,Bournemouth,Premier League,1.2,0,0,0,0,0,0,0,0.0,0,0,0,0,0,0,0,0
Hamed Junior Traorè,CIV,MF,23,Bournemouth,Premier League,0.5,1,0,1,0,0,1,3,33.3,2,3,0,3,0,1,0,0
Romain Faivre,FRA,"MF,FW",25,Bournemouth,Premier League,0.5,1,1,0,1,0,0,3,0.0,3,0,0,0,0,1,0,0
Dominic Sadi,ENG,FW,19,Bournemouth,Premier League,0.0,0,0,0,0,0,0,0,0.0,0,0,0,0,0,0,0,0
Bernd Leno,GER,GK,31,Fulham,Premier League,38.0,0,0,0,0,0,0,0,0.0,0,0,0,0,0,0,14,1
Antonee Robinson,USA,DF,25,Fulham,Premier League,36.3,93,58,60,26,7,52,110,47.3,58,56,8,48,80,173,117,3
Andreas Pereira,BRA,MF,27,Fulham,Premier League,29.0,25,12,4,12,9,11,41,26.8,30,16,2,14,4,29,12,0
João Palhinha,POR,MF,28,Fulham,Premier League,30.0,152,75,80,60,12,103,152,67.8,49,57,9,48,46,198,58,0
Timothy Castagne,BEL,DF,27,Fulham,Premier League,29.3,49,24,23,16,10,26,44,59.1,18,38,10,28,38,87,69,1
Calvin Bassey,NGA,DF,23,Fulham,Premier League,25.6,49,29,33,15,1,21,29,72.4,8,32,11,21,28,77,84,4
Alex Iwobi,NGA,"FW,MF",27,Fulham,Premier League,24.4,29,18,12,15,2,12,25,48.0,13,16,0,16,14,43,9,0
Willian,BRA,FW,34,Fulham,Premier League,22.8,18,11,6,7,5,3,21,14.3,18,13,0,13,9,27,12,1
Tosin Adarabioyo,ENG,DF,25,Fulham,Premier League,18.0,21,11,16,5,0,12,21,57.1,9,16,11,5,25,46,80,0
Rodrigo Muniz,BRA,FW,22,Fulham,Premier League,17.7,7,3,1,5,1,1,6,16.7,5,9,3,6,6,13,20,0
Raúl Jiménez,MEX,FW,32,Fulham,Premier League,15.5,18,12,4,8,6,7,20,35.0,13,11,3,8,4,22,13,0
Tim Ream,USA,DF,35,Fulham,Premier League,16.7,20,9,13,5,2,9,18,50.0,9,23,15,8,25,45,61,2
Bobby Reid,JAM,FW,30,Fulham,Premier League,15.8,22,14,5,15,2,4,16,25.0,12,24,2,22,5,27,14,0
Harry Wilson,WAL,FW,26,Fulham,Premier League,18.0,21,14,9,8,4,11,28,39.3,17,27,3,24,10,31,12,0
Issa Diop,FRA,DF,26,Fulham,Premier League,15.8,30,16,23,5,2,15,20,75.0,5,28,19,9,17,47,80,1
Harrison Reed,ENG,MF,28,Fulham,Premier League,14.7,29,18,9,17,3,13,31,41.9,18,19,9,10,11,40,24,0
Tom Cairney,SCO,MF,32,Fulham,Premier League,16.5,24,16,10,12,2,13,25,52.0,12,16,4,12,13,37,6,0
Saša Lukić,SRB,MF,26,Fulham,Premier League,12.5,33,19,9,17,7,18,39,46.2,21,18,5,13,16,49,19,1
Kenny Tete,NED,DF,27,Fulham,Premier League,9.6,27,17,19,6,2,11,19,57.9,8,10,3,7,16,43,35,0
Carlos Vinícius,BRA,FW,28,Fulham,Premier League,3.5,3,2,0,1,2,0,4,0.0,4,4,0,4,0,3,1,0
Adama Traoré,ESP,"FW,MF",27,Fulham,Premier League,4.2,4,3,1,2,1,3,6,50.0,3,2,0,2,1,5,2,0
Armando Broja,ALB,FW,21,Fulham,Premier League,1.0,0,0,0,0,0,0,0,0.0,0,1,0,1,0,0,0,0
Luke Harris,WAL,MF,18,Fulham,Premier League,0.8,1,1,1,0,0,0,1,0.0,1,0,0,0,0,1,0,0
Fodé Ballo-Touré,SEN,"DF,MF",26,Fulham,Premier League,0.8,4,2,1,3,0,1,2,50.0,1,1,0,1,3,7,2,0
Aleksandar Mitrović,SRB,FW,28,Fulham,Premier League,0.4,0,0,0,0,0,0,0,0.0,0,0,0,0,0,0,0,0
Max Kilman,ENG,DF,26,Wolves,Premier League,38.0,47,21,40,6,1,24,32,75.0,8,64,37,27,39,86,182,4
Nélson Semedo,POR,"DF,MF",29,Wolves,Premier League,34.3,79,48,52,19,8,38,64,59.4,26,44,8,36,36,115,85,1
José Sá,POR,GK,30,Wolves,Premier League,33.7,0,0,0,0,0,0,1,0.0,1,3,0,3,0,0,21,5
Mario Lemina,GAB,MF,29,Wolves,Premier League,33.0,90,58,46,33,11,25,47,53.2,22,36,9,27,41,131,64,0
João Gomes,BRA,MF,22,Wolves,Premier League,29.4,128,74,67,49,12,44,99,44.4,55,51,8,43,18,146,29,2
Toti Gomes,POR,DF,24,Wolves,Premier League,30.8,44,25,32,8,4,24,37,64.9,13,40,19,21,26,70,93,2
Matheus Cunha,BRA,"FW,MF",24,Wolves,Premier League,27.1,30,16,8,17,5,13,35,37.1,22,28,7,21,13,43,21,1
Rayan Aït-Nouri,ALG,"DF,MF",22,Wolves,Premier League,25.9,71,44,41,23,7,28,49,57.1,21,32,6,26,15,86,38,0
Craig Dawson,ENG,DF,33,Wolves,Premier League,24.5,30,20,23,6,1,22,34,64.7,12,51,39,12,16,46,120,1
Hwang Hee-chan,KOR,"FW,MF",27,Wolves,Premier League,23.5,20,10,11,8,1,9,24,37.5,15,19,1,18,10,30,9,0
Pablo Sarabia,ESP,"MF,FW",31,Wolves,Premier League,19.4,20,13,8,8,4,12,36,33.3,24,17,1,16,10,30,9,0
Pedro Neto,POR,"FW,MF",23,Wolves,Premier League,16.8,7,3,3,2,2,5,15,33.3,10,5,1,4,5,12,2,0
Tommy Doyle,ENG,MF,21,Wolves,Premier League,13.6,26,13,11,10,5,14,23,60.9,9,22,9,13,12,38,18,0
Jean-Ricner Bellegarde,FRA,"MF,FW",25,Wolves,Premier League,10.6,17,10,9,6,2,7,15,46.7,8,18,2,16,8,25,14,0
Matt Doherty,IRL,"DF,MF",31,Wolves,Premier League,12.8,31,18,17,10,4,12,23,52.2,11,15,5,10,7,38,47,0
Santiago Bueno,URU,DF,24,Wolves,Premier League,9.1,13,7,5,7,1,5,11,45.5,6,22,12,10,6,19,33,0
Boubacar Traoré,MLI,MF,21,Wolves,Premier League,9.1,35,23,16,17,2,9,21,42.9,12,12,2,10,5,40,7,0
Hugo Bueno,ESP,"DF,MF",20,Wolves,Premier League,8.2,21,14,12,7,2,12,19,63.2,7,17,4,13,6,27,24,0
Daniel Bentley,ENG,GK,30,Wolves,Premier League,4.3,0,0,0,0,0,0,1,0.0,1,0,0,0,0,0,1,0
Fábio Silva,POR,FW,21,Wolves,Premier League,2.9,7,4,3,4,0,2,3,66.7,1,1,0,1,2,9,0,0
Matheus Nunes,POR,MF,24,Wolves,Premier League,2.0,3,1,3,0,0,2,6,33.3,4,0,0,0,6,9,1,0
Leon Chiwome,ENG,FW,17,Wolves,Premier League,1.9,2,1,0,1,1,1,2,50.0,1,3,1,2,0,2,2,0
Nathan Fraser,IRL,FW,18,Wolves,Premier League,2.1,5,2,2,1,2,1,3,33.3,2,2,1,1,1,6,2,0
Sasa Kalajdzic,AUT,FW,26,Wolves,Premier League,1.8,6,2,3,2,1,1,2,50.0,1,3,0,3,1,7,6,0
Tawanda Chirewa,ZIM,"MF,FW",19,Wolves,Premier League,1.6,7,3,3,3,1,2,3,66.7,1,0,0,0,1,8,0,0
Jonny Castro,ESP,MF,29,Wolves,Premier League,0.1,0,0,0,0,0,0,1,0.0,1,1,1,0,0,0,0,0
Enso Gonzalez,PAR,"MF,DF",18,Wolves,Premier League,0.0,0,0,0,0,0,0,1,0.0,1,0,0,0,0,0,0,0
Jordan Pickford,ENG,GK,29,Everton,Premier League,38.0,1,0,1,0,0,1,1,100.0,0,3,0,3,0,1,19,1
James Tarkowski,ENG,DF,30,Everton,Premier League,38.0,61,42,46,14,1,27,48,56.3,21,82,56,26,56,117,191,2
Jarrad Branthwaite,ENG,DF,21,Everton,Premier League,34.6,66,32,42,22,2,45,62,72.6,17,51,36,15,50,116,163,2
James Garner,ENG,MF,22,Everton,Premier League,33.4,83,44,32,38,13,35,82,42.7,47,45,14,31,45,128,47,1
Dwight McNeil,ENG,"MF,FW",23,Everton,Premier League,32.1,44,27,16,14,14,24,55,43.6,31,44,7,37,22,66,37,0
Abdoulaye Doucouré,MLI,"FW,MF",30,Everton,Premier League,29.2,43,27,20,14,9,18,46,39.1,28,23,3,20,15,58,19,0
Vitaliy Mykolenko,UKR,DF,24,Everton,Premier League,27.4,69,38,46,21,2,41,66,62.1,25,36,11,25,36,105,92,0
Ashley Young,ENG,"DF,MF",38,Everton,Premier League,25.3,53,38,28,19,6,30,54,55.6,24,24,6,18,22,75,50,3
Dominic Calvert-Lewin,ENG,FW,26,Everton,Premier League,24.1,13,6,2,6,5,2,15,13.3,13,14,4,10,4,17,38,0
Jack Harrison,ENG,"MF,FW",26,Everton,Premier League,24.6,37,22,12,12,13,17,49,34.7,32,25,5,20,12,49,24,0
Idrissa Gana Gueye,SEN,MF,33,Everton,Premier League,20.9,73,44,32,27,14,29,46,63.0,17,24,7,17,28,101,16,0
Amadou Onana,BEL,MF,21,Everton,Premier League,23.2,71,38,32,31,8,21,42,50.0,21,25,6,19,21,92,31,0
Ben Godfrey,ENG,DF,25,Everton,Premier League,12.4,30,20,17,8,5,15,28,53.6,13,14,8,6,16,46,57,0
Nathan Patterson,SCO,DF,21,Everton,Premier League,11.2,34,24,21,11,2,14,37,37.8,23,14,3,11,9,43,33,0
Beto,GNB,FW,25,Everton,Premier League,10.6,14,6,1,6,7,4,12,33.3,8,11,0,11,1,15,14,0
Séamus Coleman,IRL,DF,34,Everton,Premier League,7.4,17,14,10,3,4,11,16,68.8,5,12,4,8,7,24,26,1
Arnaut Danjuma,NED,"MF,FW",26,Everton,Premier League,6.6,6,4,2,3,1,1,4,25.0,3,4,0,4,3,9,0,0
Michael Keane,ENG,DF,30,Everton,Premier League,4.9,7,3,3,3,1,1,7,14.3,6,5,4,1,5,12,18,1
André Gomes,POR,"MF,FW",30,Everton,Premier League,5.6,7,4,2,3,2,3,13,23.1,10,10,1,9,3,10,4,1
Alex Iwobi,NGA,MF,27,Everton,Premier League,1.6,2,0,1,0,1,2,3,66.7,1,2,0,2,1,3,0,0
Lewis Dobbin,ENG,MF,20,Everton,Premier League,2.6,9,7,3,5,1,5,9,55.6,4,5,1,4,1,10,0,0
Youssef Chermiti,POR,FW,19,Everton,Premier League,2.3,3,2,2,1,0,1,5,20.0,4,4,1,3,1,4,2,0
Neal Maupay,FRA,FW,26,Everton,Premier League,1.2,0,0,0,0,0,0,1,0.0,1,2,0,2,0,0,1,0
Thomas Cannon,IRL,FW,20,Everton,Premier League,0.0,0,0,0,0,0,0,0,0.0,0,0,0,0,0,0,0,0
Tyler Onyango,ENG,MF,20,Everton,Premier League,0.0,0,0,0,0,0,0,0,0.0,0,0,0,0,0,0,0,0
Lewis Warrington,ENG,FW,20,Everton,Premier League,0.0,0,0,0,0,0,0,0,0.0,0,0,0,0,0,0,0,0
Mark Flekken,NED,GK,30,Brentford,Premier League,36.5,1,1,1,0,0,1,5,20.0,4,1,0,1,0,1,17,1
Vitaly Janelt,GER,"MF,DF",25,Brentford,Premier League,33.9,63,38,29,25,9,32,64,50.0,32,35,9,26,36,99,64,3
Christian Nørgaard,DEN,MF,29,Brentford,Premier League,27.8,81,50,42,31,8,32,87,36.8,55,48,6,42,54,135,50,0
Nathan Collins,IRL,DF,22,Brentford,Premier League,29.5,38,20,24,12,2,19,29,65.5,10,46,30,16,44,82,141,4
Yoane Wissa,COD,FW,26,Brentford,Premier League,27.7,28,16,13,10,5,5,20,25.0,15,24,3,21,9,37,15,0
Ethan Pinnock,JAM,DF,30,Brentford,Premier League,28.0,35,23,22,13,0,9,20,45.0,11,40,24,16,43,78,170,3
Mathias Jensen,DEN,MF,27,Brentford,Premier League,24.5,54,32,25,22,7,26,95,27.4,69,41,6,35,23,77,25,1
Mads Roerslev,DEN,DF,24,Brentford,Premier League,22.1,48,31,34,9,5,27,54,50.0,27,15,3,12,19,67,71,0
Bryan Mbeumo,CMR,FW,23,Brentford,Premier League,21.8,15,10,6,6,3,5,19,26.3,14,26,2,24,7,22,13,0
Kristoffer Ajer,NOR,DF,25,Brentford,Premier League,20.4,38,21,25,9,4,23,36,63.9,13,26,11,15,25,63,79,1
Ivan Toney,ENG,FW,27,Brentford,Premier League,16.1,15,5,2,7,6,6,14,42.9,8,5,1,4,10,25,18,0
Keane Lewis-Potter,ENG,"FW,DF",22,Brentford,Premier League,16.0,17,7,5,11,1,7,15,46.7,8,10,2,8,7,24,23,0
Ben Mee,ENG,DF,33,Brentford,Premier League,14.1,26,15,12,12,2,17,22,77.3,5,21,13,8,13,39,63,1
Sergio Reguilón,ESP,DF,26,Brentford,Premier League,12.4,45,20,26,18,1,24,40,60.0,16,23,6,17,16,61,41,1
Neal Maupay,FRA,FW,26,Brentford,Premier League,14.7,10,7,4,5,1,3,13,23.1,10,11,0,11,2,12,3,0
Mathias Jørgensen,DEN,DF,33,Brentford,Premier League,12.1,17,12,15,1,1,11,19,57.9,8,9,5,4,12,29,40,0
Frank Onyeka,NGA,MF,25,Brentford,Premier League,12.9,37,24,9,23,5,16,29,55.2,13,15,7,8,23,60,17,0
Aaron Hickey,SCO,DF,21,Brentford,Premier League,7.9,16,9,9,3,4,7,7,100.0,0,7,3,4,3,19,10,0
Mikkel Damsgaard,DEN,MF,23,Brentford,Premier League,9.4,29,17,13,9,7,14,40,35.0,26,23,1,22,11,40,10,1
Saman Ghoddos,IRN,DF,29,Brentford,Premier League,8.2,28,19,19,7,2,17,31,54.8,14,9,2,7,5,33,12,0
Yehor Yarmoliuk,UKR,MF,19,Brentford,Premier League,7.6,17,11,6,8,3,7,17,41.2,10,17,4,13,6,23,5,0
Rico Henry,ENG,DF,26,Brentford,Premier League,4.5,7,5,3,3,1,6,7,85.7,1,8,3,5,5,12,5,1
Kevin Schade,GER,"FW,MF",21,Brentford,Premier League,3.7,3,1,1,2,0,0,5,0.0,5,2,0,2,1,4,4,0
Shandon Baptiste,GRN,MF,25,Brentford,Premier League,2.5,4,4,2,2,0,1,5,20.0,4,5,1,4,3,7,6,0
Thomas Strakosha,ALB,GK,28,Brentford,Premier League,1.5,0,0,0,0,0,0,0,0.0,0,0,0,0,0,0,0,0
Michael Olakigbe,ENG,"DF,FW",19,Brentford,Premier League,0.7,3,0,2,1,0,2,4,50.0,2,7,0,7,1,4,0,1
Josh Dasilva,ENG,"DF,FW",24,Brentford,Premier League,0.3,2,1,0,1,1,0,0,0.0,0,0,0,0,0,2,0,0
Myles Peart-Harris,ENG,"DF,MF",20,Brentford,Premier League,0.1,0,0,0,0,0,0,0,0.0,0,0,0,0,0,0,1,0
Morgan Gibbs-White,ENG,"MF,FW",23,Nott'ham Forest,Premier League,35.1,36,24,6,20,10,14,33,42.4,19,31,8,23,17,53,21,0
Murillo,BRA,DF,21,Nott'ham Forest,Premier League,31.0,50,31,36,13,1,19,33,57.6,14,41,24,17,37,87,188,0
Anthony Elanga,SWE,"FW,MF",21,Nott'ham Forest,Premier League,27.0,33,19,20,6,7,17,36,47.2,19,22,2,20,8,41,20,1
Ryan Yates,ENG,MF,25,Nott'ham Forest,Premier League,22.1,66,39,39,21,6,19,34,55.9,15,42,15,27,21,87,44,1
Callum Hudson-Odoi,ENG,"FW,MF",22,Nott'ham Forest,Premier League,20.6,18,8,4,5,9,7,28,25.0,21,16,1,15,7,25,12,1
Chris Wood,NZL,FW,31,Nott'ham Forest,Premier League,20.1,7,4,1,4,2,3,9,33.3,6,11,3,8,1,8,26,0
Danilo,BRA,MF,22,Nott'ham Forest,Premier League,19.9,36,18,22,12,2,21,46,45.7,25,33,8,25,35,71,42,0
Ola Aina,NGA,DF,26,Nott'ham Forest,Premier League,18.8,47,31,31,12,4,29,41,70.7,12,19,3,16,18,65,51,1
Orel Mangala,BEL,MF,25,Nott'ham Forest,Premier League,17.4,27,13,16,10,1,14,29,48.3,15,12,6,6,26,53,32,0
Nicolás Domínguez,ARG,"MF,FW",25,Nott'ham Forest,Premier League,16.6,63,34,35,27,1,23,48,47.9,25,31,5,26,18,81,24,0
Neco Williams,WAL,DF,22,Nott'ham Forest,Premier League,18.2,69,40,42,18,9,35,56,62.5,21,44,13,31,22,91,53,0
Willy Boly,CIV,DF,32,Nott'ham Forest,Premier League,16.0,46,29,36,9,1,22,40,55.0,18,32,21,11,25,71,90,0
Matt Turner,USA,GK,29,Nott'ham Forest,Premier League,17.0,0,0,0,0,0,0,0,0.0,0,0,0,0,0,0,8,4
Matz Sels,BEL,GK,31,Nott'ham Forest,Premier League,16.0,0,0,0,0,0,0,0,0.0,0,0,0,0,0,0,11,1
Moussa Niakhate,SEN,DF,27,Nott'ham Forest,Premier League,16.2,42,25,33,9,0,20,25,80.0,5,19,12,7,14,56,51,0
Harry Toffolo,ENG,DF,27,Nott'ham Forest,Premier League,16.2,26,14,20,6,0,15,24,62.5,9,34,13,21,14,40,49,0
Ibrahim Sangaré,CIV,MF,25,Nott'ham Forest,Premier League,11.5,42,23,25,13,4,12,29,41.4,17,24,7,17,16,58,21,0
Taiwo Awoniyi,NGA,FW,25,Nott'ham Forest,Premier League,11.6,9,7,1,4,4,1,2,50.0,1,7,2,5,1,10,9,0
Serge Aurier,CIV,"DF,MF",30,Nott'ham Forest,Premier League,9.3,20,14,9,11,0,5,11,45.5,6,10,3,7,9,29,36,1
Gonzalo Montiel,ARG,DF,26,Nott'ham Forest,Premier League,8.9,22,19,12,8,2,16,29,55.2,13,8,3,5,9,31,31,1
Andrew Omobamidele,IRL,DF,21,Nott'ham Forest,Premier League,8.7,10,3,9,1,0,5,8,62.5,3,12,8,4,13,23,42,1
Divock Origi,BEL,FW,28,Nott'ham Forest,Premier League,6.7,6,4,5,0,1,0,0,0.0,0,6,0,6,2,8,4,0
Nuno Tavares,POR,DF,23,Nott'ham Forest,Premier League,5.1,11,7,9,1,1,8,9,88.9,1,6,0,6,1,12,21,0
Odisseas Vlachodimos,GRE,GK,29,Nott'ham Forest,Premier League,5.0,0,0,0,0,0,0,1,0.0,1,0,0,0,0,0,1,0
Joe Worrall,ENG,DF,26,Nott'ham Forest,Premier League,4.9,7,5,6,1,0,3,6,50.0,3,5,4,1,3,10,32,1
Scott McKenna,SCO,DF,26,Nott'ham Forest,Premier League,4.6,4,0,3,1,0,2,3,66.7,1,6,4,2,5,9,27,0
Felipe,BRA,DF,34,Nott'ham Forest,Premier League,4.2,12,9,9,3,0,9,12,75.0,3,4,1,3,4,16,12,0
Brennan Johnson,WAL,"FW,MF",22,Nott'ham Forest,Premier League,2.6,4,1,1,1,2,2,4,50.0,2,4,1,3,0,4,0,0
Gio Reyna,USA,"FW,MF",20,Nott'ham Forest,Premier League,2.6,7,3,4,0,3,3,6,50.0,3,3,0,3,2,9,0,0
Cheikhou Kouyaté,SEN,MF,33,Nott'ham Forest,Premier League,2.4,8,5,3,3,2,1,4,25.0,3,4,1,3,2,10,10,0
Rodrigo Ribeiro,POR,"MF,FW",18,Nott'ham Forest,Premier League,0.2,0,0,0,0,0,0,1,0.0,1,1,0,1,1,1,0,0
Andrey Santos,BRA,MF,19,Nott'ham Forest,Premier League,0.1,0,0,0,0,0,0,0,0.0,0,1,0,1,0,0,0,0
Brandon Aguilera,CRC,FW,20,Nott'ham Forest,Premier League,0.1,0,0,0,0,0,0,0,0.0,0,0,0,0,0,0,0,0
Thomas Kaminski,BEL,GK,30,Luton Town,Premier League,37.8,2,1,2,0,0,2,6,33.3,4,1,0,1,0,2,14,2
Alfie Doughty,ENG,DF,23,Luton Town,Premier League,32.5,63,40,29,18,16,37,82,45.1,45,51,9,42,31,94,43,4
Carlton Morris,ENG,"FW,MF",27,Luton Town,Premier League,31.8,15,8,4,6,5,9,15,60.0,6,24,5,19,1,16,53,0
Ross Barkley,ENG,MF,29,Luton Town,Premier League,29.1,47,19,16,21,10,11,48,22.9,37,25,9,16,25,72,51,2
Teden Mengi,ENG,DF,21,Luton Town,Premier League,27.4,54,22,33,20,1,19,30,63.3,11,39,27,12,57,111,140,1
Gabriel Osho,NGA,DF,24,Luton Town,Premier League,20.5,41,22,21,19,1,16,27,59.3,11,37,20,17,31,72,92,0
Issa Kaboré,BFA,DF,22,Luton Town,Premier League,19.2,52,28,23,21,8,24,45,53.3,21,22,11,11,16,68,56,2
Amari'i Bell,JAM,DF,29,Luton Town,Premier League,19.1,50,33,30,19,1,22,35,62.9,13,33,15,18,25,75,60,1
Chiedozie Ogbene,IRL,"MF,DF",26,Luton Town,Premier League,22.2,17,10,10,7,0,12,22,54.5,10,14,3,11,7,24,34,2
Tahith Chong,NED,"MF,FW",23,Luton Town,Premier League,22.0,36,22,19,13,4,15,33,45.5,18,30,6,24,8,44,11,1
Reece Burke,ENG,DF,26,Luton Town,Premier League,18.4,37,23,17,14,6,12,26,46.2,14,25,18,7,18,55,78,1
Elijah Adebayo,ENG,FW,25,Luton Town,Premier League,15.8,4,1,1,0,3,1,12,8.3,11,13,2,11,6,10,25,0
Albert Sambi Lokonga,BEL,MF,23,Luton Town,Premier League,14.5,29,18,14,12,3,17,24,70.8,7,23,13,10,11,40,14,0
Jordan Clark,ENG,MF,29,Luton Town,Premier League,14.5,30,17,14,11,5,11,39,28.2,28,24,3,21,11,41,15,1
Andros Townsend,ENG,"MF,FW",32,Luton Town,Premier League,13.4,21,13,11,2,8,13,27,48.1,14,12,0,12,5,26,10,0
Tom Lockyer,WAL,DF,28,Luton Town,Premier League,13.0,25,16,17,6,2,15,22,68.2,7,23,13,10,23,48,68,0
Marvelous Nakamba,ZIM,MF,29,Luton Town,Premier League,12.6,40,24,24,14,2,24,42,57.1,18,23,6,17,11,51,11,1
Jacob Brown,SCO,"MF,FW",25,Luton Town,Premier League,11.3,19,12,7,7,5,7,18,38.9,11,20,1,19,8,27,22,0
Pelly Ruddock Mpanzu,COD,MF,30,Luton Town,Premier League,12.2,13,5,6,6,1,5,9,55.6,4,15,7,8,9,22,16,3
Daiki Hashioka,JPN,DF,24,Luton Town,Premier League,6.6,11,5,6,4,1,5,11,45.5,6,12,7,5,8,19,20,0
Ryan John Giles,ENG,"DF,MF",23,Luton Town,Premier League,5.6,8,6,4,3,1,2,7,28.6,5,2,0,2,4,12,22,0
Fred Onyedinma,ENG,"DF,MF",26,Luton Town,Premier League,4.5,10,6,7,3,0,5,12,41.7,7,3,0,3,1,11,13,0
Mads Juel Andersen,DEN,DF,25,Luton Town,Premier League,4.4,6,5,4,2,0,4,4,100.0,0,9,6,3,8,14,29,0
Cauley Woodrow,ENG,"FW,MF",28,Luton Town,Premier League,4.7,16,10,8,4,4,9,16,56.3,7,7,1,6,1,17,14,0
Luke Berry,ENG,"MF,DF",31,Luton Town,Premier League,3.6,7,2,2,4,1,2,3,66.7,1,6,1,5,0,7,3,0
Joseph Johnson,ENG,DF,17,Luton Town,Premier League,0.9,0,0,0,0,0,0,1,0.0,1,0,0,0,0,0,0,0
James Shea,ENG,GK,32,Luton Town,Premier League,0.2,0,0,0,0,0,0,0,0.0,0,0,0,0,0,0,2,0
Zack Nelson,ENG,"MF,DF",18,Luton Town,Premier League,0.1,1,0,1,0,0,0,0,0.0,0,0,0,0,0,1,0,0
Sander Berge,NOR,MF,25,Burnley,Premier League,33.4,76,46,35,36,5,34,58,58.6,24,49,20,29,23,99,60,2
Dara O'Shea,IRL,DF,24,Burnley,Premier League,32.1,39,20,22,14,3,11,26,42.3,15,41,30,11,35,74,158,2
James Trafford,ENG,GK,20,Burnley,Premier League,28.0,2,1,2,0,0,2,2,100.0,0,0,0,0,1,3,18,1
Zeki Amdouni,SUI,FW,22,Burnley,Premier League,21.7,27,18,1,15,11,7,25,28.0,18,23,10,13,9,36,10,0
Vitinho,BRA,"DF,MF",24,Burnley,Premier League,25.7,64,34,36,22,6,43,86,50.0,43,44,6,38,12,76,47,4
Charlie Taylor,ENG,DF,29,Burnley,Premier League,25.9,35,20,19,14,2,17,35,48.6,18,27,11,16,19,54,78,0
Wilson Odobert,FRA,"MF,FW",18,Burnley,Premier League,23.3,17,13,8,5,4,6,22,27.3,16,26,2,24,6,23,14,0
Josh Brownhill,ENG,MF,27,Burnley,Premier League,25.0,61,35,23,28,10,27,37,73.0,10,33,8,25,34,95,40,1
Josh Cullen,IRL,MF,27,Burnley,Premier League,22.9,42,29,15,22,5,26,46,56.5,20,31,19,12,15,57,26,1
Lyle Foster,RSA,"FW,MF",22,Burnley,Premier League,21.1,19,10,5,6,8,6,17,35.3,11,13,3,10,3,22,34,0
Jacob Bruun Larsen,DEN,"MF,FW",24,Burnley,Premier League,13.9,9,4,4,3,2,7,21,33.3,14,16,2,14,7,16,23,0
Maxime Estève,FRA,DF,21,Burnley,Premier League,14.5,27,10,15,12,0,18,32,56.3,14,21,10,11,27,54,56,0
Lorenz Assignon,TOG,DF,23,Burnley,Premier League,13.7,35,17,18,13,4,14,27,51.9,13,22,7,15,19,54,43,1
Jordan Beyer,GER,DF,23,Burnley,Premier League,13.7,35,20,22,12,1,14,24,58.3,10,22,15,7,16,51,68,1
Luca Koleosho,ITA,"MF,FW",18,Burnley,Premier League,10.8,7,4,2,5,0,2,10,20.0,8,13,0,13,2,9,0,0
Jóhann Berg Guðmundsson,ISL,"MF,FW",32,Burnley,Premier League,13.2,13,4,6,5,2,7,16,43.8,9,14,0,14,16,29,16,0
Ameen Al-Dakhil,BEL,DF,21,Burnley,Premier League,11.7,12,5,4,7,1,1,10,10.0,9,13,6,7,12,24,38,2
Arijanet Muric,KVX,GK,24,Burnley,Premier League,10.0,1,1,1,0,0,1,1,100.0,0,0,0,0,0,1,10,4
David Datro Fofana,CIV,FW,20,Burnley,Premier League,9.8,10,5,3,5,2,3,6,50.0,3,9,3,6,1,11,2,0
Connor Roberts,WAL,DF,27,Burnley,Premier League,9.1,12,5,6,4,2,8,17,47.1,9,8,6,2,4,16,25,2
Jay Rodriguez,ENG,FW,34,Burnley,Premier League,9.1,14,9,7,4,3,7,13,53.8,6,11,1,10,1,15,8,0
Hannes Delcroix,BEL,DF,24,Burnley,Premier League,6.5,10,6,6,4,0,3,4,75.0,1,9,3,6,9,19,26,0
Aaron Ramsey,ENG,"MF,FW",20,Burnley,Premier League,5.9,17,14,7,5,5,8,16,50.0,8,11,2,9,1,18,10,0
Hjalmar Ekdal,SWE,DF,24,Burnley,Premier League,4.9,4,2,2,2,0,2,4,50.0,2,10,5,5,6,10,21,0
Mike Trésor,BEL,"FW,MF",24,Burnley,Premier League,4.7,10,6,9,1,0,8,18,44.4,10,5,0,5,1,11,1,0
Anass Zaroury,MAR,"FW,MF",22,Burnley,Premier League,1.7,1,0,1,0,0,0,4,0.0,4,2,0,2,0,1,1,1
Benson Manuel,BEL,"MF,FW",26,Burnley,Premier League,1.3,3,2,2,1,0,0,0,0.0,0,1,0,1,0,3,0,0
Nathan Redmond,ENG,"FW,MF",29,Burnley,Premier League,1.6,2,1,0,0,2,1,4,25.0,3,1,0,1,0,2,3,0
Jack Cork,ENG,MF,34,Burnley,Premier League,0.3,2,0,0,2,0,1,3,33.3,2,0,0,0,1,3,1,0
Michael Obafemi,IRL,"FW,MF",23,Burnley,Premier League,0.2,0,0,0,0,0,0,0,0.0,0,1,0,1,0,0,0,0
Han-Noah Massengo,FRA,"MF,DF",22,Burnley,Premier League,0.2,1,1,1,0,0,0,0,0.0,0,1,0,1,0,1,0,0
Gustavo Hamer,NED,MF,26,Sheffield Utd,Premier League,32.3,39,21,17,15,7,16,59,27.1,43,33,9,24,29,68,35,0
Jayden Bogle,ENG,DF,23,Sheffield Utd,Premier League,31.0,66,36,43,21,2,35,70,50.0,35,42,11,31,32,98,97,0
Jack Robinson,ENG,DF,29,Sheffield Utd,Premier League,32.1,43,28,29,14,0,25,39,64.1,14,49,33,16,33,76,132,2
Vinicius Souza,BRA,MF,24,Sheffield Utd,Premier League,29.6,125,76,59,51,15,41,74,55.4,33,57,17,40,32,157,75,1
Anel Ahmedhodžić,BIH,DF,24,Sheffield Utd,Premier League,29.4,64,36,48,14,2,30,49,61.2,19,43,26,17,35,99,137,2
Wes Foderingham,ENG,GK,32,Sheffield Utd,Premier League,29.4,5,3,5,0,0,5,6,83.3,1,0,0,0,0,5,18,6
Auston Trusty,USA,DF,24,Sheffield Utd,Premier League,28.6,47,30,31,13,3,21,43,48.8,22,41,22,19,35,82,153,3
Cameron Archer,ENG,"FW,MF",22,Sheffield Utd,Premier League,20.4,18,13,6,6,6,8,18,44.4,10,22,3,19,1,19,11,0
James Mcatee,ENG,"MF,FW",20,Sheffield Utd,Premier League,20.2,32,21,9,13,10,13,33,39.4,20,20,0,20,11,43,18,0
Oliver Norwood,NIR,MF,32,Sheffield Utd,Premier League,16.0,41,26,18,18,5,20,47,42.6,27,24,9,15,21,62,39,0
Oliver McBurnie,SCO,FW,27,Sheffield Utd,Premier League,14.2,17,7,4,7,6,5,12,41.7,7,18,2,16,5,22,28,0
Ben Osborn,ENG,"DF,MF",28,Sheffield Utd,Premier League,15.2,22,9,11,9,2,8,17,47.1,9,18,2,16,8,30,30,0
Ben Brereton,CHI,"FW,MF",24,Sheffield Utd,Premier League,12.3,9,4,4,4,1,4,10,40.0,6,9,3,6,3,12,12,0
Andre Brooks,ENG,"MF,DF",19,Sheffield Utd,Premier League,10.4,22,13,7,11,4,9,21,42.9,12,13,1,12,14,36,20,0
George Baldock,GRE,DF,30,Sheffield Utd,Premier League,10.8,18,10,10,7,1,6,15,40.0,9,14,8,6,10,28,33,0
Oliver Arblaster,ENG,MF,19,Sheffield Utd,Premier League,10.5,23,14,11,8,4,7,15,46.7,8,17,7,10,15,38,9,0
Luke Thomas,ENG,DF,22,Sheffield Utd,Premier League,10.2,20,9,13,6,1,8,14,57.1,6,23,5,18,10,30,27,0
William Osula,DEN,FW,19,Sheffield Utd,Premier League,8.7,2,2,1,0,1,1,2,50.0,1,3,1,2,2,4,9,0
Ivo Grbić,CRO,GK,27,Sheffield Utd,Premier League,8.6,0,0,0,0,0,0,1,0.0,1,1,0,1,0,0,9,1
Mason Holgate,ENG,DF,26,Sheffield Utd,Premier League,7.9,12,7,5,6,1,5,12,41.7,7,12,5,7,11,23,40,0
Yasser Larouci,ALG,DF,22,Sheffield Utd,Premier League,5.9,17,9,10,5,2,10,14,71.4,4,6,1,5,7,24,20,1
John Egan,IRL,DF,30,Sheffield Utd,Premier League,5.4,6,4,4,2,0,4,11,36.4,7,10,4,6,13,19,39,1
Max Lowe,ENG,"DF,MF",26,Sheffield Utd,Premier League,5.6,21,10,13,5,3,8,15,53.3,7,10,4,6,5,26,15,0
Anis Ben Slimane,TUN,MF,22,Sheffield Utd,Premier League,4.7,11,6,5,2,4,4,10,40.0,6,7,1,6,5,16,7,0
Bénie Adama Traore,CIV,"FW,MF",20,Sheffield Utd,Premier League,4.3,4,2,1,2,1,0,4,0.0,4,4,1,3,1,5,1,0
Rhian Brewster,ENG,"FW,MF",23,Sheffield Utd,Premier League,3.8,5,1,1,2,2,0,2,0.0,2,2,0,2,1,6,2,0
Chris Basham,ENG,"DF,MF",35,Sheffield Utd,Premier League,3.6,7,2,4,3,0,2,9,22.2,7,9,4,5,5,12,17,0
Tom Davies,ENG,MF,25,Sheffield Utd,Premier League,2.5,10,5,4,3,3,3,9,33.3,6,2,1,1,3,13,6,1
Rhys Norrington-Davies,WAL,DF,24,Sheffield Utd,Premier League,1.2,1,1,1,0,0,0,1,0.0,1,2,0,2,1,2,2,0
John Fleck,SCO,"MF,DF",31,Sheffield Utd,Premier League,1.0,1,0,0,1,0,0,1,0.0,1,0,0,0,0,1,1,0
Sam Curtis,IRL,DF,17,Sheffield Utd,Premier League,0.3,1,0,1,0,0,1,2,50.0,1,2,0,2,0,1,0,0
Daniel Jebbison,ENG,FW,19,Sheffield Utd,Premier League,0.2,0,0,0,0,0,0,0,0.0,0,1,0,1,0,0,0,0
Antwoine Hackford,ENG,FW,19,Sheffield Utd,Premier League,0.1,0,0,0,0,0,0,0,0.0,0,0,0,0,0,0,0,0
Sydie Peck,ENG,MF,18,Sheffield Utd,Premier League,0.1,0,0,0,0,0,0,0,0.0,0,0,0,0,0,0,0,0
Ryan One,SCO,FW,17,Sheffield Utd,Premier League,0.1,0,0,0,0,0,0,0,0.0,0,0,0,0,0,0,0,0
Brandon Mechele,BEL,DF,30,Club Brugge,Pro League,29.8,51,32,33,14,4,27,39,69.2,12,37,17,20,46,97,111,0
Hans Vanaken,BEL,MF,30,Club Brugge,Pro League,28.2,42,24,8,23,11,17,34,50.0,17,22,4,18,12,54,27,0
Simon Mignolet,BEL,GK,35,Club Brugge,Pro League,27.1,0,0,0,0,0,0,1,0.0,1,0,0,0,0,0,12,0
Andreas Skov Olsen,DEN,FW,23,Club Brugge,Pro League,23.6,34,22,10,10,14,17,42,40.5,25,18,0,18,15,49,11,0
Maxim De Cuyper,BEL,DF,22,Club Brugge,Pro League,24.0,46,27,25,14,7,26,57,45.6,31,29,4,25,36,82,31,0
Hugo Vetlesen,NOR,MF,23,Club Brugge,Pro League,20.6,56,38,17,33,6,24,39,61.5,15,24,2,22,19,75,23,0
Jorne Spileers,BEL,DF,18,Club Brugge,Pro League,22.9,10,6,7,2,1,4,14,28.6,10,16,11,5,26,36,82,0
Thiago,BRA,FW,22,Club Brugge,Pro League,20.4,25,16,3,17,5,7,16,43.8,9,26,3,23,4,29,16,0
Philip Zinckernagel,DEN,"FW,MF",28,Club Brugge,Pro League,16.8,27,19,8,13,6,15,35,42.9,20,16,2,14,6,33,2,0
Raphael Onyedika,NGA,MF,22,Club Brugge,Pro League,17.6,46,33,22,20,4,25,41,61.0,16,27,3,24,11,57,7,2
Bjorn Meijer,NED,DF,20,Club Brugge,Pro League,14.9,15,13,8,6,1,8,13,61.5,5,18,4,14,17,32,27,0
Casper Nielsen,DEN,MF,29,Club Brugge,Pro League,14.2,33,22,9,16,8,15,33,45.5,18,22,6,16,12,45,15,0
Jutglà,ESP,FW,24,Club Brugge,Pro League,13.7,8,8,2,5,1,3,7,42.9,4,8,0,8,5,13,2,0
Tajon Buchanan,CAN,DF,24,Club Brugge,Pro League,9.2,10,6,6,1,3,5,16,31.3,11,13,0,13,6,16,8,1
Antonio Nusa,NOR,"FW,MF",18,Club Brugge,Pro League,11.2,20,17,5,12,3,14,26,53.8,12,13,0,13,7,27,2,0
Joel Ordóñez,ECU,DF,19,Club Brugge,Pro League,5.2,7,4,6,1,0,5,5,100.0,0,6,4,2,2,9,14,0
Denis Odoi,GHA,"DF,MF",35,Club Brugge,Pro League,6.4,15,10,10,5,0,10,14,71.4,4,7,3,4,4,19,12,0
Kyriani Sabbe,BEL,DF,18,Club Brugge,Pro League,6.3,12,9,8,3,1,6,11,54.5,5,8,4,4,7,19,6,0
Eder Álvarez Balanta,COL,MF,30,Club Brugge,Pro League,5.5,12,6,4,6,2,6,14,42.9,8,11,2,9,16,28,12,0
Michał Skóraś,POL,"FW,MF",23,Club Brugge,Pro League,5.0,7,4,1,5,1,3,9,33.3,6,9,2,7,6,13,4,0
Nordin Jackers,BEL,GK,25,Club Brugge,Pro League,2.9,1,1,1,0,0,1,1,100.0,0,1,0,1,0,1,5,1
Dedryck Boyata,BEL,"DF,MF",32,Club Brugge,Pro League,2.0,1,0,1,0,0,0,1,0.0,1,1,1,0,2,3,4,0
Mats Rits,BEL,MF,30,Club Brugge,Pro League,0.9,0,0,0,0,0,0,0,0.0,0,1,0,1,3,3,2,0
Roman Yaremchuk,UKR,FW,27,Club Brugge,Pro League,0.7,1,1,0,0,1,0,1,0.0,1,0,0,0,0,1,2,0
Víctor Barberá,ESP,"FW,MF",18,Club Brugge,Pro League,0.4,1,1,0,1,0,0,0,0.0,0,1,0,1,1,2,0,0
Chemsdine Talbi,BEL,"DF,FW",18,Club Brugge,Pro League,0.1,0,0,0,0,0,0,0,0.0,0,0,0,0,0,0,0,0
Romeo Vermant,BEL,FW,19,Club Brugge,Pro League,0.1,1,1,1,0,0,0,0,0.0,0,0,0,0,0,1,0,0
Shion Homma,JPN,FW,22,Club Brugge,Pro League,0.1,0,0,0,0,0,0,0,0.0,0,0,0,0,0,0,0,0
Abdoul Kader Yaméogo,CIV,DF,18,Club Brugge,Pro League,0.1,0,0,0,0,0,0,0,0.0,0,0,0,0,0,0,0,0
Anthony Moris,LUX,GK,33,Union SG,Pro League,28.8,0,0,0,0,0,0,2,0.0,2,0,0,0,0,0,8,3
Cameron Puertas,SUI,MF,24,Union SG,Pro League,26.9,77,47,14,37,26,24,67,35.8,43,39,1,38,19,96,10,0
Christian Burgess,ENG,DF,31,Union SG,Pro League,27.5,46,25,33,13,0,28,45,62.2,17,28,18,10,33,79,133,1
Charles Vanhoutte,BEL,MF,24,Union SG,Pro League,24.8,49,38,20,25,4,23,59,39.0,36,44,2,42,50,99,30,0
Loïc Lapoussin,MAD,"DF,MF",27,Union SG,Pro League,23.0,46,30,22,16,8,33,73,45.2,40,38,1,37,26,72,10,0
Koki Machida,JPN,DF,25,Union SG,Pro League,22.2,43,30,28,14,1,32,54,59.3,22,30,10,20,33,76,74,2
Alessio Castro-Montes,BEL,DF,26,Union SG,Pro League,20.8,62,42,29,20,13,38,63,60.3,25,35,6,29,30,92,32,0
Kevin Mac Allister,ARG,DF,25,Union SG,Pro League,21.0,63,44,38,21,4,37,64,57.8,27,41,12,29,42,105,68,1
Mathias Rasmussen,NOR,MF,25,Union SG,Pro League,17.5,38,30,9,23,6,24,44,54.5,20,22,6,16,21,59,13,0
Gustaf Nilsson,SWE,FW,26,Union SG,Pro League,16.1,11,9,1,4,6,5,11,45.5,6,14,1,13,7,18,17,0
Mohamed Amoura,ALG,FW,23,Union SG,Pro League,15.9,17,8,2,6,9,9,28,32.1,19,9,0,9,4,21,0,0
Jean Thierry Lazare,CIV,"MF,FW",25,Union SG,Pro League,15.1,38,25,13,19,6,19,31,61.3,12,27,1,26,11,49,8,0
Ross Sykes,ENG,DF,24,Union SG,Pro League,14.1,24,16,12,11,1,14,25,56.0,11,17,11,6,23,47,63,3
Dennis Eckert,GER,FW,26,Union SG,Pro League,12.6,4,4,2,1,1,1,2,50.0,1,5,1,4,3,7,10,0
Noah Sadiki,BEL,MF,18,Union SG,Pro League,12.7,37,22,10,20,7,14,29,48.3,15,18,3,15,17,54,14,0
Casper Terho,FIN,DF,20,Union SG,Pro League,10.9,32,18,12,14,6,17,36,47.2,19,16,0,16,13,45,10,1
Fedde Leysen,BEL,DF,20,Union SG,Pro League,3.7,6,3,4,1,1,2,6,33.3,4,8,3,5,4,10,17,0
Kevin Rodríguez,ECU,FW,23,Union SG,Pro League,4.9,2,0,1,1,0,1,3,33.3,2,2,1,1,1,3,2,0
Henok Teklab,GER,DF,24,Union SG,Pro League,3.8,13,12,7,5,1,4,9,44.4,5,4,0,4,3,16,3,0
Senne Lynen,BEL,MF,24,Union SG,Pro League,2.0,1,1,1,0,0,0,3,0.0,3,4,0,4,4,5,3,0
Bart Nieuwkoop,NED,DF,27,Union SG,Pro League,2.0,2,2,0,2,0,1,8,12.5,7,2,0,2,4,6,3,0
Heinz Lindner,AUT,GK,33,Union SG,Pro League,1.0,0,0,0,0,0,0,0,0.0,0,0,0,0,0,0,1,0
Guillaume François,BEL,DF,33,Union SG,Pro League,0.8,1,1,0,1,0,1,1,100.0,0,0,0,0,1,2,2,0
Elton Kabangu,BEL,"FW,MF",25,Union SG,Pro League,1.4,7,5,3,4,0,3,4,75.0,1,1,0,1,0,7,1,0
Joachim Imbrechts,SWE,GK,21,Union SG,Pro League,0.2,0,0,0,0,0,0,0,0.0,0,0,0,0,0,0,0,0
Nathan Huygevelde,BEL,MF,19,Union SG,Pro League,0.0,0,0,0,0,0,0,0,0.0,0,0,0,0,0,0,0,0
Zeno Debast,BEL,DF,19,Anderlecht,Pro League,27.5,43,29,30,11,2,18,30,60.0,12,35,24,11,22,65,127,1
Kasper Dolberg,DEN,FW,25,Anderlecht,Pro League,23.9,13,8,3,6,4,4,16,25.0,12,18,3,15,4,17,29,0
Jan Vertonghen,BEL,DF,36,Anderlecht,Pro League,26.9,21,10,10,10,1,7,12,58.3,5,29,22,7,22,43,120,4
Anders Dreyer,DEN,"FW,MF",25,Anderlecht,Pro League,24.9,17,8,8,6,3,8,25,32.0,17,20,1,19,10,27,16,0
Mats Rits,BEL,MF,30,Anderlecht,Pro League,23.7,34,16,14,19,1,19,40,47.5,21,36,12,24,21,55,50,0
Kasper Schmeichel,DEN,GK,36,Anderlecht,Pro League,23.0,0,0,0,0,0,0,3,0.0,3,1,0,1,0,0,6,1
Killian Sardella,BEL,DF,21,Anderlecht,Pro League,22.0,41,19,25,11,5,21,41,51.2,20,27,9,18,16,57,70,0
Theo Leoni,BEL,MF,23,Anderlecht,Pro League,21.1,65,39,24,32,9,32,62,51.6,30,38,2,36,40,105,21,1
Mario Stroeykens,BEL,"MF,FW",18,Anderlecht,Pro League,18.8,53,38,17,25,11,23,40,57.5,17,24,6,18,14,67,12,0
Ludwig Augustinsson,SWE,DF,29,Anderlecht,Pro League,18.1,34,19,19,9,6,17,28,60.7,11,11,1,10,25,59,40,0
Thorgan Hazard,BEL,"FW,MF",30,Anderlecht,Pro League,15.3,41,31,14,14,13,16,32,50.0,16,20,2,18,8,49,10,0
Yari Verschaeren,BEL,"MF,FW",22,Anderlecht,Pro League,10.3,32,16,11,19,2,6,21,28.6,15,18,2,16,11,43,12,0
Thomas Delaney,DEN,"MF,DF",31,Anderlecht,Pro League,10.1,21,15,12,6,3,8,20,40.0,12,12,3,9,16,37,34,0
Louis Patris,BEL,DF,22,Anderlecht,Pro League,10.4,42,20,21,14,7,18,33,54.5,15,20,4,16,25,67,26,1
Maxime Dupé,FRA,GK,30,Anderlecht,Pro League,7.0,0,0,0,0,0,0,0,0.0,0,0,0,0,0,0,1,0
Moussa N'Diaye,SEN,DF,21,Anderlecht,Pro League,7.2,19,15,16,3,0,10,15,66.7,5,12,4,8,11,30,20,0
Kristian Arnstad,NOR,"DF,MF",19,Anderlecht,Pro League,7.2,12,5,9,1,2,9,14,64.3,5,6,2,4,5,17,21,1
Amadou Diawara,GUI,MF,26,Anderlecht,Pro League,6.6,17,8,10,6,1,12,14,85.7,2,2,0,2,12,29,8,0
Francis Amuzu,BEL,FW,23,Anderlecht,Pro League,6.3,6,2,2,1,3,4,6,66.7,2,3,1,2,1,7,2,0
Alexis Flips,FRA,"FW,MF",23,Anderlecht,Pro League,4.2,14,8,3,6,5,9,22,40.9,13,5,0,5,3,17,0,0
Luis Vázquez,ARG,FW,22,Anderlecht,Pro League,7.7,10,4,3,4,3,4,10,40.0,6,2,1,1,1,11,8,0
Benito Raman,BEL,FW,28,Anderlecht,Pro League,3.1,3,3,1,0,2,2,11,18.2,9,3,1,2,4,7,2,0
Majeed Ashimeru,GHA,MF,25,Anderlecht,Pro League,1.3,5,4,1,3,1,2,5,40.0,3,1,1,0,6,11,3,1
Federico Gattoni,ARG,DF,24,Anderlecht,Pro League,1.1,3,1,1,2,0,1,1,100.0,0,2,2,0,1,4,4,0
Nilson Angulo,ECU,"FW,MF",20,Anderlecht,Pro League,0.5,0,0,0,0,0,0,0,0.0,0,2,0,2,2,2,0,0
Justin Lonwijk,SUR,"MF,FW",23,Anderlecht,Pro League,0.5,1,1,1,0,0,1,5,20.0,4,1,0,1,1,2,2,0
Marco Kana,BEL,MF,20,Anderlecht,Pro League,0.2,0,0,0,0,0,0,0,0.0,0,0,0,0,0,0,1,0
Antoine Colassin,BEL,FW,22,Anderlecht,Pro League,0.1,0,0,0,0,0,0,1,0.0,1,1,0,1,0,0,0,0
Hannes Delcroix,BEL,DF,24,Anderlecht,Pro League,0.1,1,1,0,1,0,0,0,0.0,0,1,0,1,1,2,1,0
Mohamed Bouchouari,BEL,DF,22,Anderlecht,Pro League,0.0,0,0,0,0,0,0,0,0.0,0,0,0,0,0,0,0,0
Tristan Degreef,BEL,MF,18,Anderlecht,Pro League,0.0,0,0,0,0,0,0,0,0.0,0,0,0,0,0,0,0,0
Luca Monticelli,BEL,MF,18,Anderlecht,Pro League,0.0,0,0,0,0,0,0,0,0.0,0,0,0,0,0,0,0,0
Warleson,BRA,GK,26,Cercle Brugge,Pro League,30.0,0,0,0,0,0,0,0,0.0,0,0,0,0,0,0,22,1
Jesper Daland,NOR,DF,23,Cercle Brugge,Pro League,28.1,50,36,28,18,4,33,47,70.2,14,33,13,20,43,93,118,0
Kévin Denkey,TOG,FW,22,Cercle Brugge,Pro League,27.7,16,7,1,7,8,5,12,41.7,7,19,0,19,3,19,8,0
Thibo Somers,BEL,"FW,MF",24,Cercle Brugge,Pro League,25.5,58,40,26,17,15,26,63,41.3,37,51,5,46,20,78,36,0
Boris Popović,SRB,DF,23,Cercle Brugge,Pro League,22.2,35,25,17,17,1,10,19,52.6,9,21,10,11,42,77,73,1
Hannes Van der Bruggen,BEL,MF,30,Cercle Brugge,Pro League,20.7,54,28,15,31,8,29,81,35.8,52,37,3,34,25,79,49,0
Leonardo da Silva Lopes,POR,"MF,DF",24,Cercle Brugge,Pro League,19.8,37,21,14,16,7,13,28,46.4,15,38,6,32,30,67,28,0
Hugo Siquet,BEL,DF,21,Cercle Brugge,Pro League,18.0,68,45,42,16,10,52,101,51.5,49,45,5,40,35,103,38,0
Edgaras Utkus,LTU,DF,23,Cercle Brugge,Pro League,15.9,62,40,35,24,3,34,55,61.8,21,18,3,15,28,90,69,3
Félix Lemaréchal,FRA,"MF,FW",19,Cercle Brugge,Pro League,17.4,49,29,23,18,8,18,37,48.6,19,34,5,29,13,62,19,0
Alan Minda,ECU,"FW,MF",20,Cercle Brugge,Pro League,16.8,10,6,1,3,6,5,16,31.3,11,14,0,14,1,11,2,0
Yann Gboho,FRA,"MF,FW",22,Cercle Brugge,Pro League,15.4,16,11,2,7,7,5,16,31.3,11,20,0,20,8,24,3,0
Flávio Nazinho,POR,"DF,FW",20,Cercle Brugge,Pro League,12.6,29,14,10,16,3,17,37,45.9,20,25,1,24,12,41,24,1
Christiaan Ravych,BEL,DF,21,Cercle Brugge,Pro League,11.9,35,27,21,12,2,21,37,56.8,16,17,5,12,18,53,29,1
Nils De Wilde,BEL,MF,20,Cercle Brugge,Pro League,8.0,19,8,5,12,2,11,31,35.5,20,16,0,16,5,24,5,0
Senna Miangue,BEL,DF,26,Cercle Brugge,Pro League,8.0,17,12,9,8,0,11,24,45.8,13,9,2,7,11,28,30,1
Jordan Semedo,FRA,DF,20,Cercle Brugge,Pro League,5.4,11,10,7,3,1,7,11,63.6,4,9,1,8,7,18,10,0
Francis Abu,GHA,MF,22,Cercle Brugge,Pro League,4.5,18,8,4,12,2,11,13,84.6,2,7,0,7,8,26,2,0
Felipe Augusto,BRA,"FW,MF",19,Cercle Brugge,Pro League,4.9,4,3,1,2,1,2,6,33.3,4,10,0,10,1,5,4,0
Olivier Deman,BEL,"DF,MF",23,Cercle Brugge,Pro League,4.2,15,11,7,3,5,5,15,33.3,10,19,2,17,9,24,10,0
Kazeem Olaigbe,BEL,"FW,MF",20,Cercle Brugge,Pro League,6.7,10,8,2,4,4,4,17,23.5,13,8,0,8,3,13,6,0
Malamine Efekele,FRA,"FW,MF",19,Cercle Brugge,Pro League,2.0,6,4,3,2,1,2,4,50.0,2,3,0,3,0,6,5,0
Jonas Lietaert,BEL,"DF,MF",19,Cercle Brugge,Pro League,1.9,11,8,3,6,2,5,11,45.5,6,7,1,6,4,15,10,0
Kader Ouattara,BFA,"FW,MF",18,Cercle Brugge,Pro League,0.5,0,0,0,0,0,0,0,0.0,0,2,0,2,1,1,1,0
Emilio Kehrer,GER,"MF,DF",21,Cercle Brugge,Pro League,0.4,2,2,1,1,0,1,3,33.3,2,4,1,3,0,2,0,0
Romaric Etonde,FRA,MF,18,Cercle Brugge,Pro League,0.1,0,0,0,0,0,0,0,0.0,0,1,0,1,0,0,0,0
Robbe Decostere,BEL,DF,25,Cercle Brugge,Pro League,0.0,0,0,0,0,0,0,0,0.0,0,0,0,0,0,0,1,0
Maarten Vandevoordt,BEL,GK,21,Genk,Pro League,30.0,0,0,0,0,0,0,0,0.0,0,1,0,1,1,1,8,3
Bilal El Khannouss,MAR,MF,19,Genk,Pro League,24.2,52,34,20,16,16,23,40,57.5,17,24,1,23,7,59,12,0
Bryan Heynen,BEL,MF,26,Genk,Pro League,23.5,53,31,16,27,10,22,41,53.7,19,31,9,22,29,82,52,0
Carlos Cuesta,COL,DF,24,Genk,Pro League,22.8,37,21,22,12,3,15,23,65.2,8,14,3,11,35,72,62,1
Patrik Hrošovský,SVK,MF,31,Genk,Pro League,23.7,25,16,12,11,2,13,27,48.1,14,27,4,23,18,43,33,0
Mark McKenzie,USA,DF,24,Genk,Pro League,20.9,20,13,11,9,0,5,10,50.0,5,33,20,13,26,46,86,1
Joseph Paintsil,GHA,FW,25,Genk,Pro League,19.8,14,9,3,6,5,5,10,50.0,5,10,1,9,6,20,8,0
Daniel Muñoz,COL,DF,27,Genk,Pro League,16.0,49,28,27,13,9,15,24,62.5,9,19,6,13,26,75,35,0
Mujaid Sadick,ESP,DF,23,Genk,Pro League,16.0,31,22,22,9,0,11,17,64.7,6,31,19,12,19,50,68,1
Matías Galarza,ARG,MF,21,Genk,Pro League,14.4,31,15,19,12,0,12,37,32.4,25,21,2,19,20,51,26,0
Gerardo Arteaga,MEX,DF,24,Genk,Pro League,13.4,20,13,10,8,2,10,18,55.6,8,8,3,5,22,42,25,0
Christopher Bonsu Baah,GHA,FW,18,Genk,Pro League,13.2,34,23,8,18,8,14,26,53.8,12,15,0,15,7,41,6,0
Yira Sor,NGA,FW,23,Genk,Pro League,11.9,8,4,0,6,2,2,7,28.6,5,5,0,5,4,12,8,0
Joris Kayembe,COD,DF,28,Genk,Pro League,14.1,34,22,20,9,5,19,29,65.5,10,21,4,17,14,48,23,1
Zakaria El Ouahdi,MAR,DF,21,Genk,Pro League,11.8,30,22,11,12,7,23,41,56.1,18,20,4,16,14,44,22,0
Alieu Fadera,GAM,"FW,DF",21,Genk,Pro League,10.7,25,15,8,9,8,6,24,25.0,18,11,0,11,5,30,3,0
Tolu Arokodare,NGA,FW,22,Genk,Pro League,14.5,6,2,1,3,2,3,14,21.4,11,10,0,10,6,12,33,0
Luca Oyen,BEL,"FW,MF",20,Genk,Pro League,7.1,5,2,0,3,2,1,4,25.0,3,8,0,8,4,9,3,0
Andi Zeqiri,SUI,"FW,MF",24,Genk,Pro League,7.6,1,1,0,0,1,0,3,0.0,3,10,0,10,2,3,5,0
Eduard Sobol,UKR,DF,28,Genk,Pro League,3.6,7,3,6,1,0,4,7,57.1,3,6,0,6,9,16,19,0
Aziz Ouattara,CIV,MF,22,Genk,Pro League,3.2,6,4,4,2,0,2,4,50.0,2,5,2,3,9,15,20,0
Anouar Ait El Hadj,BEL,"MF,FW",21,Genk,Pro League,3.1,6,5,1,5,0,1,7,14.3,6,2,0,2,1,7,0,0
Mike Trésor,BEL,FW,24,Genk,Pro League,1.3,1,0,0,0,1,0,0,0.0,0,3,0,3,2,3,0,0
Angelo Preciado,ECU,"DF,FW",25,Genk,Pro League,0.7,0,0,0,0,0,0,0,0.0,0,0,0,0,0,0,0,0
Ken Nkuba,BEL,"DF,FW",21,Genk,Pro League,0.5,3,3,2,0,1,2,4,50.0,2,0,0,0,1,4,0,0
Noah Adedeji,BEL,"MF,FW",18,Genk,Pro League,0.2,1,1,0,1,0,0,0,0.0,0,0,0,0,0,1,1,0
Jean Butez,FRA,GK,28,Antwerp,Pro League,30.0,0,0,0,0,0,0,3,0.0,3,0,0,0,0,0,8,1
Toby Alderweireld,BEL,DF,34,Antwerp,Pro League,28.9,34,19,19,13,2,16,29,55.2,13,32,18,14,24,58,112,0
Vincent Janssen,NED,"FW,MF",29,Antwerp,Pro League,25.6,25,18,9,6,10,11,22,50.0,11,12,4,8,7,32,7,0
Jurgen Ekkelenkamp,NED,MF,23,Antwerp,Pro League,23.5,34,16,12,20,2,21,33,63.6,12,19,4,15,10,44,19,2
Jelle Bataille,BEL,DF,24,Antwerp,Pro League,24.2,69,38,35,24,10,40,76,52.6,36,31,2,29,33,102,36,1
Arthur Vermeeren,BEL,MF,18,Antwerp,Pro League,20.8,36,23,19,15,2,16,41,39.0,25,27,6,21,24,60,35,0
Michel-Ange Balikwisha,BEL,"FW,MF",22,Antwerp,Pro League,19.8,56,44,18,25,13,11,20,55.0,9,24,0,24,21,77,10,0
Owen Wijndal,NED,DF,23,Antwerp,Pro League,17.1,27,18,20,6,1,17,38,44.7,21,18,2,16,12,39,32,1
Mandela Keita,BEL,MF,21,Antwerp,Pro League,16.5,48,27,28,20,0,26,47,55.3,21,25,4,21,33,81,16,0
Soumaïla Coulibaly,FRA,DF,19,Antwerp,Pro League,15.1,14,9,8,6,0,8,12,66.7,4,19,13,6,26,40,54,0
Chidera Ejuke,NGA,"FW,DF",25,Antwerp,Pro League,14.7,15,8,3,8,4,7,14,50.0,7,6,0,6,9,24,11,0
Arbnor Muja,ALB,"FW,MF",24,Antwerp,Pro League,13.4,22,14,12,7,3,11,33,33.3,22,12,0,12,3,25,6,0
Ritchie De Laet,BEL,DF,34,Antwerp,Pro League,10.9,22,14,9,10,3,12,18,66.7,6,9,4,5,17,39,30,0
Zeno Van den Bosch,BEL,DF,20,Antwerp,Pro League,14.8,28,19,17,11,0,11,19,57.9,8,14,7,7,30,58,41,1
Alhassan Yusuf,NGA,MF,23,Antwerp,Pro League,12.2,37,23,18,15,4,18,41,43.9,23,8,1,7,15,52,15,0
Gyrano Kerk,SUR,"FW,MF",27,Antwerp,Pro League,9.8,23,15,6,14,3,9,22,40.9,13,17,2,15,3,26,4,0
Jacob Ondrejka,SWE,"FW,MF",20,Antwerp,Pro League,7.7,7,4,2,4,1,3,7,42.9,4,2,1,1,3,10,3,0
George Ilenikhena,FRA,FW,16,Antwerp,Pro League,10.8,0,0,0,0,0,0,0,0.0,0,1,0,1,0,0,6,0
Mahamadou Doumbia,MLI,MF,19,Antwerp,Pro League,4.1,10,7,1,8,1,5,11,45.5,6,4,0,4,1,11,1,0
Sam Vines,USA,DF,24,Antwerp,Pro League,2.3,3,3,1,1,1,1,4,25.0,3,2,0,2,0,3,2,0
Gastón Ávila,ARG,DF,21,Antwerp,Pro League,2.0,5,3,3,1,1,3,9,33.3,6,3,2,1,0,5,2,0
Anthony Valencia,ECU,"FW,MF",20,Antwerp,Pro League,2.1,4,2,0,3,1,3,7,42.9,4,0,0,0,3,7,0,0
Milan Smits,BEL,MF,18,Antwerp,Pro League,0.8,0,0,0,0,0,0,1,0.0,1,0,0,0,1,1,1,0
Kobe Corbanie,BEL,"DF,MF",18,Antwerp,Pro League,1.6,11,6,5,3,3,3,3,100.0,0,2,0,2,2,13,3,0
Victor Udoh,NGA,"FW,MF",18,Antwerp,Pro League,0.8,3,3,1,2,0,1,4,25.0,3,2,0,2,0,3,0,0
Eliot Matazo,BEL,MF,21,Antwerp,Pro League,0.2,3,2,2,1,0,0,2,0.0,2,0,0,0,0,3,0,0
Christopher Scott,GER,MF,21,Antwerp,Pro League,0.1,1,1,0,1,0,1,1,100.0,0,0,0,0,0,1,0,0
Julien De Sart,BEL,MF,28,Gent,Pro League,28.3,110,74,49,54,7,43,74,58.1,31,38,10,28,62,172,63,2
Matisse Samoise,BEL,DF,21,Gent,Pro League,25.9,86,52,44,33,9,60,84,71.4,24,36,10,26,32,118,51,0
Tsuyoshi Watanabe,JPN,DF,26,Gent,Pro League,25.8,26,21,19,7,0,10,20,50.0,10,39,25,14,22,48,106,0
Ismaël Kandouss,MAR,DF,25,Gent,Pro League,24.0,62,39,35,21,6,37,51,72.5,14,19,8,11,30,92,78,2
Sven Kums,BEL,MF,35,Gent,Pro League,21.5,34,22,16,15,3,17,50,34.0,33,18,6,12,20,54,39,0
Jordan Torunarigha,GER,DF,25,Gent,Pro League,20.5,48,29,31,14,3,27,45,60.0,18,26,17,9,37,85,75,0
Archie Brown,ENG,DF,21,Gent,Pro League,18.3,24,15,13,8,3,13,26,50.0,13,32,7,25,21,45,18,0
Hong Hyunseok,KOR,MF,24,Gent,Pro League,17.5,29,16,9,18,2,17,35,48.6,18,20,1,19,18,47,6,0
Hugo Cuypers,BEL,FW,26,Gent,Pro League,18.1,28,19,6,15,7,10,39,25.6,29,12,0,12,7,35,13,0
Tarik Tissoudali,MAR,"FW,MF",30,Gent,Pro League,17.1,16,11,2,7,7,5,11,45.5,6,13,0,13,4,20,2,0
Malick Fofana,BEL,"DF,MF",18,Gent,Pro League,12.7,17,13,6,5,6,9,13,69.2,4,7,2,5,11,28,9,1
Davy Roef,BEL,GK,29,Gent,Pro League,12.0,0,0,0,0,0,0,3,0.0,3,0,0,0,0,0,4,1
Pieter Gerkens,BEL,"MF,FW",27,Gent,Pro League,10.1,14,8,5,4,5,8,16,50.0,8,16,2,14,10,24,20,0
Paul Nardi,FRA,GK,29,Gent,Pro League,10.0,0,0,0,0,0,0,0,0.0,0,0,0,0,0,0,1,0
Gift Orban,NGA,"FW,MF",21,Gent,Pro League,9.2,10,6,0,6,4,2,3,66.7,1,7,0,7,2,12,0,0
Andrew Hjulsager,DEN,"MF,DF",28,Gent,Pro League,7.9,21,14,5,9,7,8,22,36.4,14,10,1,9,4,25,2,0
Daniel Schmidt,JPN,GK,31,Gent,Pro League,8.0,0,0,0,0,0,0,0,0.0,0,0,0,0,0,0,1,1
Stefan Mitrović,SRB,DF,33,Gent,Pro League,5.2,8,4,4,4,0,3,4,75.0,1,5,4,1,6,14,24,0
Núrio Fortuna,ANG,"DF,MF",28,Gent,Pro League,4.4,14,11,13,0,1,11,12,91.7,1,5,1,4,9,23,19,0
Laurent Depoitre,BEL,FW,34,Gent,Pro League,4.3,2,1,1,0,1,0,2,0.0,2,0,0,0,0,2,5,0
Daisuke Yokota,JPN,"FW,MF",23,Gent,Pro League,3.5,2,1,0,2,0,0,3,0.0,3,4,0,4,6,8,0,0
Noah Fadiga,SEN,"DF,FW",23,Gent,Pro League,4.6,11,8,5,5,1,9,12,75.0,3,2,1,1,7,18,3,0
Brian Agbor,CMR,DF,22,Gent,Pro League,2.3,2,1,2,0,0,0,1,0.0,1,5,4,1,5,7,12,1
Matias Fernandez-Pardo,BEL,"FW,MF",18,Gent,Pro League,2.1,0,0,0,0,0,0,2,0.0,2,0,0,0,0,0,1,0
Momodou Sonko,SWE,FW,18,Gent,Pro League,1.3,3,1,0,1,2,1,3,33.3,2,0,0,0,0,3,0,0
Bram Lagae,BEL,DF,19,Gent,Pro League,1.5,2,1,2,0,0,1,1,100.0,0,2,1,1,4,6,5,1
Alessio Castro-Montes,BEL,DF,26,Gent,Pro League,0.7,0,0,0,0,0,0,1,0.0,1,0,0,0,1,1,1,0
Franck Surdez,SUI,"FW,DF",21,Gent,Pro League,0.6,2,1,0,2,0,0,0,0.0,0,2,0,2,1,3,0,0
Tibe De Vlieger,BEL,"MF,FW",17,Gent,Pro League,0.4,2,1,2,0,0,0,0,0.0,0,0,0,0,1,3,1,0
Ahmed Abdullahi,NGA,FW,19,Gent,Pro League,0.3,0,0,0,0,0,0,1,0.0,1,0,0,0,0,0,1,0
Abdoul Rachid Ayinde,BFA,"DF,MF",18,Gent,Pro League,0.1,0,0,0,0,0,0,0,0.0,0,0,0,0,0,0,1,0
Gaëtan Coucke,BEL,GK,24,Mechelen,Pro League,30.0,0,0,0,0,0,0,1,0.0,1,0,0,0,0,0,10,2
Kerim Mrabti,SWE,"MF,FW",29,Mechelen,Pro League,28.2,41,28,25,13,3,23,49,46.9,26,44,12,32,25,66,25,0
Daam Foulon,BEL,"DF,MF",24,Mechelen,Pro League,28.2,72,51,39,24,9,40,65,61.5,25,38,8,30,25,97,56,0
Rob Schoofs,BEL,MF,29,Mechelen,Pro League,27.0,45,18,20,15,10,29,69,42.0,40,26,4,22,25,70,22,0
Elias Cobbaut,BEL,DF,25,Mechelen,Pro League,24.0,14,10,9,5,0,9,15,60.0,6,39,29,10,17,31,99,1
Geoffry Hairemans,BEL,"FW,MF",31,Mechelen,Pro League,23.1,39,21,18,16,5,24,51,47.1,27,25,4,21,15,54,20,0
David Bates,SCO,DF,26,Mechelen,Pro League,23.2,26,16,17,7,2,16,31,51.6,15,40,30,10,27,53,121,0
Lion Lauberbach,GER,FW,25,Mechelen,Pro League,19.2,14,8,2,11,1,5,20,25.0,15,17,6,11,5,19,24,0
Jordi Vanlerberghe,BEL,"DF,MF",27,Mechelen,Pro League,18.3,55,38,38,13,4,33,53,62.3,20,22,14,8,36,91,63,1
Sandy Walsh,IDN,DF,28,Mechelen,Pro League,16.9,25,8,13,9,3,13,24,54.2,11,9,6,3,17,42,35,0
Ngal'Ayel Mukau,BEL,MF,18,Mechelen,Pro League,12.8,39,26,21,18,0,18,27,66.7,9,13,5,8,32,71,23,0
Mory Konaté,GUI,"MF,DF",29,Mechelen,Pro League,13.5,36,20,18,14,4,19,30,63.3,11,17,7,10,25,61,42,0
Patrick Pflücke,GER,"FW,DF",26,Mechelen,Pro League,12.9,13,10,8,3,2,7,18,38.9,11,11,0,11,4,17,8,0
Nikola Storm,BEL,"FW,MF",28,Mechelen,Pro League,10.9,11,8,7,1,3,3,10,30.0,7,10,0,10,5,16,4,0
Bill Antonio,ZIM,"MF,FW",20,Mechelen,Pro League,6.4,7,5,3,3,1,3,6,50.0,3,7,0,7,5,12,11,0
Norman Bassette,BEL,"FW,MF",18,Mechelen,Pro League,6.4,8,4,4,3,1,0,5,0.0,5,6,0,6,2,10,6,0
Munashe Garan'anga,ZIM,DF,22,Mechelen,Pro League,4.9,17,9,11,4,2,11,13,84.6,2,3,1,2,11,28,14,0
Islam Slimani,ALG,FW,35,Mechelen,Pro League,4.5,2,1,0,1,1,1,4,25.0,3,2,0,2,1,3,5,0
Jannes Van Hecke,BEL,"MF,DF",21,Mechelen,Pro League,4.6,18,10,10,4,4,13,17,76.5,4,6,1,5,5,23,16,0
Rafik Belghali,ALG,DF,21,Mechelen,Pro League,2.9,13,7,9,4,0,5,5,100.0,0,4,2,2,6,19,3,0
Dimitri Lavalée,BEL,DF,26,Mechelen,Pro League,2.1,4,2,2,2,0,3,5,60.0,2,9,5,4,6,10,16,0
Julien Ngoy,BEL,"FW,MF",25,Mechelen,Pro League,1.5,0,0,0,0,0,0,0,0.0,0,0,0,0,0,0,1,0
Bilal Bafdili,BEL,"MF,FW",18,Mechelen,Pro League,1.9,1,1,0,1,0,1,3,33.3,2,0,0,0,0,1,2,0
Toon Raemaekers,BEL,"DF,MF",22,Mechelen,Pro League,1.3,2,0,1,1,0,1,1,100.0,0,4,1,3,3,5,12,0
Boli Bolingoli-Mbombo,BEL,DF,28,Mechelen,Pro League,0.9,2,1,1,1,0,1,2,50.0,1,0,0,0,2,4,1,0
Alec Van Hoorenbeeck,BEL,DF,24,Mechelen,Pro League,0.5,1,0,0,0,1,0,0,0.0,0,2,0,2,0,1,0,0
Frederic Soelle Soelle,BEL,FW,17,Mechelen,Pro League,0.3,0,0,0,0,0,0,1,0.0,1,1,0,1,0,0,0,0
Isaac Asante,GHA,"DF,MF",20,Mechelen,Pro League,0.1,0,0,0,0,0,0,0,0.0,0,0,0,0,0,0,0,0
Dirk Asare,BEL,MF,19,Mechelen,Pro League,0.0,0,0,0,0,0,0,0,0.0,0,0,0,0,0,0,2,0
Matte Smets,BEL,DF,19,Sint-Truiden,Pro League,30.0,30,20,17,12,1,13,31,41.9,18,42,32,10,45,75,123,1
Mathias Delorge,BEL,MF,19,Sint-Truiden,Pro League,29.5,61,40,22,32,7,30,69,43.5,39,31,13,18,51,112,38,2
Rein Van Helden,BEL,DF,21,Sint-Truiden,Pro League,27.5,67,41,50,16,1,38,58,65.5,20,44,18,26,31,98,74,0
Bruno Godeau,BEL,DF,31,Sint-Truiden,Pro League,27.5,34,21,22,12,0,20,33,60.6,13,38,22,16,45,79,85,0
Eric Bocat,FRA,"DF,MF",24,Sint-Truiden,Pro League,27.2,38,25,22,10,6,25,35,71.4,10,31,3,28,51,89,41,0
Jarne Steuckers,BEL,"MF,FW",21,Sint-Truiden,Pro League,27.1,16,9,3,9,4,7,24,29.2,17,8,0,8,9,25,11,0
Aboubakary Koita,MTN,"MF,FW",24,Sint-Truiden,Pro League,25.3,42,29,14,25,3,17,41,41.5,24,24,0,24,23,65,11,0
Zion Suzuki,JPN,GK,20,Sint-Truiden,Pro League,22.0,0,0,0,0,0,0,0,0.0,0,0,0,0,1,1,9,3
Ryotaro Ito,JPN,MF,25,Sint-Truiden,Pro League,19.8,15,7,7,6,2,3,16,18.8,13,6,0,6,8,23,7,0
Daiki Hashioka,JPN,"DF,MF",24,Sint-Truiden,Pro League,16.7,28,18,19,8,1,18,32,56.3,14,27,6,21,18,46,50,0
Kahveh Zahiroleslam,USA,FW,21,Sint-Truiden,Pro League,13.9,8,5,3,3,2,3,10,30.0,7,6,0,6,6,14,10,0
Fatih Kaya,GER,FW,23,Sint-Truiden,Pro League,13.0,17,10,1,8,8,8,12,66.7,4,8,1,7,3,20,5,0
Joel Fujita,JPN,MF,21,Sint-Truiden,Pro League,9.9,26,18,11,14,1,10,17,58.8,7,15,5,10,13,39,8,0
Frederic Ananou,TOG,"DF,MF",25,Sint-Truiden,Pro League,6.0,12,7,4,4,4,6,15,40.0,9,7,2,5,6,18,7,0
Robert-Jan Vanwesemael,BEL,DF,21,Sint-Truiden,Pro League,5.1,13,9,8,4,1,7,12,58.3,5,4,1,3,6,19,9,0
Rihito Yamamoto,JPN,"MF,FW",21,Sint-Truiden,Pro League,8.1,13,6,3,7,3,3,13,23.1,10,13,0,13,5,18,6,0
Jo Coppens,BEL,GK,32,Sint-Truiden,Pro League,4.0,1,0,1,0,0,1,1,100.0,0,0,0,0,0,1,1,0
Daniel Schmidt,JPN,GK,31,Sint-Truiden,Pro League,4.0,0,0,0,0,0,0,0,0.0,0,0,0,0,0,0,0,0
Joselpho Barnes,GHA,"FW,MF",21,Sint-Truiden,Pro League,4.8,4,2,1,2,1,3,6,50.0,3,3,0,3,0,4,7,0
Wolke Janssens,BEL,DF,28,Sint-Truiden,Pro League,3.7,11,7,6,3,2,3,4,75.0,1,5,1,4,11,22,14,0
Ryoya Ogawa,JPN,"DF,MF",26,Sint-Truiden,Pro League,2.2,1,1,1,0,0,1,2,50.0,1,1,0,1,2,3,6,0
Olivier Dumont,BEL,MF,21,Sint-Truiden,Pro League,0.9,4,2,2,1,1,4,4,100.0,0,1,0,1,3,7,0,0
Stan Van Dessel,BEL,"MF,DF",22,Sint-Truiden,Pro League,0.7,6,1,2,2,2,2,3,66.7,1,0,0,0,0,6,1,0
Shinji Okazaki,JPN,"FW,MF",37,Sint-Truiden,Pro League,0.7,0,0,0,0,0,0,0,0.0,0,1,0,1,0,0,0,0
Adriano Bertaccini,BEL,"MF,FW",22,Sint-Truiden,Pro League,0.4,0,0,0,0,0,0,1,0.0,1,0,0,0,0,0,0,0
Ewoud Pletinckx,BEL,DF,22,OH Leuven,Pro League,30.0,44,25,32,11,1,20,27,74.1,7,64,31,33,28,72,134,3
Siebe Schrijvers,BEL,MF,27,OH Leuven,Pro League,27.4,79,38,30,41,8,27,56,48.2,29,39,14,25,54,133,50,0
Jón Dagur Þorsteinsson,ISL,"FW,MF",24,OH Leuven,Pro League,20.3,42,30,18,13,11,24,48,50.0,24,23,1,22,5,47,14,0
Joël Schingtienne,BEL,DF,20,OH Leuven,Pro League,21.7,39,23,31,7,1,14,18,77.8,4,28,17,11,22,61,84,0
Richie Sagrado,BEL,"DF,MF",19,OH Leuven,Pro League,18.9,34,23,25,7,2,14,26,53.8,12,13,5,8,16,50,30,0
Ezechiel Banzuzi,NED,MF,18,OH Leuven,Pro League,19.4,30,18,13,11,6,15,34,44.1,19,27,7,20,7,37,47,0
Florian Miguel,FRA,DF,26,OH Leuven,Pro League,18.5,28,17,16,9,3,17,23,73.9,6,21,7,14,28,56,71,0
Youssef Maziz,FRA,"MF,FW",25,OH Leuven,Pro League,17.6,11,6,7,1,3,6,14,42.9,8,13,1,12,6,17,11,0
Hamza Mendyl,MAR,"DF,MF",25,OH Leuven,Pro League,16.7,18,9,10,4,4,13,20,65.0,7,22,4,18,19,37,47,0
Federico Ricca,URU,DF,28,OH Leuven,Pro League,16.5,15,8,13,2,0,7,14,50.0,7,20,10,10,26,41,61,0
Tobe Leysen,BEL,GK,21,OH Leuven,Pro League,16.0,0,0,0,0,0,0,0,0.0,0,0,0,0,0,0,13,4
Joren Dom,BEL,"MF,DF",33,OH Leuven,Pro League,16.0,30,10,19,7,4,15,41,36.6,26,24,6,18,16,46,63,1
Nachon Nsingi,BEL,"FW,MF",22,OH Leuven,Pro League,13.5,10,7,0,8,2,1,8,12.5,7,16,0,16,2,12,0,0
Jonatan Braut Brunes,NOR,FW,22,OH Leuven,Pro League,11.8,3,2,1,0,2,2,4,50.0,2,9,1,8,1,4,8,0
Maxence Prevot,FRA,GK,26,OH Leuven,Pro League,11.0,0,0,0,0,0,0,1,0.0,1,0,0,0,0,0,3,0
Nathan Opoku,GHA,FW,22,OH Leuven,Pro League,9.1,8,6,0,5,3,2,9,22.2,7,10,2,8,3,11,12,0
Kento Misao,JPN,MF,27,OH Leuven,Pro League,7.3,26,15,10,12,4,9,17,52.9,8,11,2,9,10,36,13,0
Thibault Vlietinck,BEL,"DF,FW",25,OH Leuven,Pro League,5.1,9,5,5,4,0,7,18,38.9,11,5,1,4,1,10,5,0
Mathieu Maertens,BEL,"FW,MF",28,OH Leuven,Pro League,7.7,6,1,1,4,1,3,9,33.3,6,7,0,7,2,8,3,0
Sofian Kiyine,MAR,"MF,FW",25,OH Leuven,Pro League,3.2,4,4,4,0,0,3,8,37.5,5,2,0,2,2,6,1,0
Valentin Cojocaru,ROU,GK,27,OH Leuven,Pro League,3.0,0,0,0,0,0,0,0,0.0,0,0,0,0,0,0,2,0
Ignace N'Dri,CIV,"FW,DF",22,OH Leuven,Pro League,5.6,14,7,3,7,4,10,16,62.5,6,13,0,13,2,16,4,0
Takahiro Akimoto,JPN,DF,25,OH Leuven,Pro League,2.9,5,4,3,2,0,2,4,50.0,2,2,1,1,6,11,9,0
Raphael Holzhauser,AUT,MF,30,OH Leuven,Pro League,0.8,1,1,1,0,0,1,1,100.0,0,0,0,0,1,2,0,0
Mandela Keita,BEL,MF,21,OH Leuven,Pro League,0.7,2,1,1,1,0,1,1,100.0,0,0,0,0,1,3,0,0
Franco Russo,ARG,DF,28,OH Leuven,Pro League,0.6,3,2,2,0,1,1,2,50.0,1,0,0,0,1,4,5,0
Suphanat Mueanta,THA,"FW,MF",20,OH Leuven,Pro League,1.6,2,1,1,0,1,2,2,100.0,0,1,0,1,2,4,1,0
Pierre-Yves Ngawa,BEL,"DF,MF",31,OH Leuven,Pro League,0.7,3,3,3,0,0,3,4,75.0,1,1,1,0,1,4,3,0
Bryan Reynolds,USA,DF,22,Westerlo,Pro League,26.2,54,37,29,20,5,28,44,63.6,16,30,8,22,34,88,60,0
Sinan Bolat,TUR,GK,34,Westerlo,Pro League,26.0,0,0,0,0,0,0,0,0.0,0,0,0,0,0,0,6,4
Roman Neustädter,RUS,DF,35,Westerlo,Pro League,23.3,30,20,16,14,0,13,25,52.0,12,28,17,11,38,68,104,0
Nicolas Madsen,DEN,MF,23,Westerlo,Pro League,23.5,30,19,8,16,6,12,29,41.4,17,31,11,20,13,43,21,1
Serhiy Sydorchuk,UKR,MF,32,Westerlo,Pro League,21.4,51,29,22,24,5,20,48,41.7,28,14,2,12,16,67,44,1
Emin Bayram,TUR,DF,20,Westerlo,Pro League,21.9,57,39,38,17,2,29,56,51.8,27,39,20,19,63,120,122,1
Jordan Bos,AUS,DF,20,Westerlo,Pro League,19.0,32,24,22,4,6,17,31,54.8,14,27,4,23,25,57,36,1
Griffin Yow,USA,"FW,MF",20,Westerlo,Pro League,16.7,35,21,17,10,8,17,42,40.5,25,38,2,36,10,45,8,0
Arthur Piedfort,BEL,"MF,DF",18,Westerlo,Pro League,16.3,30,19,11,16,3,15,27,55.6,12,24,6,18,18,48,32,0
Thomas Van den Keybus,BEL,"MF,FW",22,Westerlo,Pro League,14.1,27,17,8,16,3,15,31,48.4,16,25,3,22,10,37,5,0
Tuur Rommens,BEL,DF,20,Westerlo,Pro League,10.5,27,17,20,4,3,12,15,80.0,3,23,2,21,23,50,36,1
Ravil Tagir,TUR,DF,20,Westerlo,Pro League,10.9,18,8,8,8,2,8,10,80.0,2,19,7,12,19,37,40,0
Lucas Stassin,BEL,"FW,MF",18,Westerlo,Pro League,9.6,11,6,5,5,1,5,13,38.5,8,2,0,2,3,14,2,0
Yusuke Matsuo,JPN,"MF,FW",26,Westerlo,Pro League,9.3,18,12,3,10,5,8,24,33.3,16,4,0,4,5,23,2,0
Nacer Chadli,BEL,"MF,FW",33,Westerlo,Pro League,7.9,14,9,10,4,0,3,9,33.3,6,4,0,4,5,19,13,0
Erdon Daci,MKD,FW,25,Westerlo,Pro League,7.7,4,2,2,2,0,2,2,100.0,0,5,1,4,0,4,3,0
Edisson Jordanov,BUL,"DF,MF",30,Westerlo,Pro League,6.5,26,20,15,9,2,13,26,50.0,13,11,3,8,7,33,13,0
Pietro Perdichizzi,BEL,DF,30,Westerlo,Pro League,6.0,9,6,8,1,0,6,8,75.0,2,9,7,2,11,20,27,0
Romeo Vermant,BEL,FW,19,Westerlo,Pro League,5.4,3,2,0,1,2,2,5,40.0,3,5,0,5,1,4,6,0
Mathias Fixelles,BEL,MF,26,Westerlo,Pro League,6.4,9,5,2,6,1,3,16,18.8,13,13,3,10,8,17,8,0
Dogucan Haspolat,TUR,MF,23,Westerlo,Pro League,5.2,15,10,5,10,0,9,15,60.0,6,10,4,6,5,20,11,0
Allahyar Sayyadmanesh,IRN,"FW,MF",22,Westerlo,Pro League,4.3,4,4,2,1,1,1,2,50.0,1,7,0,7,4,8,4,0
Lukas Van Eenoo,BEL,"MF,DF",32,Westerlo,Pro League,4.3,12,8,7,5,0,6,11,54.5,5,7,2,5,4,16,12,0
Nick Gillekens,BEL,GK,28,Westerlo,Pro League,4.0,0,0,0,0,0,0,0,0.0,0,0,0,0,0,0,1,1
Bakary Haidara,CIV,DF,18,Westerlo,Pro League,3.9,3,3,1,2,0,2,2,100.0,0,11,7,4,8,11,19,2
Kyan Vaesen,BEL,FW,22,Westerlo,Pro League,5.7,3,2,2,1,0,0,3,0.0,3,9,2,7,0,3,3,0
Dire Mebude,SCO,"MF,FW",19,Westerlo,Pro League,1.1,2,1,2,0,0,2,4,50.0,2,1,0,1,1,3,0,0
Muhammed Gümüskaya,TUR,MF,22,Westerlo,Pro League,0.9,0,0,0,0,0,0,1,0.0,1,2,0,2,1,1,1,0
Fernand Gouré,CIV,"FW,MF",21,Westerlo,Pro League,0.3,0,0,0,0,0,0,0,0.0,0,0,0,0,0,0,2,0
Josimar Alcocer,CRC,"FW,MF",19,Westerlo,Pro League,0.3,1,0,0,0,1,0,0,0.0,0,0,0,0,0,1,0,0
Ján Bernát,SVK,MF,22,Westerlo,Pro League,0.0,1,1,0,1,0,1,2,50.0,1,0,0,0,0,1,0,0
Arnaud Bodart,BEL,GK,25,Standard Liège,Pro League,29.0,1,0,1,0,0,1,2,50.0,1,0,0,0,0,1,11,1
Wilfried Kanga,CIV,FW,25,Standard Liège,Pro League,25.7,3,3,0,2,1,1,6,16.7,5,14,5,9,3,6,23,0
Hayao Kawabe,JPN,"MF,FW",27,Standard Liège,Pro League,21.5,25,13,10,10,5,12,33,36.4,21,20,2,18,10,35,13,0
Zinho Vanheusden,BEL,DF,24,Standard Liège,Pro League,19.4,27,18,19,6,2,18,26,69.2,8,29,17,12,37,64,89,2
Marlon Fossey,USA,DF,24,Standard Liège,Pro League,18.0,29,14,13,10,6,10,14,71.4,4,18,8,10,29,58,46,0
Steven Alzate,COL,MF,24,Standard Liège,Pro League,18.5,44,28,15,23,6,22,37,59.5,15,27,2,25,18,62,20,1
Moussa Djenepo,MLI,"DF,FW",25,Standard Liège,Pro League,16.6,24,15,9,13,2,9,19,47.4,10,19,2,17,11,35,19,0
Konstantinos Laifis,CYP,DF,30,Standard Liège,Pro League,18.7,33,16,25,8,0,19,24,79.2,5,20,13,7,27,60,87,0
Isaac Price,NIR,"MF,DF",19,Standard Liège,Pro League,18.4,54,39,31,21,2,27,59,45.8,32,24,8,16,26,80,32,0
Aiden O'Neill,AUS,MF,25,Standard Liège,Pro League,16.7,48,27,22,22,4,19,37,51.4,18,30,8,22,17,65,36,1
Merveille Bokadi,COD,DF,31,Standard Liège,Pro League,14.5,19,13,13,6,0,11,19,57.9,8,13,8,5,22,41,78,0
Kamal Sowah,GHA,"FW,MF",23,Standard Liège,Pro League,13.6,20,16,6,11,3,3,19,15.8,16,10,1,9,7,27,13,0
Nathan Ngoy,BEL,DF,20,Standard Liège,Pro League,13.1,25,18,16,7,2,12,22,54.5,10,10,2,8,36,61,35,0
William Balikwisha,COD,MF,24,Standard Liège,Pro League,12.1,27,12,10,13,4,7,13,53.8,6,10,0,10,10,37,9,1
Lucas Noubi,BEL,DF,18,Standard Liège,Pro League,11.8,27,15,17,9,1,14,20,70.0,6,13,5,8,20,47,42,0
Isaac Hayden,ENG,MF,28,Standard Liège,Pro League,7.4,18,13,6,9,3,6,19,31.6,13,6,0,6,10,28,10,0
Souleyman Doumbia,CIV,DF,26,Standard Liège,Pro League,6.2,18,13,6,11,1,10,14,71.4,4,7,2,5,11,29,18,0
Gilles Dewaele,BEL,"DF,MF",27,Standard Liège,Pro League,7.5,17,11,8,9,0,10,18,55.6,8,11,2,9,9,26,23,0
Hakim Sahabo,RWA,MF,18,Standard Liège,Pro League,5.3,17,12,5,12,0,8,11,72.7,3,9,5,4,9,26,11,0
Kelvin Yeboah,ITA,FW,23,Standard Liège,Pro League,4.9,4,4,1,3,0,1,7,14.3,6,2,2,0,1,5,7,0
Aron Dønnum,NOR,"DF,FW",25,Standard Liège,Pro League,4.8,2,0,0,1,1,2,6,33.3,4,6,0,6,1,3,10,0
Cihan Çanak,TUR,"DF,MF",18,Standard Liège,Pro League,6.9,9,6,4,3,2,2,8,25.0,6,13,1,12,3,12,11,0
Denis Drăguș,ROU,FW,24,Standard Liège,Pro League,3.5,6,4,2,1,3,1,6,16.7,5,2,0,2,1,7,3,0
Noah Ohio,NED,FW,20,Standard Liège,Pro League,3.5,1,1,0,1,0,0,2,0.0,2,4,1,3,0,1,1,0
Jonathan Panzo,ENG,DF,22,Standard Liège,Pro League,2.4,3,2,2,1,0,1,2,50.0,1,0,0,0,2,5,5,0
Jacob Barrett Laursen,DEN,DF,28,Standard Liège,Pro League,1.7,2,2,0,2,0,2,4,50.0,2,2,2,0,0,2,7,0
Renaud Emond,BEL,FW,31,Standard Liège,Pro League,1.1,0,0,0,0,0,0,2,0.0,2,1,1,0,0,0,2,0
Laurent Henkinet,BEL,GK,30,Standard Liège,Pro League,1.0,1,1,1,0,0,1,1,100.0,0,0,0,0,0,1,1,0
Romaine Mundle,ENG,"FW,MF",20,Standard Liège,Pro League,1.7,7,5,4,3,0,4,4,100.0,0,1,1,0,1,8,0,0
Stipe Perica,CRO,"FW,MF",28,Standard Liège,Pro League,1.0,0,0,0,0,0,0,0,0.0,0,1,0,1,1,1,2,0
Ibe Hautekiet,BEL,DF,21,Standard Liège,Pro League,0.6,3,3,2,0,1,3,3,100.0,0,0,0,0,2,5,2,0
Sacha Banse,BFA,MF,22,Standard Liège,Pro League,0.5,3,1,1,2,0,1,1,100.0,0,1,1,0,0,3,2,0
Seydou Fini,ITA,"DF,FW",17,Standard Liège,Pro League,0.5,1,1,1,0,0,1,1,100.0,0,3,0,3,0,1,0,0
Noah Dodeigne,BEL,"DF,FW",20,Standard Liège,Pro League,0.4,1,0,1,0,0,1,1,100.0,0,1,0,1,0,1,2,0
Stelios Andreou,CYP,DF,21,Charleroi,Pro League,26.8,52,37,33,18,1,24,42,57.1,18,44,23,21,37,89,109,0
Hervé Koffi,BFA,GK,26,Charleroi,Pro League,26.0,3,2,3,0,0,2,3,66.7,1,0,0,0,1,4,7,3
Marco Ilaimaharitra,MAD,MF,28,Charleroi,Pro League,23.7,60,38,26,28,6,33,64,51.6,31,40,6,34,26,86,21,0
Zan Rogelj,SVN,"DF,MF",23,Charleroi,Pro League,23.2,53,40,32,17,4,40,75,53.3,35,31,6,25,39,92,55,0
Adem Zorgane,ALG,MF,23,Charleroi,Pro League,20.5,55,29,33,17,5,23,57,40.4,34,36,8,28,25,80,27,0
Vetle Dragsnes,NOR,"DF,MF",29,Charleroi,Pro League,19.5,33,25,22,10,1,22,37,59.5,15,17,5,12,16,49,42,0
Daan Heymans,BEL,"MF,FW",24,Charleroi,Pro League,18.5,26,22,8,12,6,10,30,33.3,20,21,6,15,18,44,21,1
Isaac Mbenza,BEL,"DF,FW",27,Charleroi,Pro League,17.5,10,6,5,3,2,6,11,54.5,5,4,0,4,2,12,16,0
Oday Dabbagh,PLE,FW,24,Charleroi,Pro League,16.3,14,11,6,7,1,4,15,26.7,11,8,1,7,1,15,7,0
Damien Marcq,FRA,DF,34,Charleroi,Pro League,15.8,35,23,23,12,0,17,35,48.6,18,27,22,5,26,61,70,2
Parfait Guiagon,CIV,"FW,MF",22,Charleroi,Pro League,15.2,23,17,5,13,5,6,19,31.6,13,15,2,13,5,28,7,0
Jonas Bager,DEN,DF,27,Charleroi,Pro League,16.7,33,17,16,16,1,17,28,60.7,11,28,20,8,26,59,80,0
Ryota Morioka,JPN,MF,32,Charleroi,Pro League,10.1,31,19,13,16,2,17,29,58.6,12,25,4,21,21,52,13,0
Stefan Knežević,SUI,DF,26,Charleroi,Pro League,9.2,24,14,15,7,2,9,18,50.0,9,16,6,10,27,51,24,1
Youssouph Badji,SEN,"FW,MF",21,Charleroi,Pro League,10.4,11,6,7,2,2,5,10,50.0,5,1,0,1,4,15,10,0
Jules Van Cleemput,BEL,DF,26,Charleroi,Pro League,7.9,10,5,6,4,0,5,6,83.3,1,8,4,4,21,31,33,0
Antoine Bernier,BEL,"FW,MF",25,Charleroi,Pro League,7.4,13,9,5,8,0,9,11,81.8,2,16,0,16,5,18,0,0
Jérémy Pétris,FRA,DF,25,Charleroi,Pro League,7.0,16,12,10,5,1,8,10,80.0,2,5,1,4,3,19,17,0
Youssuf Sylla,BEL,FW,20,Charleroi,Pro League,6.9,3,3,0,1,2,1,4,25.0,3,3,0,3,1,4,3,0
Mehdi Boukamir,MAR,DF,19,Charleroi,Pro League,5.2,11,7,7,4,0,4,8,50.0,4,5,2,3,10,21,21,1
Nikola Štulić,SRB,"FW,MF",21,Charleroi,Pro League,4.9,5,3,0,2,3,3,5,60.0,2,4,1,3,4,9,6,0
Pierre Patron,FRA,GK,25,Charleroi,Pro League,4.0,0,0,0,0,0,0,1,0.0,1,0,0,0,0,0,0,0
Etienne Camara,FRA,MF,20,Charleroi,Pro League,3.8,14,5,2,10,2,9,14,64.3,5,4,0,4,4,18,6,0
Achraf Dari,MAR,DF,24,Charleroi,Pro League,3.5,5,4,5,0,0,2,2,100.0,0,4,2,2,6,11,19,0
Nadhir Benbouali,ALG,"FW,MF",23,Charleroi,Pro League,3.7,5,4,0,4,1,1,3,33.3,2,7,1,6,0,5,2,0
Ken Nkuba,BEL,"MF,DF",21,Charleroi,Pro League,1.7,10,6,6,4,0,5,9,55.6,4,1,0,1,3,13,4,0
Roméo Monticelli,BEL,DF,17,Charleroi,Pro League,1.3,3,1,2,1,0,1,3,33.3,2,0,0,0,2,5,1,0
Adrien Trebel,FRA,"MF,DF",32,Charleroi,Pro League,1.2,5,3,2,3,0,3,4,75.0,1,1,1,0,1,6,0,0
Mitchy Ntelo,BEL,"FW,DF",22,Charleroi,Pro League,0.4,0,0,0,0,0,0,0,0.0,0,1,1,0,2,2,1,0
Martin Delavallée,BEL,GK,19,Charleroi,Pro League,0.0,0,0,0,0,0,0,0,0.0,0,0,0,0,0,0,0,0
João Pedro Silva,POR,DF,24,Kortrijk,Pro League,28.5,41,22,32,7,2,17,25,68.0,8,45,32,13,31,72,205,2
Abdelkahar Kadri,ALG,"MF,FW",23,Kortrijk,Pro League,25.4,65,30,33,26,6,20,63,31.7,43,52,0,52,27,92,24,1
Nayel Mehssatou,CHI,"DF,MF",21,Kortrijk,Pro League,21.4,43,24,24,15,4,22,40,55.0,18,28,8,20,21,64,24,2
Abdoulaye Sissako,FRA,MF,25,Kortrijk,Pro League,21.0,49,29,22,23,4,18,36,50.0,18,31,6,25,28,77,47,0
Dion De Neve,BEL,"DF,MF",21,Kortrijk,Pro League,21.4,60,42,42,15,3,23,52,44.2,29,32,1,31,21,81,57,0
Tom Vandenberghe,BEL,GK,30,Kortrijk,Pro League,21.0,1,1,1,0,0,1,1,100.0,0,0,0,0,1,2,9,2
Isaak Davies,WAL,FW,21,Kortrijk,Pro League,19.2,14,8,2,6,6,6,12,50.0,6,17,1,16,3,17,4,0
Mark Mampasi,UKR,DF,20,Kortrijk,Pro League,18.9,25,17,18,6,1,11,18,61.1,7,39,26,13,33,58,114,0
Felipe Avenatti,URU,"FW,MF",30,Kortrijk,Pro League,17.4,16,11,2,10,4,7,19,36.8,12,10,2,8,6,22,25,0
Sheyi Ojo,ENG,"DF,FW",26,Kortrijk,Pro League,17.1,23,18,14,9,0,13,23,56.5,10,9,2,7,12,35,24,0
Marco Kana,BEL,"MF,DF",20,Kortrijk,Pro League,14.5,36,21,22,12,2,18,31,58.1,13,21,11,10,30,66,45,0
Massimo Bruno,BEL,"MF,FW",29,Kortrijk,Pro League,12.6,16,12,8,7,1,9,26,34.6,17,10,2,8,7,23,10,0
Aleksandar Radovanović,SRB,DF,29,Kortrijk,Pro League,10.9,23,16,19,4,0,17,21,81.0,4,21,11,10,20,43,63,1
Lucas Pirard,BEL,GK,28,Kortrijk,Pro League,9.0,0,0,0,0,0,0,1,0.0,1,1,0,1,0,0,10,3
Ryotaro Tsunoda,JPN,DF,24,Kortrijk,Pro League,8.8,16,9,10,4,2,7,9,77.8,2,13,6,7,17,33,46,0
Mounaim El Idrissy,FRA,"FW,MF",24,Kortrijk,Pro League,8.1,16,7,13,2,1,9,14,64.3,5,5,0,5,7,23,9,0
Kristiyan Malinov,BUL,MF,29,Kortrijk,Pro League,9.7,27,11,19,8,0,18,37,48.6,19,17,5,12,18,45,27,0
Martin Wasinski,BEL,DF,19,Kortrijk,Pro League,6.3,16,11,8,8,0,10,13,76.9,3,5,3,2,9,25,16,0
Haruya Fujii,JPN,DF,22,Kortrijk,Pro League,5.0,9,8,8,1,0,8,12,66.7,4,6,6,0,8,17,28,1
Dylan Mbayo,BEL,"FW,MF",21,Kortrijk,Pro League,5.0,9,5,5,4,0,3,6,50.0,3,2,0,2,2,11,0,0
Lynnt Audoor,BEL,MF,19,Kortrijk,Pro League,4.5,12,3,7,4,1,8,13,61.5,5,8,1,7,10,22,11,0
Jonathan Afolabi,IRL,FW,23,Kortrijk,Pro League,4.4,2,1,1,1,0,1,3,33.3,2,0,0,0,0,2,1,0
David Henen,TOG,"MF,DF",27,Kortrijk,Pro League,2.9,5,3,2,3,0,3,5,60.0,2,2,0,2,1,6,2,0
Ryan Alebiosu,ENG,"DF,MF",21,Kortrijk,Pro League,3.9,5,2,4,0,1,1,3,33.3,2,2,0,2,2,7,10,0
Alex Mighten,ENG,MF,21,Kortrijk,Pro League,2.7,2,2,2,0,0,0,1,0.0,1,1,0,1,2,4,1,0
Lars Montegnies,BEL,MF,17,Kortrijk,Pro League,1.9,7,4,4,3,0,3,8,37.5,5,2,1,1,5,12,4,0
Iver Fossum,NOR,"MF,FW",27,Kortrijk,Pro League,1.9,5,2,2,3,0,3,8,37.5,5,5,0,5,2,7,5,0
Raul Oprut,ROU,DF,25,Kortrijk,Pro League,1.4,5,4,4,0,1,2,3,66.7,1,4,0,4,0,5,3,0
Kings Kangwa,ZAM,MF,24,Kortrijk,Pro League,1.8,2,1,2,0,0,0,0,0.0,0,2,1,1,1,3,3,0
Christalino Atemona,GER,DF,21,Kortrijk,Pro League,1.1,2,0,2,0,0,0,2,0.0,2,0,0,0,2,4,7,0
Thierry Ambrose,GLP,FW,26,Kortrijk,Pro League,0.6,1,1,0,0,1,0,1,0.0,1,0,0,0,1,2,1,0
Djiby Seck,SEN,"FW,MF",19,Kortrijk,Pro League,0.6,0,0,0,0,0,0,5,0.0,5,2,0,2,0,0,0,0
Youssef Challouk,BEL,"MF,FW",27,Kortrijk,Pro League,0.5,0,0,0,0,0,0,1,0.0,1,1,0,1,0,0,0,0
Billel Messaoudi,ALG,"DF,MF",25,Kortrijk,Pro League,0.3,0,0,0,0,0,0,0,0.0,0,1,0,1,0,0,0,0
Massimo Decoene,BEL,FW,19,Kortrijk,Pro League,0.1,0,0,0,0,0,0,0,0.0,0,1,1,0,1,1,0,0
Pape Habib Guèye,SEN,FW,23,Kortrijk,Pro League,0.1,0,0,0,0,0,0,0,0.0,0,0,0,0,0,0,0,0
Théo Defourny,BEL,GK,31,RWD Molenbeek,Pro League,29.8,1,1,1,0,0,1,1,100.0,0,0,0,0,1,2,15,1
Pierre Dwomoh,BEL,MF,19,RWD Molenbeek,Pro League,25.3,50,36,20,26,4,29,58,50.0,29,51,5,46,29,79,35,1
Makhtar Gueye,SEN,FW,25,RWD Molenbeek,Pro League,24.2,21,10,7,9,5,9,22,40.9,13,7,2,5,6,27,24,0
Abner,BRA,"DF,MF",27,RWD Molenbeek,Pro League,20.6,23,13,11,7,5,14,24,58.3,10,15,1,14,25,48,57,1
Jeff Reine-Adélaïde,FRA,MF,25,RWD Molenbeek,Pro League,15.2,15,12,8,6,1,7,22,31.8,15,15,2,13,9,24,15,1
Ilay Camara,BEL,"DF,MF",20,RWD Molenbeek,Pro League,17.8,32,25,17,11,4,18,28,64.3,10,23,7,16,21,53,35,0
Mickaël Biron,MTQ,"FW,MF",25,RWD Molenbeek,Pro League,16.1,29,17,15,12,2,6,18,33.3,12,8,0,8,7,36,7,0
Xavier Mercier,FRA,"MF,FW",34,RWD Molenbeek,Pro League,14.6,8,4,2,5,1,2,10,20.0,8,7,0,7,2,10,4,0
Shuto Abe,JPN,MF,25,RWD Molenbeek,Pro League,16.4,47,32,23,17,7,18,46,39.1,28,21,6,15,13,60,37,0
Willian Klaus,BRA,DF,29,RWD Molenbeek,Pro League,13.8,19,10,13,6,0,9,19,47.4,10,28,18,10,21,40,115,0
Marsoni Sambu,BEL,DF,27,RWD Molenbeek,Pro League,11.7,32,16,21,10,1,14,21,66.7,7,17,3,14,16,48,45,1
Luis Segovia,ECU,DF,25,RWD Molenbeek,Pro League,11.3,20,12,16,3,1,10,16,62.5,6,11,6,5,13,33,74,1
Moussa Sissako,MLI,DF,22,RWD Molenbeek,Pro League,11.0,25,18,19,6,0,11,18,61.1,7,21,13,8,27,52,75,2
Jonathan Heris,BEL,DF,32,RWD Molenbeek,Pro League,9.7,18,13,12,3,3,12,30,40.0,18,19,10,9,19,37,54,0
Florian Le Joncour,FRA,DF,28,RWD Molenbeek,Pro League,9.7,10,5,6,4,0,4,4,100.0,0,21,14,7,14,24,56,0
Carlos Alberto,BRA,"FW,MF",21,RWD Molenbeek,Pro League,7.3,11,8,6,3,2,4,11,36.4,7,12,0,12,9,20,8,0
David Sousa,BRA,DF,22,RWD Molenbeek,Pro League,7.5,12,5,7,5,0,5,8,62.5,3,14,8,6,26,38,51,0
Tayo Adaramola,IRL,DF,19,RWD Molenbeek,Pro League,6.4,21,14,13,8,0,12,17,70.6,5,7,1,6,7,28,19,1
Pathé Mboup,SEN,"MF,FW",19,RWD Molenbeek,Pro League,8.5,26,13,9,14,3,9,21,42.9,12,9,1,8,4,30,5,0
Youssouf Koné,MLI,DF,28,RWD Molenbeek,Pro League,6.2,12,7,12,0,0,4,10,40.0,6,7,3,4,8,20,25,0
Mamadou Sarr,FRA,"MF,DF",17,RWD Molenbeek,Pro League,6.0,17,13,13,2,2,9,14,64.3,5,7,4,3,5,22,19,0
Florent da Silva,FRA,MF,20,RWD Molenbeek,Pro League,5.6,7,6,1,5,1,3,6,50.0,3,8,0,8,6,13,6,0
Alexis De Sart,BEL,MF,26,RWD Molenbeek,Pro League,5.4,15,9,9,5,1,7,21,33.3,14,14,4,10,4,19,11,0
Zakaria El Ouahdi,MAR,DF,21,RWD Molenbeek,Pro League,4.8,17,12,12,3,2,9,16,56.3,7,7,1,6,5,22,8,0
Philipe Sampaio,BRA,DF,28,RWD Molenbeek,Pro League,4.5,5,3,3,2,0,4,4,100.0,0,9,7,2,4,9,16,0
Christ Makosso,CGO,DF,19,RWD Molenbeek,Pro League,4.0,10,7,8,2,0,4,6,66.7,2,11,4,7,5,15,26,0
Niklo Dailly,BEL,"MF,DF",21,RWD Molenbeek,Pro League,3.6,5,5,4,1,0,4,9,44.4,5,2,0,2,1,6,9,0
Rikelmi,BRA,"MF,FW",21,RWD Molenbeek,Pro League,3.0,4,3,0,1,3,2,5,40.0,3,2,0,2,1,5,0,0
Djovkar Doudaev,BEL,DF,19,RWD Molenbeek,Pro League,2.3,5,2,4,1,0,4,6,66.7,2,3,0,3,5,10,3,0
Malcolm Ebiowei,ENG,"FW,MF",19,RWD Molenbeek,Pro League,1.6,3,3,0,3,0,1,1,100.0,0,1,0,1,2,5,1,0
Théo Gécé,BEL,MF,22,RWD Molenbeek,Pro League,1.4,5,4,3,1,1,4,5,80.0,1,4,0,4,2,7,3,0
Sada Diallo,BEL,"MF,DF",21,RWD Molenbeek,Pro League,1.0,1,1,1,0,0,1,6,16.7,5,3,1,2,1,2,5,0
Frederic Soelle Soelle,BEL,"FW,MF",17,RWD Molenbeek,Pro League,0.7,0,0,0,0,0,0,1,0.0,1,1,1,0,0,0,0,0
Del Piage,BRA,MF,23,RWD Molenbeek,Pro League,0.7,4,3,2,2,0,1,3,33.3,2,3,0,3,0,4,1,0
Matias Segovia,PAR,"FW,MF",20,RWD Molenbeek,Pro League,0.4,0,0,0,0,0,0,0,0.0,0,1,0,1,0,0,1,0
Matteo Vandendaele,BEL,DF,18,RWD Molenbeek,Pro League,0.2,0,0,0,0,0,0,1,0.0,1,0,0,0,0,0,0,0
Guillaume Hubert,BEL,GK,29,RWD Molenbeek,Pro League,0.2,0,0,0,0,0,0,0,0.0,0,0,0,0,0,0,0,0
Fabio Ferraro,BEL,MF,20,RWD Molenbeek,Pro League,0.2,0,0,0,0,0,0,1,0.0,1,0,0,0,0,0,0,0
Victor Pálsson,ISL,DF,32,Eupen,Pro League,30.0,28,19,22,6,0,14,27,51.9,13,41,32,9,33,61,168,0
Gaga Slonina,USA,GK,19,Eupen,Pro League,28.0,1,1,1,0,0,1,4,25.0,3,0,0,0,0,1,15,3
Isaac Nuhu,GHA,"FW,MF",21,Eupen,Pro League,25.3,24,13,8,11,5,12,28,42.9,16,15,2,13,12,36,11,0
Jason Davidson,AUS,DF,32,Eupen,Pro League,25.9,42,31,24,13,5,24,38,63.2,14,42,15,27,33,75,87,2
Rune Paeshuyse,BEL,DF,21,Eupen,Pro League,25.2,42,25,32,9,1,27,54,50.0,27,28,16,12,41,83,90,1
Brandon Baiye,BEL,MF,22,Eupen,Pro League,23.0,74,46,40,28,6,26,56,46.4,30,42,7,35,41,115,38,1
Gary Magnée,BEL,"DF,MF",23,Eupen,Pro League,21.8,55,31,25,21,9,29,57,50.9,28,41,13,28,24,79,45,0
Yentl Van Genechten,BEL,DF,22,Eupen,Pro League,17.4,27,19,16,7,4,13,25,52.0,12,24,5,19,19,46,59,1
Boris lambert,BEL,"MF,DF",23,Eupen,Pro League,15.8,47,26,21,24,2,25,49,51.0,24,30,8,22,28,75,52,0
Kevin Möhwald,GER,MF,30,Eupen,Pro League,15.0,27,20,16,9,2,12,36,33.3,24,17,4,13,14,41,14,2
Miloš Pantović,SRB,"MF,FW",27,Eupen,Pro League,14.3,21,15,11,7,3,9,30,30.0,21,11,1,10,7,28,10,1
Amadou Keita,GUI,"MF,FW",21,Eupen,Pro League,15.1,54,36,26,23,5,22,49,44.9,27,20,0,20,20,74,5,0
Regan Charles-Cook,GRN,"FW,MF",26,Eupen,Pro League,14.9,19,12,6,8,5,7,14,50.0,7,12,2,10,3,22,8,0
Alfreð Finnbogason,ISL,FW,34,Eupen,Pro League,12.5,5,2,0,3,2,2,11,18.2,9,10,0,10,2,7,5,1
Oleksandr Filin,RUS,DF,27,Eupen,Pro League,9.7,23,14,18,4,1,11,21,52.4,10,16,10,6,13,36,32,3
Jan Král,CZE,DF,24,Eupen,Pro League,9.0,10,7,9,1,0,7,13,53.8,6,10,5,5,14,24,49,1
Jerome Deom,BEL,"MF,FW",24,Eupen,Pro League,8.5,26,14,11,8,7,11,20,55.0,9,13,0,13,6,32,11,0
Isaac Christie-Davies,WAL,MF,25,Eupen,Pro League,6.3,8,5,5,3,0,3,9,33.3,6,4,2,2,4,12,7,0
Renaud Emond,BEL,FW,31,Eupen,Pro League,4.8,1,0,0,1,0,0,0,0.0,0,4,2,2,2,3,6,0
Manaf Nurudeen,GHA,GK,24,Eupen,Pro League,2.0,0,0,0,0,0,0,0,0.0,0,0,0,0,0,0,3,1
Teddy Alloh,FRA,DF,21,Eupen,Pro League,2.2,3,3,0,2,1,2,3,66.7,1,2,1,1,3,6,8,0
Nathan Bitu Mazala,FRA,"MF,FW",20,Eupen,Pro League,1.3,0,0,0,0,0,0,1,0.0,1,1,0,1,0,0,1,0
Lorenzo Youndje,BEL,"DF,MF",18,Eupen,Pro League,1.0,6,3,1,2,3,1,4,25.0,3,5,0,5,1,7,4,0
Shayne Pattynama,IDN,DF,24,Eupen,Pro League,0.5,0,0,0,0,0,0,0,0.0,0,0,0,0,0,0,1,0
Matteo Filorizzo,BEL,"FW,MF",17,Eupen,Pro League,0.4,0,0,0,0,0,0,0,0.0,0,0,0,0,0,0,0,0
Théo Maréchal,NED,"MF,FW",18,Eupen,Pro League,0.1,0,0,0,0,0,0,0,0.0,0,0,0,0,0,0,0,0
Viktor Gyökeres,SWE,FW,25,Sporting CP,Primeira Liga,32.4,16,11,3,5,8,3,6,50.0,3,13,1,12,5,21,22,0
Pedro Gonçalves,POR,"FW,MF",25,Sporting CP,Primeira Liga,28.6,47,30,10,23,14,20,55,36.4,35,31,2,29,10,57,4,0
Gonçalo Inácio,POR,DF,21,Sporting CP,Primeira Liga,27.6,48,35,20,26,2,26,42,61.9,16,29,14,15,25,73,64,1
Morten Hjulmand,DEN,MF,24,Sporting CP,Primeira Liga,24.3,60,37,24,28,8,25,43,58.1,18,27,5,22,20,80,25,0
Sebastián Coates,URU,DF,32,Sporting CP,Primeira Liga,25.3,38,19,23,14,1,24,36,66.7,12,28,19,9,24,62,81,1
Ousmane Diomande,CIV,DF,19,Sporting CP,Primeira Liga,23.5,41,24,23,14,4,17,22,77.3,5,11,7,4,13,54,43,1
Hidemasa Morita,JPN,MF,28,Sporting CP,Primeira Liga,23.8,55,35,16,32,7,28,58,48.3,30,17,1,16,17,72,25,0
Nuno Santos,POR,"MF,DF",28,Sporting CP,Primeira Liga,22.9,26,18,8,12,6,9,22,40.9,13,8,1,7,25,51,13,1
Antonio Adán,ESP,GK,36,Sporting CP,Primeira Liga,22.0,0,0,0,0,0,0,1,0.0,1,0,0,0,0,0,3,1
Ricardo Esgaio,POR,"MF,DF",30,Sporting CP,Primeira Liga,16.6,44,22,19,18,7,22,42,52.4,20,14,2,12,7,51,35,0
Francisco Trincão,POR,"FW,MF",23,Sporting CP,Primeira Liga,18.9,28,19,8,16,4,9,24,37.5,15,13,2,11,4,32,8,0
Geny Catamo,MOZ,"MF,DF",22,Sporting CP,Primeira Liga,18.7,25,17,12,5,8,15,33,45.5,18,19,1,18,12,37,15,0
Matheus Reis,BRA,"DF,MF",28,Sporting CP,Primeira Liga,15.8,20,13,7,11,2,15,24,62.5,9,16,3,13,9,29,27,0
Marcus Edwards,ENG,"FW,MF",24,Sporting CP,Primeira Liga,14.9,10,7,2,6,2,1,8,12.5,7,8,0,8,6,16,2,0
Paulinho,POR,"FW,MF",30,Sporting CP,Primeira Liga,14.5,18,14,1,9,8,5,16,31.3,11,15,1,14,2,20,6,0
Daniel Bragança,POR,MF,24,Sporting CP,Primeira Liga,11.4,33,22,9,15,9,14,26,53.8,12,11,2,9,19,52,4,2
Franco Israel,URU,GK,23,Sporting CP,Primeira Liga,10.0,0,0,0,0,0,0,0,0.0,0,0,0,0,0,0,5,1
Eduardo Quaresma,POR,DF,21,Sporting CP,Primeira Liga,10.7,28,18,15,12,1,13,20,65.0,7,11,7,4,9,37,23,0
Jerry St. Juste,NED,DF,26,Sporting CP,Primeira Liga,6.0,13,5,7,5,1,5,9,55.6,4,5,0,5,6,19,8,0
Diogo Pinto,POR,GK,19,Sporting CP,Primeira Liga,1.9,0,0,0,0,0,0,0,0.0,0,0,0,0,0,0,0,0
Luís Neto,POR,DF,35,Sporting CP,Primeira Liga,1.5,1,0,0,1,0,0,1,0.0,1,2,2,0,1,2,4,0
Iván Fresneda,ESP,"MF,DF",18,Sporting CP,Primeira Liga,0.4,4,2,3,1,0,2,3,66.7,1,1,0,1,0,4,2,0
Dario Essugo,POR,MF,18,Sporting CP,Primeira Liga,0.4,2,2,0,2,0,1,1,100.0,0,0,0,0,0,2,0,0
Koba Koindredi,FRA,MF,21,Sporting CP,Primeira Liga,0.4,4,3,0,4,0,2,2,100.0,0,0,0,0,2,6,0,0
Afonso Bastardo,POR,MF,18,Sporting CP,Primeira Liga,0.3,1,1,1,0,0,1,2,50.0,1,1,0,1,0,1,1,0
Francisco Silva,POR,GK,17,Sporting CP,Primeira Liga,0.1,0,0,0,0,0,0,0,0.0,0,0,0,0,0,0,0,0
Mateus Fernandes,POR,FW,19,Sporting CP,Primeira Liga,0.0,0,0,0,0,0,0,0,0.0,0,0,0,0,0,0,0,0
Miguel Menino,POR,MF,20,Sporting CP,Primeira Liga,0.0,0,0,0,0,0,0,0,0.0,0,1,0,1,0,0,0,0
Rafael Pontelo,BRA,DF,20,Sporting CP,Primeira Liga,0.0,0,0,0,0,0,0,0,0.0,0,0,0,0,0,0,0,0
Fredrik Aursnes,NOR,DF,27,Benfica,Primeira Liga,31.0,73,43,32,32,9,49,84,58.3,35,41,8,33,18,91,43,0
Nicolás Otamendi,ARG,DF,35,Benfica,Primeira Liga,30.6,50,36,33,16,1,30,58,51.7,28,30,14,16,53,103,109,3
António Silva,POR,DF,19,Benfica,Primeira Liga,29.1,64,43,34,24,6,33,42,78.6,9,47,24,23,23,87,91,0
Rafa Silva,POR,"MF,FW",30,Benfica,Primeira Liga,27.5,23,12,10,7,6,10,32,31.3,22,11,0,11,7,30,4,0
João Mário,POR,"FW,MF",30,Benfica,Primeira Liga,26.9,39,27,8,21,10,15,34,44.1,19,24,0,24,16,55,8,0
Anatolii Trubin,UKR,GK,21,Benfica,Primeira Liga,28.0,1,1,1,0,0,1,2,50.0,1,0,0,0,1,2,10,3
João Neves,POR,MF,18,Benfica,Primeira Liga,25.7,65,53,21,26,18,29,63,46.0,34,49,12,37,35,100,38,0
Angel Di María,ARG,FW,35,Benfica,Primeira Liga,24.6,20,12,9,8,3,7,32,21.9,25,26,0,26,8,28,3,1
Orkun Kökçü,TUR,MF,22,Benfica,Primeira Liga,19.8,32,22,10,18,4,17,35,48.6,18,15,2,13,8,40,7,1
Alexander Bah,DEN,DF,25,Benfica,Primeira Liga,16.9,52,35,23,19,10,30,44,68.2,14,24,4,20,32,84,28,1
Florentino Luís,POR,MF,23,Benfica,Primeira Liga,18.7,79,45,26,43,10,39,75,52.0,36,36,5,31,49,128,13,0
Morato,BRA,DF,22,Benfica,Primeira Liga,16.9,53,33,33,11,9,37,67,55.2,30,20,5,15,17,70,40,0
Arthur Cabral,BRA,FW,25,Benfica,Primeira Liga,14.8,11,7,2,5,4,3,9,33.3,6,8,0,8,1,12,7,0
David Neres,BRA,FW,26,Benfica,Primeira Liga,12.6,12,3,2,8,2,4,11,36.4,7,15,2,13,5,17,2,0
Casper Tengstedt,DEN,FW,23,Benfica,Primeira Liga,7.4,11,5,2,5,4,7,12,58.3,5,6,0,6,0,11,2,0
Petar Musa,CRO,FW,25,Benfica,Primeira Liga,5.8,12,8,4,4,4,3,5,60.0,2,8,2,6,0,12,6,0
Alvaro Carreras,ESP,DF,20,Benfica,Primeira Liga,6.3,18,10,7,9,2,8,12,66.7,4,8,3,5,10,28,9,0
Tiago Gouveia,POR,FW,22,Benfica,Primeira Liga,6.0,12,7,3,4,5,8,14,57.1,6,7,0,7,1,13,0,0
Tomás Araújo,POR,DF,21,Benfica,Primeira Liga,5.4,12,9,4,3,5,5,8,62.5,3,10,4,6,8,20,18,0
Samuel Soares,POR,GK,21,Benfica,Primeira Liga,5.0,0,0,0,0,0,0,0,0.0,0,0,0,0,0,0,2,0
Marcos Leonardo,BRA,FW,20,Benfica,Primeira Liga,3.7,2,1,0,0,2,0,0,0.0,0,3,0,3,0,2,1,0
David Jurásek,CZE,DF,22,Benfica,Primeira Liga,2.9,9,4,7,2,0,6,8,75.0,2,1,0,1,1,10,9,1
Chiquinho,POR,MF,28,Benfica,Primeira Liga,2.1,5,4,1,4,0,1,3,33.3,2,1,0,1,2,7,3,0
Benjamín Rollheiser,ARG,FW,23,Benfica,Primeira Liga,1.7,0,0,0,0,0,0,1,0.0,1,3,1,2,0,0,1,0
Gonçalo Guedes,POR,"FW,MF",26,Benfica,Primeira Liga,1.4,1,0,0,1,0,1,3,33.3,2,0,0,0,1,2,0,0
Odisseas Vlachodimos,GRE,GK,29,Benfica,Primeira Liga,1.0,0,0,0,0,0,0,0,0.0,0,0,0,0,0,0,0,0
Juan Bernat,ESP,DF,30,Benfica,Primeira Liga,0.9,0,0,0,0,0,0,2,0.0,2,2,0,2,0,0,3,0
João Victor,BRA,DF,25,Benfica,Primeira Liga,0.3,0,0,0,0,0,0,0,0.0,0,2,1,1,1,1,0,0
Gustavo Varela,POR,FW,18,Benfica,Primeira Liga,0.2,0,0,0,0,0,0,0,0.0,0,0,0,0,0,0,0,0
João Seno,POR,MF,18,Benfica,Primeira Liga,0.1,0,0,0,0,0,0,0,0.0,0,0,0,0,0,0,0,0
Gianluca Prestianni,ARG,MF,17,Benfica,Primeira Liga,0.0,0,0,0,0,0,0,1,0.0,1,0,0,0,0,0,0,0
Gustavo Marques,BRA,DF,21,Benfica,Primeira Liga,0.0,0,0,0,0,0,0,0,0.0,0,0,0,0,1,1,0,0
Mihailo Ristić,SRB,DF,27,Benfica,Primeira Liga,0.0,1,0,1,0,0,0,0,0.0,0,0,0,0,0,1,0,0
Diogo Spencer,POR,DF,19,Benfica,Primeira Liga,0.0,0,0,0,0,0,0,0,0.0,0,0,0,0,0,0,0,0
Diogo Costa,POR,GK,23,Porto,Primeira Liga,32.7,0,0,0,0,0,0,0,0.0,0,0,0,0,0,0,17,2
Pepê,BRA,"MF,DF",26,Porto,Primeira Liga,31.7,26,18,8,12,6,9,33,27.3,24,30,2,28,22,48,16,0
Alan Varela,ARG,MF,22,Porto,Primeira Liga,24.7,36,20,11,21,4,15,35,42.9,20,32,8,24,23,59,28,0
João Mário Lopes,POR,DF,23,Porto,Primeira Liga,22.9,33,20,13,16,4,22,44,50.0,22,19,4,15,13,46,18,1
Evanilson,BRA,FW,23,Porto,Primeira Liga,22.8,19,11,2,9,8,7,13,53.8,6,15,1,14,3,22,8,0
Galeno,BRA,"FW,MF",25,Porto,Primeira Liga,24.9,25,18,11,8,6,11,28,39.3,17,22,2,20,15,40,18,0
Wendell,BRA,DF,30,Porto,Primeira Liga,23.3,40,23,16,23,1,21,37,56.8,16,21,3,18,14,54,42,0
Pepe,POR,DF,40,Porto,Primeira Liga,20.9,28,16,16,12,0,16,30,53.3,14,13,8,5,19,47,50,1
Francisco Conceição,POR,"FW,MF",20,Porto,Primeira Liga,21.0,40,31,9,15,16,16,30,53.3,14,14,1,13,2,42,4,1
Nicolás González,ESP,MF,21,Porto,Primeira Liga,18.9,42,28,13,21,8,22,38,57.9,16,24,3,21,10,52,11,0
Stephen Eustáquio,CAN,MF,26,Porto,Primeira Liga,17.0,41,27,16,19,6,19,34,55.9,15,28,5,23,18,59,24,0
Mehdi Taremi,IRN,"FW,MF",31,Porto,Primeira Liga,16.4,24,15,8,9,7,8,24,33.3,16,14,3,11,7,31,21,0
Fábio Cardoso,POR,DF,29,Porto,Primeira Liga,13.4,5,3,1,4,0,0,2,0.0,2,12,8,4,12,17,37,0
Otavio Ataide,BRA,DF,21,Porto,Primeira Liga,12.0,11,6,9,1,1,9,15,60.0,6,10,6,4,7,18,28,0
Zé Pedro Figueiredo,POR,DF,26,Porto,Primeira Liga,10.3,15,7,8,6,1,10,17,58.8,7,5,2,3,9,24,31,0
David Carmo,ANG,DF,24,Porto,Primeira Liga,6.8,5,4,2,2,1,4,5,80.0,1,11,7,4,2,7,31,1
Jorge Eduardo Sánchez,MEX,DF,25,Porto,Primeira Liga,6.3,19,13,12,5,2,15,23,65.2,8,5,0,5,7,26,7,0
Ivan Jaime Pajuelo,ESP,"MF,FW",22,Porto,Primeira Liga,6.3,11,7,2,5,4,3,8,37.5,5,5,1,4,2,13,2,0
Toni Martínez,ESP,FW,26,Porto,Primeira Liga,5.8,2,1,1,0,1,1,6,16.7,5,2,0,2,0,2,0,0
André Franco,POR,"MF,FW",25,Porto,Primeira Liga,4.9,6,5,3,3,0,4,11,36.4,7,1,0,1,4,10,5,0
Iván Marcano,ESP,DF,36,Porto,Primeira Liga,4.1,9,4,5,4,0,5,7,71.4,2,1,1,0,4,13,9,0
Zaidu Sanusi,NGA,DF,26,Porto,Primeira Liga,3.2,3,2,1,2,0,2,3,66.7,1,4,2,2,4,7,4,0
Martim Fernandes,POR,DF,17,Porto,Primeira Liga,2.8,10,6,6,3,1,6,7,85.7,1,3,0,3,4,14,7,0
Marko Grujić,SRB,MF,27,Porto,Primeira Liga,3.2,17,13,5,11,1,11,13,84.6,2,4,1,3,6,23,4,0
João Miguel,POR,DF,23,Porto,Primeira Liga,3.2,3,2,2,1,0,3,5,60.0,2,5,3,2,2,5,2,0
Romário Baró,POR,"MF,FW",23,Porto,Primeira Liga,2.5,2,2,1,1,0,1,6,16.7,5,0,0,0,1,3,4,0
Gonçalo Borges,POR,"MF,FW",22,Porto,Primeira Liga,3.2,7,4,6,1,0,4,8,50.0,4,3,0,3,0,7,4,0
Danny Loader,ENG,"FW,MF",22,Porto,Primeira Liga,2.7,4,2,0,4,0,1,3,33.3,2,5,0,5,0,4,2,0
Fran Navarro,ESP,"FW,MF",25,Porto,Primeira Liga,1.9,1,0,1,0,0,0,3,0.0,3,1,0,1,3,4,3,0
Cláudio Ramos,POR,GK,31,Porto,Primeira Liga,1.3,0,0,0,0,0,0,0,0.0,0,0,0,0,1,1,0,0
Otávio,POR,"MF,FW",28,Porto,Primeira Liga,1.0,0,0,0,0,0,0,3,0.0,3,0,0,0,0,0,0,0
Gonçalo Sousa,POR,FW,17,Porto,Primeira Liga,0.1,0,0,0,0,0,0,0,0.0,0,0,0,0,0,0,1,0
Matheus,BRA,GK,31,Braga,Primeira Liga,34.0,1,1,1,0,0,0,2,0.0,2,1,0,1,0,1,20,2
Cristian Borja,COL,DF,30,Braga,Primeira Liga,27.2,61,33,36,23,2,23,42,54.8,19,25,5,20,22,83,55,0
Ricardo Horta,POR,"FW,MF",28,Braga,Primeira Liga,26.0,23,13,9,11,3,5,37,13.5,32,23,2,21,11,34,12,0
Victor Gomez,ESP,DF,23,Braga,Primeira Liga,22.6,41,27,18,17,6,31,49,63.3,18,22,6,16,26,67,62,1
João Moutinho,POR,MF,36,Braga,Primeira Liga,23.5,68,42,24,42,2,31,69,44.9,38,27,8,19,30,98,28,1
Simon Banza,COD,FW,26,Braga,Primeira Liga,22.2,11,6,4,2,5,1,10,10.0,9,16,1,15,8,19,14,0
Rodrigo Zalazar,URU,MF,23,Braga,Primeira Liga,20.2,40,27,11,24,5,18,42,42.9,24,33,3,30,9,49,16,3
Alvaro djaló,ESP,"FW,MF",23,Braga,Primeira Liga,19.9,27,19,7,14,6,15,45,33.3,30,17,1,16,23,50,15,0
Abel Ruiz,ESP,"FW,MF",23,Braga,Primeira Liga,21.1,8,6,1,4,3,4,8,50.0,4,6,1,5,6,14,12,0
Bruma,POR,"FW,MF",28,Braga,Primeira Liga,19.1,22,12,6,12,4,8,27,29.6,19,13,1,12,6,28,4,0
Paulo Oliveira,POR,DF,31,Braga,Primeira Liga,18.6,34,18,20,13,1,21,31,67.7,10,18,9,9,35,69,79,1
Serdar Saatçı,TUR,DF,20,Braga,Primeira Liga,16.6,27,17,18,9,0,17,24,70.8,7,17,10,7,38,65,46,3
José Fonte,POR,DF,39,Braga,Primeira Liga,16.8,8,3,6,2,0,3,8,37.5,5,18,13,5,20,28,70,0
Sikou Niakaté,MLI,DF,24,Braga,Primeira Liga,16.5,13,9,8,5,0,8,12,66.7,4,13,7,6,16,29,72,2
Vitor Carvalho,BRA,MF,26,Braga,Primeira Liga,14.5,41,22,21,19,1,22,37,59.5,15,22,4,18,17,58,29,1
Pizzi,POR,"MF,FW",33,Braga,Primeira Liga,10.7,6,4,4,1,1,2,8,25.0,6,8,0,8,3,9,6,1
Joe Mendes,SWE,DF,20,Braga,Primeira Liga,9.9,18,8,10,6,2,8,17,47.1,9,7,3,4,6,24,20,0
Almoatasem Al Musrati,LBY,MF,27,Braga,Primeira Liga,8.9,20,14,9,10,1,9,14,64.3,5,4,2,2,14,34,8,1
Roger Fernandes,GNB,"MF,FW",17,Braga,Primeira Liga,7.5,16,11,3,10,3,9,20,45.0,11,10,0,10,4,20,3,0
André Horta,POR,MF,26,Braga,Primeira Liga,6.1,12,8,2,4,6,8,15,53.3,7,12,1,11,1,13,5,0
Adrián Marín,ESP,DF,26,Braga,Primeira Liga,3.6,7,3,2,3,2,3,5,60.0,2,6,3,3,6,13,7,0
Rony Lopes,POR,"FW,MF",27,Braga,Primeira Liga,4.1,6,6,1,2,3,3,4,75.0,1,3,1,2,2,8,4,0
Cher Ndour,ITA,MF,19,Braga,Primeira Liga,2.3,7,4,4,3,0,1,4,25.0,3,3,1,2,5,12,5,0
André Castro,POR,MF,35,Braga,Primeira Liga,0.5,1,0,0,1,0,1,4,25.0,3,4,1,3,1,2,1,0
Nuno Matos,POR,DF,18,Braga,Primeira Liga,0.1,0,0,0,0,0,0,2,0.0,2,0,0,0,0,0,0,0
Jota Silva,POR,"FW,MF",23,Vitória,Primeira Liga,30.9,35,18,12,14,9,11,43,25.6,32,34,2,32,17,52,28,0
Tomás Händel,POR,MF,22,Vitória,Primeira Liga,28.0,48,31,16,26,6,28,47,59.6,19,21,3,18,23,71,10,0
Jorge Filipe Oliveira Fernandes,POR,DF,26,Vitória,Primeira Liga,27.1,52,39,29,22,1,38,68,55.9,30,35,11,24,26,78,115,0
Tomás Ribeiro,POR,DF,24,Vitória,Primeira Liga,27.0,33,17,16,14,3,19,34,55.9,15,36,17,19,21,54,88,0
Tiago Silva,POR,MF,30,Vitória,Primeira Liga,25.9,45,30,14,24,7,22,46,47.8,24,17,1,16,27,72,13,0
Bruno Gaspar,ANG,"MF,DF",30,Vitória,Primeira Liga,25.4,37,23,21,10,6,19,32,59.4,13,35,4,31,17,54,32,1
Bruno Varela,CPV,GK,28,Vitória,Primeira Liga,26.5,0,0,0,0,0,0,1,0.0,1,0,0,0,0,0,9,1
Toni Borevkovic,CRO,DF,26,Vitória,Primeira Liga,22.7,22,14,20,2,0,22,28,78.6,6,25,11,14,36,58,108,0
Ricardo Mangas,POR,"MF,DF",25,Vitória,Primeira Liga,21.2,25,17,16,7,2,14,27,51.9,13,15,3,12,14,39,27,0
André Silva,BRA,FW,26,Vitória,Primeira Liga,19.7,19,10,3,12,4,8,13,61.5,5,20,1,19,5,24,17,0
Manuel Manu,POR,"DF,MF",22,Vitória,Primeira Liga,19.7,50,33,37,12,1,27,50,54.0,23,23,13,10,22,72,78,3
João Mendes,POR,"FW,MF",28,Vitória,Primeira Liga,16.0,21,9,5,10,6,10,29,34.5,19,19,1,18,9,30,7,1
Afonso freitas,POR,"DF,MF",23,Vitória,Primeira Liga,8.1,16,11,8,5,3,8,12,66.7,4,5,0,5,4,20,15,0
Nuno Santos,POR,"FW,MF",24,Vitória,Primeira Liga,10.7,10,6,3,7,0,5,26,19.2,21,12,0,12,5,15,5,0
Miguel Magalhães,POR,"DF,MF",20,Vitória,Primeira Liga,9.9,30,19,17,11,2,21,31,67.7,10,10,2,8,14,44,25,1
Daniel Bandeira,POR,MF,23,Vitória,Primeira Liga,7.8,8,6,3,3,2,3,7,42.9,4,6,0,6,11,19,11,0
Charles,BRA,GK,29,Vitória,Primeira Liga,7.5,0,0,0,0,0,0,1,0.0,1,0,0,0,0,0,6,0
André André,POR,MF,33,Vitória,Primeira Liga,7.3,9,4,3,5,1,6,10,60.0,4,9,1,8,4,13,7,0
Nélson Oliveira,POR,FW,31,Vitória,Primeira Liga,6.7,4,4,1,3,0,0,1,0.0,1,4,1,3,2,6,3,0
Mikel Villanueva,VEN,DF,30,Vitória,Primeira Liga,5.1,4,3,1,1,2,3,4,75.0,1,8,5,3,8,12,16,0
Kaio,BRA,FW,19,Vitória,Primeira Liga,4.7,10,8,6,3,1,6,13,46.2,7,8,0,8,0,10,1,0
Adrián Butzke,ESP,FW,24,Vitória,Primeira Liga,4.1,3,3,0,3,0,1,2,50.0,1,4,1,3,0,3,8,0
Zé Carlos,POR,"MF,DF",21,Vitória,Primeira Liga,4.7,10,5,5,5,0,6,18,33.3,12,6,1,5,6,16,7,0
Nelson,ANG,"DF,FW",25,Vitória,Primeira Liga,4.5,10,8,3,4,3,5,11,45.5,6,11,0,11,6,16,4,0
Safira,BRA,FW,28,Vitória,Primeira Liga,1.6,4,2,2,2,0,1,1,100.0,0,2,0,2,0,4,3,0
Alberto costa,POR,DF,19,Vitória,Primeira Liga,0.2,0,0,0,0,0,0,0,0.0,0,0,0,0,0,0,0,0
Gonçalo Nogueira,POR,MF,19,Vitória,Primeira Liga,0.1,0,0,0,0,0,0,0,0.0,0,1,0,1,0,0,0,0
Gonçalo Franco,POR,MF,22,Moreirense,Primeira Liga,30.2,81,54,38,33,10,29,75,38.7,46,57,5,52,59,140,52,0
Kewin,BRA,GK,27,Moreirense,Primeira Liga,29.8,1,1,1,0,0,0,0,0.0,0,0,0,0,0,1,16,2
Maracás,BRA,DF,29,Moreirense,Primeira Liga,28.5,44,35,35,8,1,24,34,70.6,10,34,28,6,22,66,150,0
Lawrence Ofori,GHA,MF,25,Moreirense,Primeira Liga,27.3,27,13,10,15,2,8,38,21.1,30,22,5,17,17,44,19,1
Alan,BRA,MF,23,Moreirense,Primeira Liga,27.3,44,32,7,25,12,9,29,31.0,20,24,2,22,7,51,5,0
João Pedro Gomes Camacho,POR,"FW,MF",29,Moreirense,Primeira Liga,23.1,37,25,13,14,10,15,28,53.6,13,23,2,21,14,51,16,0
Marcelo dos Santos Ferreira,BRA,DF,34,Moreirense,Primeira Liga,26.0,36,20,28,8,0,18,31,58.1,13,39,27,12,28,64,142,0
Fabiano,BRA,DF,23,Moreirense,Primeira Liga,23.7,45,30,27,11,7,25,35,71.4,10,13,2,11,29,74,60,1
Godfried Frimpong,NED,DF,24,Moreirense,Primeira Liga,22.4,35,22,26,7,2,21,29,72.4,8,21,5,16,39,74,81,0
Kobamelo Kodisang,RSA,FW,23,Moreirense,Primeira Liga,18.0,10,6,7,3,0,6,17,35.3,11,12,1,11,16,26,10,0
André Luis,BRA,FW,29,Moreirense,Primeira Liga,14.8,8,6,2,4,2,4,10,40.0,6,11,3,8,6,14,24,0
Madson,BRA,"FW,MF",23,Moreirense,Primeira Liga,14.9,6,4,2,3,1,1,9,11.1,8,17,0,17,11,17,18,0
Pedro Amador,POR,DF,24,Moreirense,Primeira Liga,12.6,28,19,16,10,2,16,31,51.6,15,17,3,14,15,43,32,0
Carlos Ponck,CPV,DF,28,Moreirense,Primeira Liga,11.5,20,17,12,8,0,14,17,82.4,3,16,10,6,12,32,61,2
Dinis Pinto,POR,DF,22,Moreirense,Primeira Liga,10.4,20,12,10,6,4,10,14,71.4,4,10,3,7,8,28,24,0
Luismi,EQG,FW,22,Moreirense,Primeira Liga,10.4,20,11,7,10,3,7,19,36.8,12,22,3,19,4,24,10,0
André Castro,POR,MF,35,Moreirense,Primeira Liga,6.0,15,10,6,7,2,10,17,58.8,7,6,0,6,6,21,15,0
Vinicius Mingotti,BRA,FW,23,Moreirense,Primeira Liga,5.4,6,3,1,4,1,0,1,0.0,1,4,0,4,0,6,3,0
Rúben Ramos,POR,MF,24,Moreirense,Primeira Liga,6.2,6,1,1,4,1,2,8,25.0,6,8,4,4,7,13,14,0
Matheus Aiás,BRA,"FW,MF",26,Moreirense,Primeira Liga,5.3,4,2,2,0,2,1,10,10.0,9,7,4,3,4,8,2,0
Caio Secco,BRA,GK,32,Moreirense,Primeira Liga,4.0,0,0,0,0,0,0,0,0.0,0,0,0,0,0,0,1,0
Jeremy Antonisse,CUW,FW,21,Moreirense,Primeira Liga,6.1,13,8,8,5,0,8,20,40.0,12,8,1,7,5,18,9,0
Pedro Aparício,POR,"MF,FW",27,Moreirense,Primeira Liga,3.7,2,1,1,1,0,1,6,16.7,5,0,0,0,1,3,3,0
Gilberto Batista,POR,DF,19,Moreirense,Primeira Liga,2.5,3,2,3,0,0,2,4,50.0,2,5,5,0,1,4,19,1
Wallisson Luiz,BRA,"MF,FW",25,Moreirense,Primeira Liga,2.2,13,7,4,5,4,6,10,60.0,4,3,1,2,6,19,11,0
Hernani Infande,POR,"FW,MF",22,Moreirense,Primeira Liga,0.9,4,2,1,2,1,3,5,60.0,2,2,0,2,1,5,0,0
Rodrigo Macedo,POR,"FW,MF",20,Moreirense,Primeira Liga,0.7,4,2,1,2,1,2,3,66.7,1,1,0,1,0,4,0,0
Mika,POR,GK,32,Moreirense,Primeira Liga,0.2,0,0,0,0,0,0,0,0.0,0,0,0,0,0,0,0,0
Miguel Rebelo,POR,MF,19,Moreirense,Primeira Liga,0.0,0,0,0,0,0,0,0,0.0,0,0,0,0,0,0,0,0
Cristo González,ESP,"FW,MF",25,Arouca,Primeira Liga,30.9,20,15,4,7,9,9,31,29.0,22,9,1,8,6,26,12,0
Morlaye Sylla,GUI,"MF,FW",25,Arouca,Primeira Liga,28.7,69,41,24,31,14,38,73,52.1,35,42,3,39,27,96,17,0
Jason,ESP,"FW,MF",29,Arouca,Primeira Liga,28.5,22,17,5,10,7,9,39,23.1,30,29,3,26,12,34,8,0
Ignacio De Arruabarrena,URU,GK,26,Arouca,Primeira Liga,31.0,3,2,3,0,0,3,6,50.0,3,0,0,0,1,4,23,3
David Simão,POR,MF,33,Arouca,Primeira Liga,28.4,47,28,22,21,4,28,63,44.4,35,40,9,31,34,81,22,3
Francisco Montero,ESP,DF,24,Arouca,Primeira Liga,28.7,28,20,24,4,0,14,35,40.0,21,35,19,16,31,59,137,1
Rafa Mújica,ESP,FW,24,Arouca,Primeira Liga,28.1,22,14,5,8,9,2,13,15.4,11,23,3,20,5,27,16,0
Tiago Esgaio,POR,DF,27,Arouca,Primeira Liga,25.3,61,37,37,20,4,42,68,61.8,26,36,9,27,34,95,72,0
Weverson,BRA,DF,23,Arouca,Primeira Liga,22.2,53,29,25,24,4,34,48,70.8,14,28,6,22,17,70,46,0
Pedro Santos,POR,MF,22,Arouca,Primeira Liga,16.1,29,20,8,18,3,18,45,40.0,27,19,1,18,11,40,8,0
Nino Galović,CRO,DF,31,Arouca,Primeira Liga,16.0,10,6,6,2,2,7,17,41.2,10,10,7,3,16,26,68,0
Eboue Kouassi,CIV,MF,25,Arouca,Primeira Liga,15.0,26,17,12,11,3,14,27,51.9,13,17,7,10,11,37,39,0
Bogdan Milovanov,UKR,DF,25,Arouca,Primeira Liga,13.4,49,30,24,21,4,29,51,56.9,22,12,4,8,13,62,33,0
Robson Bambu,BRA,DF,25,Arouca,Primeira Liga,9.8,15,12,9,6,0,7,11,63.6,4,12,8,4,9,24,35,0
Alfonso Trezza,URU,"FW,MF",24,Arouca,Primeira Liga,9.3,17,14,11,6,0,7,24,29.2,17,15,0,15,6,23,8,0
Rafael Fernandes,POR,DF,21,Arouca,Primeira Liga,8.3,12,8,8,2,2,6,7,85.7,1,6,5,1,9,21,31,0
Matí­as Rocha,URU,DF,22,Arouca,Primeira Liga,6.2,6,4,3,3,0,5,8,62.5,3,2,2,0,6,12,26,0
Oriol Busquets,ESP,MF,24,Arouca,Primeira Liga,4.8,9,5,5,3,1,3,4,75.0,1,5,3,2,2,11,10,0
Quaresma,BRA,DF,26,Arouca,Primeira Liga,3.3,8,6,4,3,1,6,13,46.2,7,5,1,4,5,13,6,1
Mosquito,BRA,GK,27,Arouca,Primeira Liga,2.0,0,0,0,0,0,0,0,0.0,0,0,0,0,0,0,0,0
Uladzislaŭ Marozaŭ,BLR,"FW,MF",22,Arouca,Primeira Liga,1.6,0,0,0,0,0,0,2,0.0,2,1,0,1,0,0,1,0
Yusuf Lawal,NGA,"FW,MF",25,Arouca,Primeira Liga,2.6,4,2,2,2,0,0,2,0.0,2,4,0,4,3,7,2,0
Jerome Opoku,GHA,DF,24,Arouca,Primeira Liga,1.5,1,0,0,0,1,0,0,0.0,0,2,0,2,0,1,9,0
Vitinho,BRA,"FW,MF",23,Arouca,Primeira Liga,1.1,4,4,3,0,1,1,3,33.3,2,2,0,2,2,6,1,0
João Valido,POR,GK,23,Arouca,Primeira Liga,1.0,1,1,1,0,0,1,2,50.0,1,0,0,0,0,1,2,0
Miguel Puche García,ESP,"FW,MF",22,Arouca,Primeira Liga,3.4,6,2,5,1,0,4,5,80.0,1,1,0,1,1,7,1,0
André Bukia,COD,"MF,FW",28,Arouca,Primeira Liga,1.7,5,4,3,1,1,3,6,50.0,3,3,0,3,1,6,1,0
Moses Yaw,GHA,"DF,MF",24,Arouca,Primeira Liga,0.8,1,1,1,0,0,1,1,100.0,0,1,0,1,0,1,1,0
Benji Michel,USA,"FW,MF",25,Arouca,Primeira Liga,0.5,0,0,0,0,0,0,0,0.0,0,0,0,0,0,0,1,0
Yanis Hamache,ALG,DF,24,Arouca,Primeira Liga,0.5,1,0,1,0,0,0,0,0.0,0,2,1,1,0,1,1,0
Pedro Manuel da Silva Moreira,POR,MF,34,Arouca,Primeira Liga,0.5,1,0,0,0,1,0,0,0.0,0,0,0,0,0,1,0,0
Luiz Lúcio Reis Júnior,BRA,GK,22,Famalicão,Primeira Liga,33.0,1,0,1,0,0,1,3,33.3,2,1,0,1,1,2,28,2
Moura,POR,DF,23,Famalicão,Primeira Liga,33.0,55,35,29,13,13,29,41,70.7,12,43,7,36,33,88,79,1
Zaydou Youssouf,FRA,MF,24,Famalicão,Primeira Liga,30.7,76,48,34,32,10,28,60,46.7,32,32,2,30,27,103,25,0
Jhonder Cádiz,VEN,FW,28,Famalicão,Primeira Liga,25.6,10,7,1,6,3,2,9,22.2,7,4,2,2,1,11,21,0
Mirko Topić,SRB,MF,22,Famalicão,Primeira Liga,26.1,51,39,24,24,3,21,31,67.7,10,27,4,23,47,98,47,1
Gustavo sá,POR,MF,18,Famalicão,Primeira Liga,20.4,37,22,6,22,9,12,40,30.0,28,16,5,11,12,49,31,0
Chiquinho,POR,"FW,MF",23,Famalicão,Primeira Liga,19.3,31,18,13,15,3,12,31,38.7,19,43,4,39,13,44,10,0
Nathan,BRA,DF,21,Famalicão,Primeira Liga,20.5,61,42,39,20,2,27,59,45.8,32,18,1,17,19,80,38,0
Riccieli,BRA,DF,24,Famalicão,Primeira Liga,19.7,23,14,17,6,0,15,29,51.7,14,26,13,13,13,36,84,0
Justin de Haas,NED,DF,23,Famalicão,Primeira Liga,17.8,22,15,16,6,0,11,21,52.4,10,16,12,4,24,46,80,1
Enea Mihaj,ALB,DF,25,Famalicão,Primeira Liga,17.3,20,15,14,6,0,14,22,63.6,8,25,19,6,23,43,75,0
José Luis Rodríguez,PAN,FW,25,Famalicão,Primeira Liga,16.6,20,14,12,5,3,16,30,53.3,14,13,3,10,10,30,16,0
Otavio Ataide,BRA,DF,21,Famalicão,Primeira Liga,15.4,31,21,24,5,2,20,31,64.5,11,33,21,12,25,56,66,0
Martin Agirregabiria,ESP,DF,27,Famalicão,Primeira Liga,13.4,21,18,15,4,2,17,24,70.8,7,12,2,10,11,32,31,0
Marcos Vinicios Sorriso,BRA,"FW,MF",22,Famalicão,Primeira Liga,9.5,14,9,4,8,2,8,17,47.1,9,11,0,11,7,21,11,0
Oscar Aranda,ESP,"FW,MF",21,Famalicão,Primeira Liga,8.0,7,4,1,4,2,2,10,20.0,8,6,2,4,1,8,1,0
Théo Fonseca,FRA,FW,23,Famalicão,Primeira Liga,7.2,10,3,5,3,2,3,6,50.0,3,7,2,5,7,17,7,0
Henrique Araújo,POR,FW,21,Famalicão,Primeira Liga,7.6,3,1,0,3,0,1,3,33.3,2,3,1,2,1,4,3,0
Gustavo Assuncao,POR,MF,23,Famalicão,Primeira Liga,7.0,17,12,11,6,0,10,20,50.0,10,8,2,6,9,26,16,1
Otso Liimatta,FIN,"MF,FW",19,Famalicão,Primeira Liga,5.2,6,3,3,2,1,3,9,33.3,6,2,0,2,3,9,0,0
Tom Lacoux,FRA,MF,21,Famalicão,Primeira Liga,4.0,12,8,7,4,1,7,11,63.6,4,9,4,5,6,18,2,0
Mihai Dobre,ROU,FW,24,Famalicão,Primeira Liga,3.9,5,3,4,0,1,3,12,25.0,9,4,0,4,3,8,5,0
Florian Danho Seke,FRA,FW,23,Famalicão,Primeira Liga,2.7,3,3,1,0,2,2,2,100.0,0,5,0,5,0,3,3,0
Pablo,BRA,"FW,MF",19,Famalicão,Primeira Liga,2.2,3,3,3,0,0,2,4,50.0,2,4,1,3,1,4,3,0
Afonso Rodrigues,POR,"FW,MF",20,Famalicão,Primeira Liga,2.6,4,0,0,2,2,2,5,40.0,3,4,0,4,2,6,4,0
Ivan Zlobin,RUS,GK,26,Famalicão,Primeira Liga,1.0,0,0,0,0,0,0,0,0.0,0,0,0,0,0,0,0,0
Filipe Soares,POR,MF,24,Famalicão,Primeira Liga,1.9,4,2,1,1,2,1,3,33.3,2,0,0,0,0,4,1,0
Leonardo Lelo,POR,"DF,MF",23,Casa Pia,Primeira Liga,32.7,53,32,35,13,5,40,74,54.1,34,35,6,29,37,90,70,0
Ricardo Batista,POR,GK,36,Casa Pia,Primeira Liga,30.9,1,0,1,0,0,1,3,33.3,2,0,0,0,0,1,6,1
Nermin Zolotić,BIH,DF,30,Casa Pia,Primeira Liga,29.7,41,29,26,14,1,32,49,65.3,17,40,22,18,28,69,127,2
Larra,ESP,"DF,MF",25,Casa Pia,Primeira Liga,27.9,46,36,27,14,5,26,45,57.8,19,28,6,22,43,89,69,0
Neto,BRA,MF,31,Casa Pia,Primeira Liga,25.0,50,32,26,18,6,31,62,50.0,31,37,9,28,21,71,44,0
Fernando Varela,CPV,DF,35,Casa Pia,Primeira Liga,23.0,28,20,20,7,1,15,23,65.2,8,33,19,14,17,45,113,0
Yuki Soma,JPN,"FW,MF",26,Casa Pia,Primeira Liga,21.0,20,14,6,10,4,7,21,33.3,14,12,1,11,4,24,11,0
Clayton,BRA,FW,24,Casa Pia,Primeira Liga,18.8,9,7,1,3,5,1,14,7.1,13,13,2,11,3,12,12,0
Pablo Roberto,BRA,"MF,FW",23,Casa Pia,Primeira Liga,18.5,25,13,4,19,2,13,33,39.4,20,18,1,17,17,42,9,1
Felippe Cardoso,BRA,FW,24,Casa Pia,Primeira Liga,17.4,14,8,1,7,6,3,13,23.1,10,7,1,6,1,15,7,0
João Nunes,POR,DF,27,Casa Pia,Primeira Liga,14.7,12,7,8,4,0,8,20,40.0,12,19,11,8,14,26,55,1
Beni,ANG,MF,21,Casa Pia,Primeira Liga,16.3,32,24,17,15,0,13,28,46.4,15,17,2,15,19,51,18,0
Duplexe Tchamba,CMR,DF,25,Casa Pia,Primeira Liga,13.9,23,14,17,5,1,16,26,61.5,10,14,6,8,18,41,79,1
Nuno Gonçalo Moreira,POR,"FW,MF",24,Casa Pia,Primeira Liga,11.3,21,12,4,13,4,7,20,35.0,13,12,1,11,9,30,7,0
Vasco Fernandes,POR,DF,36,Casa Pia,Primeira Liga,10.0,8,5,7,1,0,5,9,55.6,4,13,6,7,10,18,29,0
Tiago Dias,POR,"MF,FW",25,Casa Pia,Primeira Liga,8.8,8,7,4,3,1,4,14,28.6,10,15,1,14,5,13,4,0
Telasco Segovia,VEN,MF,20,Casa Pia,Primeira Liga,8.3,29,19,12,16,1,15,31,48.4,16,7,1,6,15,44,6,0
André Geraldes,POR,"MF,DF",32,Casa Pia,Primeira Liga,6.7,7,3,6,1,0,3,4,75.0,1,5,1,4,2,9,15,0
Samuel Justo,POR,MF,19,Casa Pia,Primeira Liga,6.7,9,6,4,4,1,6,14,42.9,8,7,1,6,4,13,13,0
Rúben Lameiras,POR,"FW,MF",28,Casa Pia,Primeira Liga,6.1,7,5,4,1,2,5,9,55.6,4,4,0,4,4,11,4,0
Rafael Brito,POR,MF,21,Casa Pia,Primeira Liga,3.8,12,8,4,5,3,4,12,33.3,8,3,1,2,5,17,8,0
Fernando,BRA,"FW,MF",30,Casa Pia,Primeira Liga,6.0,10,6,4,3,3,3,8,37.5,5,6,0,6,0,10,2,0
Saviour Godwin,NGA,"FW,MF",26,Casa Pia,Primeira Liga,3.8,5,3,3,1,1,0,1,0.0,1,7,0,7,4,9,0,0
Jajá,BRA,"FW,MF",22,Casa Pia,Primeira Liga,4.8,19,16,4,7,8,9,16,56.3,7,9,0,9,1,20,2,0
Lucas Paes,BRA,GK,25,Casa Pia,Primeira Liga,3.0,0,0,0,0,0,0,1,0.0,1,0,0,0,0,0,0,0
André Lacximicant,POR,"FW,MF",22,Casa Pia,Primeira Liga,2.4,4,2,0,2,2,0,0,0.0,0,2,0,2,0,4,1,0
Artur Serobyan,ARM,MF,20,Casa Pia,Primeira Liga,0.7,1,1,0,1,0,1,2,50.0,1,0,0,0,1,2,1,0
Kevin Krygård,NOR,"MF,DF",23,Casa Pia,Primeira Liga,0.7,4,1,3,1,0,1,6,16.7,5,3,1,2,3,7,0,0
Rafael Martins,BRA,MF,34,Casa Pia,Primeira Liga,0.3,0,0,0,0,0,0,0,0.0,0,0,0,0,0,0,0,0
Fahem Benaissa Yahia,FRA,MF,21,Casa Pia,Primeira Liga,0.1,0,0,0,0,0,0,1,0.0,1,0,0,0,0,0,0,0
Diogo Pinto,POR,MF,24,Casa Pia,Primeira Liga,0.1,0,0,0,0,0,0,0,0.0,0,0,0,0,0,0,0,0
Francisco Kiki,POR,MF,25,Casa Pia,Primeira Liga,0.1,0,0,0,0,0,0,0,0.0,0,0,0,0,0,0,0,0
Gonçalo Silva,POR,DF,32,Farense,Primeira Liga,32.0,36,21,29,7,0,22,35,62.9,13,45,32,13,39,75,231,1
Ricardo Velho,POR,GK,24,Farense,Primeira Liga,32.0,0,0,0,0,0,0,1,0.0,1,0,0,0,0,0,21,2
Claudio Falcão,BRA,MF,29,Farense,Primeira Liga,28.9,78,45,33,44,1,29,82,35.4,53,48,17,31,40,118,128,1
Marco Matias,POR,"FW,MF",34,Farense,Primeira Liga,25.5,40,26,20,12,8,13,32,40.6,19,19,0,19,22,62,20,0
David Pastor,BRA,DF,23,Farense,Primeira Liga,27.5,55,34,34,19,2,31,60,51.7,29,32,7,25,50,105,83,0
Mattheus Oliveira,BRA,MF,29,Farense,Primeira Liga,24.8,44,34,24,17,3,19,43,44.2,24,40,8,32,27,71,42,0
Bruno Duarte,BRA,FW,27,Farense,Primeira Liga,25.1,15,9,1,11,3,8,27,29.6,19,24,5,19,7,22,27,0
Bachir Belloumi,ALG,"FW,MF",21,Farense,Primeira Liga,23.0,41,28,19,17,5,17,41,41.5,24,38,6,32,21,62,32,0
Talocha,POR,DF,33,Farense,Primeira Liga,22.9,36,26,21,13,2,18,25,72.0,7,31,13,18,26,62,87,0
Zach Muscat,MLT,DF,29,Farense,Primeira Liga,18.7,11,4,5,6,0,6,14,42.9,8,42,33,9,15,26,103,0
Fabrício Isidoro,BRA,MF,31,Farense,Primeira Liga,18.5,25,10,14,8,3,13,37,35.1,24,27,9,18,22,47,19,0
Facundo Cáseres,ARG,MF,22,Farense,Primeira Liga,12.4,49,25,27,20,2,21,33,63.6,12,35,14,21,11,60,17,0
Igor Rossi Branco,BRA,DF,34,Farense,Primeira Liga,11.3,8,6,7,0,1,6,7,85.7,1,4,4,0,12,20,64,0
Talys Oliveira,BRA,DF,24,Farense,Primeira Liga,10.9,18,13,12,5,1,12,23,52.2,11,13,3,10,18,36,43,0
Elves Baldé,POR,"FW,MF",23,Farense,Primeira Liga,10.8,9,5,6,2,1,6,17,35.3,11,11,2,9,1,10,12,0
Rafael Barbosa,POR,"MF,FW",27,Farense,Primeira Liga,9.5,12,9,5,4,3,6,11,54.5,5,8,4,4,4,16,3,0
Rui Costa,POR,"FW,MF",27,Farense,Primeira Liga,7.8,3,2,2,1,0,3,5,60.0,2,7,1,6,0,3,2,0
Vítor Gonçalves,POR,MF,31,Farense,Primeira Liga,7.7,10,7,2,4,4,2,4,50.0,2,12,3,9,4,14,17,0
Fran Delgado,ESP,DF,22,Farense,Primeira Liga,5.5,7,2,3,3,1,4,6,66.7,2,9,2,7,2,9,8,0
Zé Luís,CPV,"FW,MF",32,Farense,Primeira Liga,6.6,3,3,0,1,2,1,3,33.3,2,9,3,6,1,4,4,0
Artur Jorge Marques Amorim,POR,DF,28,Farense,Primeira Liga,5.5,7,4,5,2,0,4,5,80.0,1,10,8,2,7,14,37,0
Miguel Carvalho,POR,GK,27,Farense,Primeira Liga,2.0,0,0,0,0,0,0,0,0.0,0,0,0,0,0,0,1,0
Cristian Ponde,POR,"MF,FW",28,Farense,Primeira Liga,2.5,5,3,2,3,0,1,5,20.0,4,6,1,5,3,8,2,0
André Seruca,POR,MF,22,Farense,Primeira Liga,0.4,3,2,3,0,0,2,2,100.0,0,2,0,2,0,3,0,0
Jhon Velásquez,COL,"FW,MF",28,Farense,Primeira Liga,0.3,0,0,0,0,0,0,1,0.0,1,0,0,0,0,0,1,0
Costinha,POR,"MF,DF",23,Rio Ave,Primeira Liga,33.9,95,60,41,43,11,55,104,52.9,49,88,12,76,40,135,92,3
Aderlan Santos,BRA,DF,34,Rio Ave,Primeira Liga,31.6,68,44,50,18,0,34,47,72.3,13,58,40,18,45,113,167,1
Fábio Conceição,POR,"MF,FW",22,Rio Ave,Primeira Liga,28.2,36,24,25,7,4,22,52,42.3,30,35,5,30,17,53,35,0
Amine Oudrhiri,MAR,MF,30,Rio Ave,Primeira Liga,24.7,34,22,8,21,5,19,34,55.9,15,22,4,18,30,64,20,3
Jhonatan,BRA,GK,32,Rio Ave,Primeira Liga,26.0,0,0,0,0,0,0,0,0.0,0,0,0,0,1,1,16,3
Josué Sá,POR,DF,31,Rio Ave,Primeira Liga,21.8,30,20,18,11,1,16,26,61.5,10,24,11,13,23,53,78,0
Joca,POR,"FW,MF",27,Rio Ave,Primeira Liga,19.0,11,5,4,2,5,8,17,47.1,9,13,1,12,13,24,15,0
Emmanuel Boateng,GHA,FW,27,Rio Ave,Primeira Liga,20.7,12,9,4,6,2,3,7,42.9,4,11,3,8,5,17,16,0
Miguel Nóbrega,POR,DF,23,Rio Ave,Primeira Liga,18.0,32,20,17,14,1,20,32,62.5,12,22,12,10,22,54,79,1
Gonçalo Rodrigues,POR,MF,26,Rio Ave,Primeira Liga,13.7,22,12,3,15,4,10,27,37.0,17,8,0,8,4,26,8,0
Renato Pantalon,CRO,DF,25,Rio Ave,Primeira Liga,14.9,22,10,11,10,1,11,16,68.8,5,15,8,7,9,31,54,0
João Graça,POR,MF,28,Rio Ave,Primeira Liga,13.3,38,25,13,18,7,20,44,45.5,24,8,3,5,9,47,9,0
Abdul-Aziz Yakubu,GHA,FW,24,Rio Ave,Primeira Liga,12.4,2,2,0,2,0,1,8,12.5,7,3,2,1,0,2,17,0
Patrick,BRA,DF,26,Rio Ave,Primeira Liga,12.4,18,8,14,4,0,12,21,57.1,9,9,2,7,26,44,44,0
Umaro Embaló,POR,"MF,FW",22,Rio Ave,Primeira Liga,8.8,10,4,3,6,1,0,7,0.0,7,9,0,9,3,13,9,0
João Teixeira,POR,"MF,FW",29,Rio Ave,Primeira Liga,8.0,17,10,9,7,1,9,21,42.9,12,14,2,12,4,21,5,0
Leonardo Ruíz,COL,FW,27,Rio Ave,Primeira Liga,8.3,6,6,2,3,1,5,12,41.7,7,3,1,2,4,10,13,0
Magrão,BRA,GK,23,Rio Ave,Primeira Liga,7.0,2,1,2,0,0,2,2,100.0,0,0,0,0,0,2,2,1
Mateo Tanlongo,ARG,MF,19,Rio Ave,Primeira Liga,6.8,18,8,6,9,3,5,15,33.3,10,4,1,3,8,26,1,0
André Pereira,POR,FW,28,Rio Ave,Primeira Liga,6.5,10,7,1,8,1,4,10,40.0,6,9,0,9,2,12,5,0
Marious Vrousai,GRE,"MF,DF",25,Rio Ave,Primeira Liga,7.4,20,13,9,9,2,10,18,55.6,8,15,3,12,6,26,18,0
Bruno Ventura,POR,"FW,MF",22,Rio Ave,Primeira Liga,5.8,3,1,2,0,1,2,7,28.6,5,3,0,3,2,5,7,0
Zé Manuel,POR,"FW,MF",32,Rio Ave,Primeira Liga,6.6,12,8,3,8,1,5,17,29.4,12,9,0,9,4,16,7,0
Hernâni Fortes,POR,FW,31,Rio Ave,Primeira Liga,3.8,0,0,0,0,0,0,4,0.0,4,1,1,0,1,1,1,0
Adrien Silva,POR,MF,34,Rio Ave,Primeira Liga,3.8,13,4,4,7,2,4,10,40.0,6,6,0,6,5,18,7,1
Savio,BRA,"DF,MF",28,Rio Ave,Primeira Liga,2.8,4,2,2,2,0,3,8,37.5,5,3,1,2,2,6,6,2
Vítor Gomes,POR,MF,35,Rio Ave,Primeira Liga,3.6,5,4,2,3,0,2,4,50.0,2,7,3,4,3,8,5,0
Cezary Miszta,POL,GK,21,Rio Ave,Primeira Liga,1.0,0,0,0,0,0,0,0,0.0,0,0,0,0,0,0,2,0
Ukra,POR,"FW,MF",35,Rio Ave,Primeira Liga,0.9,0,0,0,0,0,0,1,0.0,1,0,0,0,0,0,0,0
Cristian Castro,COL,DF,22,Rio Ave,Primeira Liga,0.8,0,0,0,0,0,0,2,0.0,2,1,1,0,1,1,8,0
Helder Sá,POR,"DF,MF",20,Rio Ave,Primeira Liga,0.5,0,0,0,0,0,0,1,0.0,1,2,2,0,0,0,4,0
Nuno Namora,POR,"DF,MF",25,Rio Ave,Primeira Liga,0.3,1,0,0,0,1,1,3,33.3,2,0,0,0,0,1,3,0
Julien Lomboto,FRA,MF,21,Rio Ave,Primeira Liga,0.1,0,0,0,0,0,0,0,0.0,0,1,1,0,0,0,2,0
Andrew,BRA,GK,22,Gil Vicente FC,Primeira Liga,32.0,0,0,0,0,0,0,0,0.0,0,0,0,0,0,0,14,2
Gabriel Pereira,BRA,DF,23,Gil Vicente FC,Primeira Liga,30.9,34,24,25,6,3,26,38,68.4,12,42,30,12,26,60,130,0
Rúben Fernandes,POR,DF,37,Gil Vicente FC,Primeira Liga,29.0,18,11,15,3,0,9,21,42.9,12,33,19,14,35,53,117,1
Maxime Dominguez,SUI,"MF,FW",27,Gil Vicente FC,Primeira Liga,25.9,46,26,16,25,5,28,68,41.2,40,51,4,47,28,74,6,2
Félix Correia,POR,FW,22,Gil Vicente FC,Primeira Liga,24.1,31,22,11,11,9,21,29,72.4,8,28,2,26,21,52,16,1
Murilo Costa,BRA,FW,28,Gil Vicente FC,Primeira Liga,22.1,21,15,9,12,0,10,20,50.0,10,16,0,16,16,37,13,0
Leonardo Buta,POR,DF,21,Gil Vicente FC,Primeira Liga,24.3,48,30,28,15,5,33,46,71.7,13,21,8,13,28,76,65,1
Kanya Fujimoto,JPN,MF,24,Gil Vicente FC,Primeira Liga,22.2,26,15,7,15,4,9,15,60.0,6,23,4,19,11,37,8,0
José Carlos,POR,DF,25,Gil Vicente FC,Primeira Liga,21.4,50,34,34,9,7,20,37,54.1,17,21,6,15,30,80,56,2
Mory Gbane,CIV,MF,22,Gil Vicente FC,Primeira Liga,21.2,59,36,28,21,10,32,47,68.1,15,33,15,18,27,86,52,1
Martim Carvalho,POR,MF,20,Gil Vicente FC,Primeira Liga,20.7,45,23,17,26,2,22,57,38.6,35,25,0,25,18,63,16,1
Pedro Tiba,POR,MF,34,Gil Vicente FC,Primeira Liga,16.6,46,35,23,15,8,22,44,50.0,22,15,4,11,15,61,17,0
Alexandre Pinto,POR,DF,25,Gil Vicente FC,Primeira Liga,11.8,25,17,13,10,2,14,24,58.3,10,6,1,5,15,40,57,1
Ali Alipour,IRN,FW,27,Gil Vicente FC,Primeira Liga,8.9,9,4,0,3,6,2,5,40.0,3,6,0,6,0,9,4,0
Roko Baturina,CRO,FW,23,Gil Vicente FC,Primeira Liga,7.9,1,1,0,0,1,0,3,0.0,3,2,0,2,0,1,5,0
Tidjany Chabrol,FRA,"FW,MF",21,Gil Vicente FC,Primeira Liga,12.0,13,8,3,9,1,5,17,29.4,12,14,2,12,3,16,8,1
Depú,ANG,FW,23,Gil Vicente FC,Primeira Liga,8.6,5,4,2,1,2,2,5,40.0,3,3,0,3,2,7,4,0
Kiko Vilas Boas,POR,DF,23,Gil Vicente FC,Primeira Liga,6.3,18,11,11,7,0,8,11,72.7,3,3,0,3,7,25,26,0
Jonathan Buatu Mananga,ANG,DF,29,Gil Vicente FC,Primeira Liga,5.0,8,4,8,0,0,5,5,100.0,0,7,3,4,1,9,22,0
Marlon,BRA,"FW,MF",25,Gil Vicente FC,Primeira Liga,4.8,4,3,1,2,1,3,12,25.0,9,8,0,8,3,7,5,0
Felipe Silva Lipe,BRA,DF,21,Gil Vicente FC,Primeira Liga,3.0,7,2,4,3,0,5,7,71.4,2,3,2,1,2,9,8,0
Né lopes,POR,DF,23,Gil Vicente FC,Primeira Liga,2.9,4,3,2,1,1,3,3,100.0,0,3,1,2,4,8,12,0
Jesús Castillo,PER,MF,22,Gil Vicente FC,Primeira Liga,2.7,6,5,1,4,1,4,9,44.4,5,4,1,3,4,10,8,0
Vinicius Dias,BRA,GK,26,Gil Vicente FC,Primeira Liga,2.0,0,0,0,0,0,0,0,0.0,0,0,0,0,0,0,0,1
Miguel Monteiro,POR,FW,20,Gil Vicente FC,Primeira Liga,2.5,0,0,0,0,0,0,1,0.0,1,0,0,0,1,1,2,0
Miro,ANG,"FW,MF",20,Gil Vicente FC,Primeira Liga,1.8,2,2,0,1,1,0,2,0.0,2,1,0,1,1,3,1,0
Roan Wilson,CRC,"MF,DF",21,Gil Vicente FC,Primeira Liga,1.4,8,4,2,6,0,4,6,66.7,2,3,0,3,2,10,3,0
Kazu,BRA,"DF,FW",23,Gil Vicente FC,Primeira Liga,0.6,2,0,1,0,1,1,4,25.0,3,0,0,0,2,4,0,0
Afonso Bastardo,POR,"FW,DF",18,Gil Vicente FC,Primeira Liga,0.5,1,1,0,0,1,0,1,0.0,1,1,0,1,1,2,0,0
Thomas Luciano,BRA,DF,21,Gil Vicente FC,Primeira Liga,0.3,3,1,0,1,2,1,1,100.0,0,1,0,1,0,3,1,0
André Simões,POR,FW,19,Gil Vicente FC,Primeira Liga,0.2,0,0,0,0,0,0,1,0.0,1,0,0,0,0,0,0,0
Rafik Guitane,FRA,"FW,MF",24,Estoril,Primeira Liga,30.1,18,9,5,10,3,5,18,27.8,13,18,1,17,7,25,3,0
Bernardo Vital,POR,DF,22,Estoril,Primeira Liga,28.3,39,21,24,14,1,23,40,57.5,17,38,24,14,23,62,107,2
Tiago Araújo,POR,"DF,MF",22,Estoril,Primeira Liga,25.0,34,22,17,14,3,21,48,43.8,27,23,0,23,27,61,67,1
Rodrigo Gomes,POR,"MF,DF",20,Estoril,Primeira Liga,27.2,47,30,21,19,7,19,49,38.8,30,39,6,33,25,72,53,1
Mateus Fernandes,POR,MF,19,Estoril,Primeira Liga,24.8,79,46,28,40,11,39,78,50.0,39,44,6,38,25,104,16,2
Marcelo Carné,BRA,GK,33,Estoril,Primeira Liga,22.0,1,1,1,0,0,1,2,50.0,1,0,0,0,0,1,8,4
João Marques,POR,"MF,FW",21,Estoril,Primeira Liga,21.9,39,25,5,26,8,11,29,37.9,18,20,2,18,11,50,13,0
Pedro Álvaro,POR,DF,23,Estoril,Primeira Liga,19.9,11,7,11,0,0,7,12,58.3,5,21,15,6,23,34,96,0
Cassiano,BRA,FW,34,Estoril,Primeira Liga,17.9,31,20,10,13,8,13,30,43.3,17,16,2,14,0,31,11,0
Volnei Feltes,BRA,DF,23,Estoril,Primeira Liga,16.4,19,15,10,9,0,8,24,33.3,16,21,14,7,21,40,55,2
Heriberto Tavares,POR,"FW,MF",26,Estoril,Primeira Liga,13.9,14,9,7,5,2,4,18,22.2,14,6,0,6,4,18,5,2
Jordan Holsgrove,SCO,MF,23,Estoril,Primeira Liga,13.0,30,25,9,18,3,14,24,58.3,10,11,7,4,15,45,19,2
Alejandro Marqués,VEN,FW,22,Estoril,Primeira Liga,15.1,10,7,1,8,1,2,9,22.2,7,14,4,10,3,13,15,0
João Othavio Basso,BRA,DF,26,Estoril,Primeira Liga,13.4,26,18,17,7,2,14,25,56.0,11,16,9,7,16,42,53,0
Vinícius Zanocelo,BRA,MF,22,Estoril,Primeira Liga,12.4,18,9,9,8,1,8,21,38.1,13,7,2,5,10,28,25,0
Daniel Leite,POR,GK,25,Estoril,Primeira Liga,12.0,3,2,3,0,0,3,3,100.0,0,0,0,0,0,3,9,0
Eliaquim Mangala,FRA,DF,32,Estoril,Primeira Liga,11.6,15,7,9,5,1,8,11,72.7,3,11,9,2,21,36,40,1
Wagner Pina,CPV,"MF,DF",20,Estoril,Primeira Liga,12.2,34,24,22,10,2,23,29,79.3,6,24,5,19,8,42,29,0
Raúl Parra,ESP,DF,23,Estoril,Primeira Liga,6.3,8,5,6,2,0,4,9,44.4,5,3,2,1,2,10,9,0
Koba Koindredi,FRA,MF,21,Estoril,Primeira Liga,6.3,14,5,11,2,1,7,14,50.0,7,5,1,4,11,25,6,0
Erick Cabaco,URU,DF,28,Estoril,Primeira Liga,3.7,5,4,3,2,0,1,3,33.3,2,4,3,1,7,12,16,0
Fabrício Garcia,CPV,"FW,MF",22,Estoril,Primeira Liga,3.7,13,10,6,4,3,7,10,70.0,3,5,0,5,1,14,3,0
Michel Costa,BRA,MF,21,Estoril,Primeira Liga,3.3,10,4,5,3,2,6,10,60.0,4,4,0,4,2,12,6,0
Mor Ndiaye,SEN,MF,22,Estoril,Primeira Liga,2.8,5,3,3,1,1,5,7,71.4,2,2,0,2,1,6,6,0
Ivan Pavlic,BEL,MF,21,Estoril,Primeira Liga,2.0,4,2,3,1,0,4,6,66.7,2,1,0,1,1,5,2,0
Alexandre Miguel Barros Soares,POR,MF,32,Estoril,Primeira Liga,2.8,9,4,2,6,1,4,6,66.7,2,2,1,1,3,12,3,0
João Carlos,BRA,"FW,DF",28,Estoril,Primeira Liga,3.5,2,1,1,1,0,0,2,0.0,2,4,0,4,1,3,2,0
Frederik Winther,DEN,DF,22,Estoril,Primeira Liga,1.3,0,0,0,0,0,0,1,0.0,1,0,0,0,0,0,9,1
Nemanja Jović,SRB,MF,20,Estoril,Primeira Liga,0.2,0,0,0,0,0,0,1,0.0,1,0,0,0,0,0,0,0
Harouna Sy,FRA,FW,27,Estoril,Primeira Liga,0.1,0,0,0,0,0,0,0,0.0,0,0,0,0,0,0,1,0
Rodrigo Martins,POR,"DF,FW",24,Estoril,Primeira Liga,0.1,0,0,0,0,0,0,0,0.0,0,0,0,0,1,1,0,0
Leo Cordeiro,BRA,MF,27,Estrela,Primeira Liga,29.0,60,40,23,30,7,32,64,50.0,32,36,8,28,19,79,19,0
Léo Jabá,BRA,"FW,MF",24,Estrela,Primeira Liga,24.7,35,23,12,14,9,11,23,47.8,12,23,2,21,12,47,17,0
Gaspar,ANG,DF,25,Estrela,Primeira Liga,26.1,53,36,29,20,4,32,41,78.0,9,35,19,16,40,93,146,2
Bruno Brigido,BRA,GK,32,Estrela,Primeira Liga,26.0,2,2,2,0,0,2,4,50.0,2,1,0,1,0,2,18,0
Hevertton Santos,BRA,"DF,MF",22,Estrela,Primeira Liga,21.9,25,18,12,10,3,18,29,62.1,11,27,7,20,20,45,53,0
Aloísio Souza Genézio,BRA,MF,27,Estrela,Primeira Liga,16.6,44,30,13,27,4,19,46,41.3,27,16,4,12,24,68,20,0
Miguel Lopes,POR,DF,36,Estrela,Primeira Liga,14.7,34,24,18,16,0,22,30,73.3,8,21,13,8,18,52,45,1
João Reis,POR,"DF,MF",31,Estrela,Primeira Liga,16.1,40,24,24,13,3,25,51,49.0,26,27,2,25,24,64,45,0
Ronald,BRA,"MF,FW",22,Estrela,Primeira Liga,14.7,14,8,3,7,4,7,18,38.9,11,13,0,13,4,18,6,0
Kikas,POR,"FW,MF",24,Estrela,Primeira Liga,17.3,3,3,0,2,1,1,2,50.0,1,2,0,2,1,4,13,0
Mansur,BRA,DF,30,Estrela,Primeira Liga,15.6,27,19,23,4,0,14,18,77.8,4,17,10,7,13,40,43,1
André Inácio,BRA,"FW,MF",21,Estrela,Primeira Liga,13.3,19,10,6,9,4,9,24,37.5,15,22,1,21,4,23,9,0
Ronaldo Tavares,POR,FW,26,Estrela,Primeira Liga,12.8,9,4,2,4,3,2,4,50.0,2,10,1,9,2,11,15,0
Joneston Omurwa,KEN,DF,24,Estrela,Primeira Liga,12.7,20,12,13,6,1,12,20,60.0,8,20,12,8,21,41,47,1
Rúben Lima,POR,"DF,MF",33,Estrela,Primeira Liga,10.3,14,8,7,6,1,4,11,36.4,7,12,1,11,8,22,36,0
Pedro Mendes,POR,DF,32,Estrela,Primeira Liga,9.0,13,9,10,2,1,7,12,58.3,5,14,10,4,15,28,42,1
Jean Felipe,BRA,"MF,DF",29,Estrela,Primeira Liga,12.8,24,18,9,13,2,18,30,60.0,12,11,1,10,10,34,21,0
Régis N’Do,BFA,"FW,MF",22,Estrela,Primeira Liga,11.0,16,9,5,8,3,10,25,40.0,15,15,2,13,3,19,4,0
Leonel Bucca,ARG,"MF,FW",24,Estrela,Primeira Liga,9.1,36,23,15,14,7,21,39,53.8,18,11,2,9,4,40,5,0
Vitó Ferreira,POR,MF,25,Estrela,Primeira Liga,6.4,12,7,5,7,0,7,24,29.2,17,6,0,6,4,16,9,0
Eulânio Ângelo Chipela Gomes,GNB,MF,29,Estrela,Primeira Liga,6.5,8,5,1,2,5,2,4,50.0,2,10,1,9,5,13,6,0
Nilton Varela,POR,"DF,MF",22,Estrela,Primeira Liga,6.2,20,15,15,5,0,16,22,72.7,6,5,1,4,4,24,9,0
Nkanyiso Shinga,RSA,"DF,MF",23,Estrela,Primeira Liga,5.7,12,11,4,5,3,10,12,83.3,2,12,7,5,7,19,20,1
Pedro Sá,POR,MF,29,Estrela,Primeira Liga,7.2,9,4,4,5,0,3,10,30.0,7,4,2,2,6,15,7,0
Almeida,BRA,DF,23,Estrela,Primeira Liga,5.4,6,5,3,3,0,3,7,42.9,4,6,4,2,3,9,19,0
Diogo Fonseca,POR,DF,21,Estrela,Primeira Liga,4.8,6,4,3,3,0,2,3,66.7,1,3,1,2,4,10,15,0
Wagner Santos,BRA,GK,25,Estrela,Primeira Liga,4.7,0,0,0,0,0,0,0,0.0,0,1,0,1,0,0,5,0
Rodrigo Pinho,BRA,FW,32,Estrela,Primeira Liga,3.5,2,2,1,1,0,0,1,0.0,1,2,0,2,1,3,1,0
António Filipe de Carvalho,POR,GK,38,Estrela,Primeira Liga,3.0,0,0,0,0,0,0,0,0.0,0,0,0,0,0,0,1,0
Gustavo Henrique,BRA,"DF,MF",24,Estrela,Primeira Liga,1.4,2,2,2,0,0,2,3,66.7,1,2,0,2,0,2,2,0
Alioune Ndour,SEN,"FW,MF",22,Estrela,Primeira Liga,1.9,4,3,0,2,2,0,1,0.0,1,0,0,0,0,4,2,0
Keliano,ANG,MF,20,Estrela,Primeira Liga,1.3,5,3,1,4,0,3,4,75.0,1,6,4,2,4,9,6,1
Tashan Oakley-Boothe,ENG,"MF,DF",23,Estrela,Primeira Liga,0.6,0,0,0,0,0,0,0,0.0,0,0,0,0,1,1,2,0
Cambila,ANG,GK,21,Estrela,Primeira Liga,0.2,0,0,0,0,0,0,0,0.0,0,0,0,0,0,0,1,1
João Gonçalves,POR,GK,22,Boavista,Primeira Liga,34.0,1,1,1,0,0,1,4,25.0,3,0,0,0,0,1,20,2
Salvador Agra,POR,"FW,DF",31,Boavista,Primeira Liga,27.3,21,9,14,5,2,9,31,29.0,22,8,1,7,16,37,19,0
Róbert Boženík,SVK,FW,23,Boavista,Primeira Liga,28.6,16,10,0,12,4,5,16,31.3,11,12,1,11,4,20,34,0
Rodrigo Abascal,URU,DF,29,Boavista,Primeira Liga,27.5,46,26,33,13,0,26,40,65.0,14,59,32,27,34,80,110,3
Sebastián Pérez Cardona,COL,MF,30,Boavista,Primeira Liga,24.3,74,39,41,30,3,39,68,57.4,29,30,8,22,22,96,26,1
Gaius Makouta,CGO,MF,26,Boavista,Primeira Liga,25.9,29,22,11,17,1,14,23,60.9,9,21,2,19,20,49,34,0
Miguel Reisinho,POR,MF,24,Boavista,Primeira Liga,23.3,48,30,14,29,5,22,48,45.8,26,22,8,14,21,69,37,2
Bruno Lourenço,POR,"FW,MF",25,Boavista,Primeira Liga,22.4,30,15,5,18,7,12,38,31.6,26,11,0,11,15,45,15,0
Pedro Malheiro,POR,"DF,MF",22,Boavista,Primeira Liga,21.9,58,33,34,21,3,36,57,63.2,21,27,8,19,24,82,48,1
Bruno Onyemaechi,NGA,"DF,MF",24,Boavista,Primeira Liga,21.9,50,37,26,20,4,21,36,58.3,15,28,6,22,24,74,57,0
Chidozie Awaziem,NGA,DF,26,Boavista,Primeira Liga,21.7,23,18,18,3,2,13,21,61.9,8,27,17,10,18,41,98,2
Filipe Ferreira,POR,DF,32,Boavista,Primeira Liga,19.2,31,22,16,15,0,19,26,73.1,7,21,8,13,18,49,47,1
Tiago Fonseca Morais,POR,"FW,MF",19,Boavista,Primeira Liga,15.3,23,17,14,6,3,12,38,31.6,26,21,1,20,10,33,7,0
Vincent Sasso,FRA,DF,32,Boavista,Primeira Liga,14.2,23,10,13,9,1,13,23,56.5,10,20,13,7,14,37,69,3
Ilija Vukotić,MNE,MF,24,Boavista,Primeira Liga,11.1,22,16,8,10,4,13,25,52.0,12,7,4,3,3,25,27,0
Luís Santos,POR,"DF,FW",23,Boavista,Primeira Liga,7.6,17,9,13,3,1,10,16,62.5,6,8,3,5,11,28,23,0
Martim Tavares,POR,"FW,MF",19,Boavista,Primeira Liga,6.0,4,3,1,3,0,1,4,25.0,3,6,3,3,2,6,4,0
Ibrahima Camará,GUI,"MF,DF",24,Boavista,Primeira Liga,5.3,4,4,2,1,1,3,6,50.0,3,4,1,3,4,8,18,0
Masaki Watai,JPN,"FW,MF",24,Boavista,Primeira Liga,4.8,8,4,4,2,2,2,10,20.0,8,4,0,4,5,13,2,0
Joel silva,POR,MF,20,Boavista,Primeira Liga,4.1,11,7,3,7,1,5,12,41.7,7,6,1,5,3,14,5,0
Berna,POR,"FW,DF",19,Boavista,Primeira Liga,3.6,15,11,8,5,2,5,10,50.0,5,5,2,3,5,20,4,0
Jeriel Córdova,VEN,FW,21,Boavista,Primeira Liga,1.7,0,0,0,0,0,0,2,0.0,2,1,0,1,0,0,1,0
Tiago Machado,POR,"MF,FW",19,Boavista,Primeira Liga,0.2,0,0,0,0,0,0,0,0.0,0,0,0,0,0,0,0,0
Carlinhos,BRA,MF,29,Portimonense,Primeira Liga,31.6,44,27,14,24,6,23,44,52.3,21,12,2,10,8,52,24,2
Filipe Relvas,POR,DF,23,Portimonense,Primeira Liga,31.1,56,32,43,13,0,28,46,60.9,18,48,25,23,58,114,140,1
Hélio Varela,CPV,"FW,MF",21,Portimonense,Primeira Liga,30.5,35,22,19,10,6,14,39,35.9,25,29,4,25,15,50,31,0
Pedrão,BRA,DF,26,Portimonense,Primeira Liga,29.3,48,29,34,12,2,22,38,57.9,16,32,17,15,50,98,136,0
Alemão,BRA,DF,20,Portimonense,Primeira Liga,26.3,49,34,39,10,0,27,39,69.2,12,49,33,16,30,79,137,1
Dener,BRA,MF,31,Portimonense,Primeira Liga,19.6,51,31,26,21,4,22,47,46.8,25,16,4,12,26,77,43,0
Nonoca,BRA,MF,25,Portimonense,Primeira Liga,21.3,82,54,34,41,7,35,49,71.4,14,30,11,19,20,102,30,1
Kosuke Nakamura,JPN,GK,28,Portimonense,Primeira Liga,20.0,0,0,0,0,0,0,1,0.0,1,0,0,0,0,0,17,1
Sylvester Jasper,BUL,"FW,MF",21,Portimonense,Primeira Liga,18.6,22,12,9,8,5,10,21,47.6,11,17,0,17,15,37,16,0
Gonçalo Costa,POR,"DF,MF",23,Portimonense,Primeira Liga,19.0,59,38,32,22,5,33,48,68.8,15,27,3,24,27,86,46,1
Guga,POR,"DF,MF",19,Portimonense,Primeira Liga,17.0,56,34,31,20,5,30,60,50.0,30,18,7,11,16,72,29,0
Igor Marques,BRA,"DF,MF",24,Portimonense,Primeira Liga,16.5,55,34,25,24,6,23,50,46.0,27,35,5,30,41,96,45,1
Vinicius Silvestre,BRA,GK,29,Portimonense,Primeira Liga,14.0,0,0,0,0,0,0,3,0.0,3,0,0,0,0,0,10,1
Ronie Carrillo,ECU,"FW,MF",26,Portimonense,Primeira Liga,14.6,9,4,1,5,3,2,7,28.6,5,13,1,12,3,12,19,0
Moustapha Seck,SEN,"DF,MF",27,Portimonense,Primeira Liga,9.8,29,19,17,9,3,15,19,78.9,4,17,6,11,11,40,28,0
Hildeberto Pereira,POR,FW,27,Portimonense,Primeira Liga,9.4,2,2,2,0,0,0,12,0.0,12,10,1,9,2,4,3,0
Taichi Fukui,JPN,MF,19,Portimonense,Primeira Liga,6.6,8,5,0,3,5,2,11,18.2,9,4,0,4,5,13,8,0
Maurício,BRA,MF,34,Portimonense,Primeira Liga,5.0,11,8,3,8,0,8,14,57.1,6,7,3,4,9,20,11,1
Rildo,BRA,"FW,MF",23,Portimonense,Primeira Liga,5.7,5,3,0,5,0,1,3,33.3,2,9,0,9,1,6,3,0
Luan Campos,BRA,"FW,MF",21,Portimonense,Primeira Liga,5.2,7,5,2,4,1,4,8,50.0,4,4,1,3,5,12,6,0
Paulo Estrela Moreira,POR,"MF,FW",24,Portimonense,Primeira Liga,5.9,14,7,6,7,1,4,15,26.7,11,11,1,10,7,21,10,0
Tamble,POR,FW,22,Portimonense,Primeira Liga,4.0,0,0,0,0,0,0,2,0.0,2,3,3,0,1,1,3,0
Midana Cassama,GNB,"FW,MF",20,Portimonense,Primeira Liga,3.2,4,3,1,2,1,2,3,66.7,1,2,1,1,2,6,2,0
Rodrigo Martins,POR,FW,24,Portimonense,Primeira Liga,2.6,4,3,2,1,1,2,6,33.3,4,1,0,1,0,4,6,0
Rafael Alcobia,POR,DF,20,Portimonense,Primeira Liga,2.3,3,3,2,1,0,1,1,100.0,0,4,1,3,1,4,4,0
Paulinho,POR,"FW,MF",23,Portimonense,Primeira Liga,1.9,0,0,0,0,0,0,0,0.0,0,0,0,0,0,0,3,0
Steve Mvoué,CMR,MF,21,Portimonense,Primeira Liga,0.8,4,1,0,4,0,1,2,50.0,1,1,0,1,0,4,0,0
Zinho,BRA,"FW,MF",20,Portimonense,Primeira Liga,1.6,4,3,1,1,2,3,4,75.0,1,2,0,2,1,5,1,0
Jose Souza,POR,MF,22,Portimonense,Primeira Liga,0.1,0,0,0,0,0,0,1,0.0,1,1,0,1,0,0,0,0
Dennis Adeniran,ENG,MF,24,Portimonense,Primeira Liga,0.1,0,0,0,0,0,0,0,0.0,0,0,0,0,2,2,0,0
Davis Nascimento,BRA,MF,20,Portimonense,Primeira Liga,0.0,0,0,0,0,0,0,1,0.0,1,0,0,0,0,0,0,0
Samu,POR,MF,27,Vizela,Primeira Liga,30.7,70,37,32,27,11,34,78,43.6,44,54,12,42,20,90,48,0
Samuel Essende,RDC,FW,25,Vizela,Primeira Liga,29.6,9,7,1,5,3,4,9,44.4,5,21,8,13,3,12,17,0
Tomás Costa Silva,POR,DF,23,Vizela,Primeira Liga,29.1,74,50,42,24,8,45,79,57.0,34,33,8,25,41,115,102,1
Fabijan Buntić,CRO,GK,26,Vizela,Primeira Liga,27.7,0,0,0,0,0,0,0,0.0,0,1,0,1,0,0,18,0
Anderson Jesus,BRA,DF,28,Vizela,Primeira Liga,27.7,33,26,29,4,0,19,35,54.3,16,36,28,8,23,56,124,3
Diogo Nascimento,POR,MF,20,Vizela,Primeira Liga,24.0,29,19,9,17,3,14,32,43.8,18,17,2,15,10,39,24,0
Matheus Pereira,BRA,"DF,FW",22,Vizela,Primeira Liga,23.3,26,16,12,11,3,11,23,47.8,12,29,6,23,20,46,38,0
Matías Lacava,VEN,"FW,MF",20,Vizela,Primeira Liga,14.8,33,19,18,8,7,14,30,46.7,16,15,0,15,6,39,3,0
Jota Gonçalves,POR,DF,23,Vizela,Primeira Liga,16.1,17,8,11,5,1,9,22,40.9,13,18,11,7,21,38,97,1
Orest Lebedenko,UKR,DF,24,Vizela,Primeira Liga,16.1,35,20,18,16,1,18,29,62.1,11,24,7,17,23,58,58,0
Bruno Wilson,POR,DF,26,Vizela,Primeira Liga,15.6,15,8,9,5,1,11,14,78.6,3,20,14,6,19,34,62,0
João Escoval,POR,DF,26,Vizela,Primeira Liga,15.2,25,10,20,4,1,10,17,58.8,7,14,9,5,14,39,55,1
Nuno Gonçalo Moreira,POR,"FW,MF",24,Vizela,Primeira Liga,10.7,14,9,6,7,1,4,14,28.6,10,14,2,12,10,24,8,1
Pedro Ortiz,ESP,MF,22,Vizela,Primeira Liga,10.2,27,15,10,14,3,15,26,57.7,11,9,4,5,7,34,21,0
Domingos Quina,POR,"FW,MF",23,Vizela,Primeira Liga,8.1,18,9,1,14,3,4,12,33.3,8,11,0,11,4,22,5,0
Alberto Soro,ESP,"FW,MF",24,Vizela,Primeira Liga,10.0,21,13,9,8,4,6,16,37.5,10,10,0,10,1,22,8,0
Jason Lokilo,BEL,"FW,MF",24,Vizela,Primeira Liga,7.8,4,3,2,2,0,2,6,33.3,4,3,0,3,0,4,7,0
Aleksandar Busnić,SRB,"MF,FW",25,Vizela,Primeira Liga,8.5,21,12,10,9,2,10,20,50.0,10,13,4,9,6,27,23,0
Rafael Bustamante,COL,MF,23,Vizela,Primeira Liga,7.9,16,9,10,5,1,7,25,28.0,18,17,3,14,12,28,7,0
Bruno Xavier Almeida Costa,POR,MF,26,Vizela,Primeira Liga,6.8,3,1,1,1,1,2,9,22.2,7,4,1,3,10,13,5,0
Francesco Ruberto,SUI,GK,30,Vizela,Primeira Liga,6.3,0,0,0,0,0,0,2,0.0,2,0,0,0,0,0,3,1
Sava Petrov,SRB,"FW,MF",25,Vizela,Primeira Liga,5.7,0,0,0,0,0,0,3,0.0,3,5,2,3,0,0,8,0
Hugo Oliveira,POR,"DF,MF",21,Vizela,Primeira Liga,5.5,8,6,5,2,1,5,8,62.5,3,5,3,2,8,16,15,0
Alexis Méndez,USA,"MF,FW",22,Vizela,Primeira Liga,4.1,6,5,1,4,1,3,4,75.0,1,2,0,2,2,8,1,0
Kiko Bondoso,POR,"FW,MF",27,Vizela,Primeira Liga,2.1,5,3,1,2,2,4,6,66.7,2,2,0,2,1,6,2,0
Abdul Awudu,GHA,"FW,MF",22,Vizela,Primeira Liga,2.1,4,3,1,1,2,2,7,28.6,5,2,1,1,0,4,1,0
Jardel,GNB,"FW,MF",25,Vizela,Primeira Liga,2.1,2,1,1,1,0,1,2,50.0,1,0,0,0,2,4,2,0
Dylan Saint-Louis,CGO,"FW,MF",28,Vizela,Primeira Liga,2.9,5,2,3,1,1,3,6,50.0,3,3,1,2,1,6,2,0
Amadou Ba-Sy,FRA,"FW,MF",22,Vizela,Primeira Liga,1.3,1,1,0,1,0,0,1,0.0,1,2,1,1,1,2,0,0
Osama Rashid,IRQ,"MF,FW",31,Vizela,Primeira Liga,0.3,0,0,0,0,0,0,1,0.0,1,0,0,0,1,1,2,0
Iker Unzueta,ESP,FW,24,Vizela,Primeira Liga,0.3,0,0,0,0,0,0,0,0.0,0,0,0,0,0,0,0,0
Héctor,ESP,FW,27,Chaves,Primeira Liga,28.8,11,8,3,5,3,5,17,29.4,12,14,3,11,5,16,18,0
Hugo Souza,BRA,GK,24,Chaves,Primeira Liga,26.0,0,0,0,0,0,0,1,0.0,1,0,0,0,0,0,16,2
Kelechi Nwakali,NGA,MF,25,Chaves,Primeira Liga,23.0,38,29,7,27,4,20,38,52.6,18,20,2,18,19,57,12,0
João Pedro Araújo Correia,CPV,"DF,MF",26,Chaves,Primeira Liga,23.3,19,12,10,7,2,12,41,29.3,29,21,8,13,31,50,44,1
Ygor Nogueira,BRA,DF,28,Chaves,Primeira Liga,18.4,37,25,32,5,0,24,33,72.7,9,22,15,7,27,64,101,0
Sandro Cruz,POR,"DF,MF",22,Chaves,Primeira Liga,18.1,34,23,23,10,1,22,35,62.9,13,23,8,15,20,54,70,2
Rúben Tiago Rodrigues Ribeiro,POR,"FW,MF",35,Chaves,Primeira Liga,18.7,23,14,14,7,2,12,20,60.0,8,12,0,12,12,35,11,0
Vasco Fernandes,POR,DF,36,Chaves,Primeira Liga,16.8,26,14,18,7,1,17,25,68.0,8,17,9,8,9,35,68,1
Bruno Rodrigues,POR,DF,22,Chaves,Primeira Liga,15.0,14,8,11,1,2,9,13,69.2,4,15,3,12,18,32,47,0
Raphael Guzzo,POR,"MF,FW",28,Chaves,Primeira Liga,13.2,13,7,7,3,3,2,11,18.2,9,17,6,11,11,24,13,0
Steven Vitória,CAN,DF,36,Chaves,Primeira Liga,15.0,11,8,8,3,0,8,9,88.9,1,17,14,3,4,15,75,3
Ricardo Guimarães,MOZ,MF,27,Chaves,Primeira Liga,13.9,35,19,20,11,4,18,37,48.6,19,16,5,11,18,53,15,1
Junior Pius,NGA,DF,27,Chaves,Primeira Liga,12.8,45,33,31,12,2,28,42,66.7,14,23,7,16,18,63,53,0
Leandro Sanca,GNB,"FW,MF",23,Chaves,Primeira Liga,16.3,17,5,5,9,3,6,29,20.7,23,25,1,24,9,26,8,0
Dario Essugo,POR,MF,18,Chaves,Primeira Liga,12.9,29,19,15,11,3,16,25,64.0,9,21,3,18,21,50,32,0
Bruno Langa,MOZ,"DF,MF",25,Chaves,Primeira Liga,11.9,22,14,8,12,2,8,18,44.4,10,9,2,7,18,40,27,1
Carraça,POR,"DF,MF",30,Chaves,Primeira Liga,11.1,9,5,3,6,0,6,11,54.5,5,7,0,7,7,16,23,0
Benny,POR,"MF,FW",23,Chaves,Primeira Liga,14.1,10,3,4,4,2,3,14,21.4,11,18,0,18,6,16,17,0
Jo,BRA,"FW,MF",28,Chaves,Primeira Liga,11.3,10,6,1,5,4,4,11,36.4,7,6,1,5,1,11,13,0
Paulo Victor,BRA,"FW,MF",22,Chaves,Primeira Liga,9.1,14,8,4,10,0,5,9,55.6,4,15,2,13,6,20,5,0
Rodrigo Nascimento,BRA,GK,27,Chaves,Primeira Liga,7.0,3,0,3,0,0,3,3,100.0,0,0,0,0,0,3,3,0
Thibang Phete,RSA,"DF,MF",29,Chaves,Primeira Liga,4.9,5,3,2,2,1,3,5,60.0,2,5,3,2,8,13,18,0
Hélder Morim,POR,"MF,DF",22,Chaves,Primeira Liga,7.3,19,8,8,8,3,7,24,29.2,17,18,7,11,8,27,5,0
João Pedro,POR,MF,30,Chaves,Primeira Liga,4.5,7,4,3,3,1,7,15,46.7,8,3,2,1,3,10,5,0
Habib sylla,CIV,DF,24,Chaves,Primeira Liga,4.5,6,2,3,2,1,2,3,66.7,1,9,2,7,1,7,16,0
Rúben Lameiras,POR,"FW,MF",28,Chaves,Primeira Liga,2.3,2,1,0,2,0,0,0,0.0,0,1,0,1,1,3,2,0
Abass Issah,GHA,"MF,FW",24,Chaves,Primeira Liga,3.4,1,0,0,0,1,1,4,25.0,3,2,0,2,0,1,0,0
João Queirós,POR,DF,25,Chaves,Primeira Liga,2.6,4,2,3,1,0,3,4,75.0,1,2,1,1,4,8,6,1
Pedro Pinho,POR,MF,23,Chaves,Primeira Liga,2.8,9,2,4,3,2,3,7,42.9,4,6,4,2,9,18,7,0
Gonçalo Filipe,POR,GK,23,Chaves,Primeira Liga,1.0,0,0,0,0,0,0,0,0.0,0,0,0,0,0,0,0,0
Rodrigo Melro,POR,DF,19,Chaves,Primeira Liga,0.0,0,0,0,0,0,0,1,0.0,1,0,0,0,0,0,0,0
Franco Armani,ARG,GK,36,River Plate,Primera Division,26.0,2,2,2,0,0,2,2,100.0,0,0,0,0,0,2,5,0
Ignacio Fernández,ARG,"MF,FW",33,River Plate,Primera Division,19.8,38,23,14,19,5,16,47,34.0,31,29,2,27,10,48,11,1
Milton Casco,ARG,DF,34,River Plate,Primera Division,19.7,37,22,17,18,2,24,39,61.5,15,19,10,9,14,51,31,0
Enzo Díaz,ARG,DF,27,River Plate,Primera Division,20.8,61,36,36,24,1,32,47,68.1,15,27,5,22,21,82,46,0
Leandro González Pirez,ARG,DF,30,River Plate,Primera Division,19.6,38,31,27,11,0,23,34,67.6,11,23,17,6,41,79,99,0
Rodrigo Aliendro,ARG,MF,31,River Plate,Primera Division,18.0,46,36,11,31,4,22,63,34.9,41,35,5,30,17,63,16,1
Enzo Pérez,ARG,MF,36,River Plate,Primera Division,17.0,37,26,19,17,1,18,37,48.6,19,23,4,19,28,65,19,0
Ezequiel Barco,ARG,"FW,MF",23,River Plate,Primera Division,16.7,8,6,2,3,3,5,23,21.7,18,18,2,16,4,12,3,0
Lucas Beltrán,ARG,FW,21,River Plate,Primera Division,15.2,17,13,1,10,6,4,16,25.0,12,21,2,19,4,21,5,0
Nicolás De La Cruz,URU,"MF,FW",25,River Plate,Primera Division,12.2,28,18,4,17,7,14,28,50.0,14,8,0,8,5,33,6,0
Pablo Solari,ARG,"FW,MF",21,River Plate,Primera Division,13.6,18,14,5,7,6,2,22,9.1,20,24,2,22,7,25,5,0
Paulo Díaz,CHI,DF,28,River Plate,Primera Division,12.7,18,10,13,5,0,12,20,60.0,8,12,8,4,19,37,59,0
José Paradela,ARG,"MF,FW",24,River Plate,Primera Division,11.4,19,12,5,10,4,8,28,28.6,20,20,3,17,8,27,1,0
Robert Rojas,PAR,DF,26,River Plate,Primera Division,9.7,13,8,7,5,1,8,13,61.5,5,10,5,5,4,17,41,0
Marcelo Herrera,ARG,DF,24,River Plate,Primera Division,9.3,23,16,13,9,1,10,22,45.5,12,8,2,6,17,40,21,0
Miguel Borja,COL,FW,30,River Plate,Primera Division,9.1,6,4,0,4,2,1,2,50.0,1,6,0,6,0,6,10,0
Salomón Rondón,VEN,FW,33,River Plate,Primera Division,8.7,6,4,2,2,2,2,5,40.0,3,11,0,11,0,6,11,0
Agustín Palavecino,ARG,"MF,FW",26,River Plate,Primera Division,8.7,27,19,9,13,5,13,30,43.3,17,9,1,8,5,32,10,0
Emanuel Mammana,ARG,DF,26,River Plate,Primera Division,6.0,8,5,5,2,1,4,5,80.0,1,6,5,1,10,18,31,0
Jonatan Maidana,ARG,DF,37,River Plate,Primera Division,5.1,2,1,1,1,0,1,2,50.0,1,7,4,3,5,7,22,0
Elías Gómez,ARG,"DF,FW",28,River Plate,Primera Division,4.8,11,8,6,4,1,9,17,52.9,8,5,0,5,6,17,10,0
Matías Kranevitter,ARG,MF,29,River Plate,Primera Division,4.1,7,5,1,6,0,4,11,36.4,7,2,0,2,1,8,9,0
Santiago Simón,ARG,"MF,FW",20,River Plate,Primera Division,3.1,4,3,0,3,1,1,6,16.7,5,7,1,6,3,7,3,0
Ezequiel Centurión,ARG,GK,25,River Plate,Primera Division,1.0,0,0,0,0,0,0,0,0.0,0,0,0,0,0,0,1,0
Matías Suárez,ARG,"FW,MF",34,River Plate,Primera Division,2.0,2,2,1,1,0,1,2,50.0,1,4,1,3,0,2,2,0
Franco Alfonso,ARG,"FW,MF",20,River Plate,Primera Division,0.9,2,1,0,1,1,1,2,50.0,1,3,0,3,0,2,0,0
Claudio Echeverri,ARG,"MF,DF",17,River Plate,Primera Division,0.8,3,2,2,1,0,1,2,50.0,1,3,0,3,0,3,1,0
Bruno Zuculini,ARG,MF,29,River Plate,Primera Division,0.2,0,0,0,0,0,0,1,0.0,1,0,0,0,0,0,0,0
Héctor David Martínez,PAR,DF,25,River Plate,Primera Division,0.1,0,0,0,0,0,0,0,0.0,0,0,0,0,0,0,0,0
Guido Herrera,ARG,GK,30,Talleres,Primera Division,27.0,2,1,2,0,0,2,3,66.7,1,0,0,0,1,3,11,0
Gastón Benavídez,ARG,DF,27,Talleres,Primera Division,26.0,63,45,39,19,5,36,69,52.2,33,34,7,27,26,89,67,0
Matías Catalán,CHI,DF,30,Talleres,Primera Division,25.2,23,17,15,7,1,10,16,62.5,6,22,9,13,27,50,118,0
Rodrigo Villagra,ARG,MF,21,Talleres,Primera Division,24.8,51,32,19,31,1,19,49,38.8,30,22,4,18,26,77,20,0
Rodrigo Garro,ARG,MF,25,Talleres,Primera Division,23.1,27,17,7,16,4,11,45,24.4,34,19,0,19,15,42,5,0
Michael Santos,URU,FW,29,Talleres,Primera Division,20.4,7,2,0,4,3,1,12,8.3,11,12,0,12,3,10,5,0
Ramón Sosa,PAR,FW,23,Talleres,Primera Division,16.7,10,6,3,6,1,4,15,26.7,11,17,1,16,5,15,4,0
Juan Portillo,ARG,DF,22,Talleres,Primera Division,15.8,40,25,21,19,0,24,36,66.7,12,24,4,20,16,56,47,0
Diego Valoyes,COL,FW,26,Talleres,Primera Division,17.9,33,24,13,18,2,10,28,35.7,18,29,5,24,10,43,23,0
Juan Rodríguez,ARG,DF,28,Talleres,Primera Division,15.6,31,21,19,10,2,14,27,51.9,13,28,17,11,21,52,86,0
Diego Ortegoza,ARG,MF,25,Talleres,Primera Division,8.8,23,16,8,13,2,9,29,31.0,20,13,3,10,6,29,14,0
Francisco Pizzini,ARG,FW,29,Talleres,Primera Division,12.9,30,21,11,14,5,16,41,39.0,25,22,4,18,12,42,17,0
Alan Franco,ECU,MF,24,Talleres,Primera Division,11.5,20,9,2,15,3,8,19,42.1,11,19,5,14,8,28,18,0
Lucas Suárez,ARG,DF,27,Talleres,Primera Division,11.0,24,17,20,4,0,19,24,79.2,5,11,4,7,17,41,50,0
Nicolás Pasquini,ARG,DF,32,Talleres,Primera Division,6.7,9,8,5,4,0,3,8,37.5,5,6,0,6,6,15,13,0
Valentín Depietri,ARG,"FW,MF",22,Talleres,Primera Division,5.8,8,4,3,4,1,4,17,23.5,13,4,0,4,2,10,0,0
Nahuel Bustos,ARG,"FW,MF",24,Talleres,Primera Division,8.1,2,2,0,2,0,1,4,25.0,3,4,1,3,0,2,0,0
Christian Oliva,URU,MF,26,Talleres,Primera Division,4.9,9,6,3,4,2,6,13,46.2,7,6,0,6,8,17,9,0
Tiago Palacios,ARG,DF,19,Talleres,Primera Division,1.9,2,1,2,0,0,1,3,33.3,2,2,1,1,2,4,9,0
Julio Buffarini,ARG,DF,34,Talleres,Primera Division,1.7,2,1,1,1,0,1,3,33.3,2,3,0,3,6,8,3,0
Maximiliano Álvez,ARG,FW,19,Talleres,Primera Division,2.0,3,1,2,1,0,0,2,0.0,2,1,1,0,0,3,2,0
Tomás Olmos,ARG,DF,18,Talleres,Primera Division,1.0,3,1,3,0,0,2,2,100.0,0,1,0,1,2,5,7,0
Angelo Martino,ARG,DF,24,Talleres,Primera Division,0.7,1,1,1,0,0,1,1,100.0,0,1,0,1,3,4,2,0
José Romero,ARG,"FW,MF",19,Talleres,Primera Division,1.9,1,0,0,0,1,1,2,50.0,1,2,0,2,0,1,2,0
Diego Barrera,ARG,FW,18,Talleres,Primera Division,1.4,6,4,2,3,1,3,5,60.0,2,5,0,5,1,7,1,0
Luis Sequeira,ARG,"MF,DF",20,Talleres,Primera Division,1.2,4,3,2,2,0,1,2,50.0,1,1,0,1,2,6,1,0
Fabio Álvarez,ARG,"MF,FW",30,Talleres,Primera Division,0.7,3,2,1,2,0,0,1,0.0,1,0,0,0,1,4,0,0
Vicente Fernández,CHI,"MF,FW",23,Talleres,Primera Division,0.5,1,1,0,1,0,1,1,100.0,0,1,0,1,1,2,1,0
David Zalazar,ARG,MF,20,Talleres,Primera Division,0.2,1,0,0,1,0,0,0,0.0,0,1,0,1,0,1,0,0
Federico Girotti,ARG,DF,23,Talleres,Primera Division,0.1,0,0,0,0,0,0,0,0.0,0,0,0,0,0,0,0,0
Matias Gomez,ARG,"MF,FW",17,Talleres,Primera Division,0.0,0,0,0,0,0,0,1,0.0,1,0,0,0,0,0,0,0
Malcom Braida,ARG,"DF,MF",25,San Lorenzo,Primera Division,24.4,68,54,33,26,9,46,75,61.3,29,47,2,45,24,92,43,1
Rafa Pérez,COL,DF,33,San Lorenzo,Primera Division,23.6,32,22,20,12,0,14,37,37.8,23,16,7,9,25,57,62,0
Jalil Elías,SYR,MF,26,San Lorenzo,Primera Division,23.2,33,20,14,17,2,18,41,43.9,23,30,10,20,20,53,36,1
Gastón Hernández,ARG,DF,25,San Lorenzo,Primera Division,22.6,53,30,30,22,1,33,52,63.5,19,28,12,16,45,98,69,0
Augusto Batalla,ARG,GK,26,San Lorenzo,Primera Division,22.0,1,1,1,0,0,0,0,0.0,0,0,0,0,0,1,4,0
Adam Bareiro,PAR,FW,26,San Lorenzo,Primera Division,19.5,24,14,2,16,6,9,29,31.0,20,13,0,13,2,26,20,0
Nahuel Barrios,ARG,"MF,FW",24,San Lorenzo,Primera Division,18.8,23,15,8,15,0,12,35,34.3,23,16,3,13,8,31,2,0
Federico Gattoni,ARG,DF,23,San Lorenzo,Primera Division,19.0,22,8,16,6,0,9,16,56.3,7,18,8,10,14,36,65,1
Carlos Sánchez,COL,"MF,DF",36,San Lorenzo,Primera Division,16.6,21,13,7,13,1,10,27,37.0,17,16,4,12,15,36,40,1
Andrés Vombergar,SVN,"FW,MF",28,San Lorenzo,Primera Division,15.2,29,19,10,14,5,10,28,35.7,18,23,3,20,3,32,15,0
Agustín Giay,ARG,"DF,MF",19,San Lorenzo,Primera Division,10.8,19,12,11,7,1,13,27,48.1,14,8,1,7,7,26,14,0
Gonzalo Luján,ARG,"DF,MF",21,San Lorenzo,Primera Division,13.8,26,18,16,7,3,15,33,45.5,18,16,8,8,16,42,44,0
Ivan Leguizamon,PAR,"MF,FW",20,San Lorenzo,Primera Division,15.2,16,8,5,8,3,4,24,16.7,20,14,1,13,8,24,5,0
Ezequiel Cerutti,ARG,"FW,MF",31,San Lorenzo,Primera Division,6.9,10,6,3,4,3,4,14,28.6,10,7,0,7,2,12,8,0
Agustín Martegani,ARG,MF,22,San Lorenzo,Primera Division,8.4,15,7,4,8,3,5,16,31.3,11,4,0,4,4,19,3,0
Gastón Campi,ARG,"DF,MF",31,San Lorenzo,Primera Division,7.5,14,7,13,1,0,8,13,61.5,5,5,3,2,17,31,20,0
Facundo Altamirano,ARG,GK,26,San Lorenzo,Primera Division,5.0,0,0,0,0,0,0,1,0.0,1,0,0,0,0,0,2,0
Francisco Perruzzi,ARG,MF,21,San Lorenzo,Primera Division,4.9,10,7,3,7,0,4,12,33.3,8,5,2,3,4,14,9,0
Gonzalo Maroni,ARG,"MF,FW",23,San Lorenzo,Primera Division,4.4,3,3,2,1,0,1,6,16.7,5,4,0,4,0,3,3,0
Nicolás Blandi,ARG,FW,33,San Lorenzo,Primera Division,3.0,2,1,0,2,0,0,2,0.0,2,3,1,2,0,2,2,0
Elian Irala,ARG,"MF,DF",18,San Lorenzo,Primera Division,3.1,16,11,7,6,3,10,19,52.6,9,4,0,4,11,27,4,0
Diego Calcaterra,ARG,DF,21,San Lorenzo,Primera Division,2.0,4,4,4,0,0,1,2,50.0,1,3,3,0,1,5,13,0
Diego Perea,COL,"MF,FW",20,San Lorenzo,Primera Division,1.7,3,1,1,1,1,2,5,40.0,3,1,0,1,2,5,3,0
Ezequiel Herrera,ARG,DF,20,San Lorenzo,Primera Division,1.5,1,1,0,1,0,0,4,0.0,4,2,0,2,1,2,6,0
Tomás Silva,ARG,DF,19,San Lorenzo,Primera Division,0.9,0,0,0,0,0,0,2,0.0,2,0,0,0,3,3,3,0
Siro Rosane,ARG,MF,22,San Lorenzo,Primera Division,0.6,1,1,1,0,0,0,0,0.0,0,0,0,0,0,1,2,0
Mariano Peralta,ARG,FW,24,San Lorenzo,Primera Division,0.2,1,1,1,0,0,0,0,0.0,0,0,0,0,1,2,0,0
Manuel Insaurralde,ARG,"MF,DF",24,San Lorenzo,Primera Division,0.2,2,2,1,1,0,1,3,33.3,2,0,0,0,0,2,0,0
Matías Hernández,ARG,DF,17,San Lorenzo,Primera Division,0.0,0,0,0,0,0,0,0,0.0,0,0,0,0,0,0,0,0
Cristian Lema,ARG,DF,32,Lanús,Primera Division,22.7,28,19,14,12,2,19,32,59.4,13,32,14,18,21,49,131,0
Leandro Díaz,ARG,FW,30,Lanús,Primera Division,22.8,9,8,1,6,2,5,16,31.3,11,7,2,5,6,15,9,0
Pedro De la Vega,ARG,FW,21,Lanús,Primera Division,21.7,35,17,13,15,7,13,39,33.3,26,20,3,17,11,46,29,0
Tomás Belmonte,ARG,MF,24,Lanús,Primera Division,21.0,46,24,18,25,3,21,50,42.0,29,33,10,23,39,85,66,0
Juan Cáceres,PAR,DF,22,Lanús,Primera Division,20.0,77,52,39,31,7,41,67,61.2,26,31,4,27,31,108,63,0
Lucas Acosta,ARG,GK,27,Lanús,Primera Division,18.0,0,0,0,0,0,0,0,0.0,0,0,0,0,1,1,3,4
Luciano Boggio,ITA,MF,23,Lanús,Primera Division,16.0,24,15,6,16,2,12,46,26.1,34,21,3,18,16,40,15,0
Matías Esquivel,ARG,"MF,FW",23,Lanús,Primera Division,14.2,39,26,10,14,15,22,57,38.6,35,25,2,23,18,57,5,0
Braian Aguirre,ARG,DF,22,Lanús,Primera Division,14.2,41,28,30,8,3,17,38,44.7,21,15,4,11,15,56,46,0
Juan Sánchez Miño,ARG,DF,33,Lanús,Primera Division,13.0,33,17,24,7,2,20,38,52.6,18,25,4,21,8,41,25,0
Franco Orozco,ARG,FW,21,Lanús,Primera Division,12.5,12,6,4,6,2,4,25,16.0,21,16,1,15,2,14,2,0
Jose Domínguez,PAR,DF,26,Lanús,Primera Division,12.7,14,11,12,2,0,8,10,80.0,2,9,7,2,5,19,50,0
Raúl Loaiza,COL,MF,28,Lanús,Primera Division,11.8,21,9,6,14,1,8,19,42.1,11,13,1,12,14,35,11,0
Franco Troyansky,ARG,FW,25,Lanús,Primera Division,11.3,15,9,5,8,2,5,15,33.3,10,10,0,10,8,23,8,0
Felipe Aguilar,COL,DF,30,Lanús,Primera Division,13.1,6,5,4,2,0,4,14,28.6,10,10,7,3,14,20,76,1
Lautaro Acosta,ARG,MF,34,Lanús,Primera Division,10.4,17,13,6,9,2,7,27,25.9,20,12,3,9,8,25,10,0
Julián Fernández,ARG,MF,27,Lanús,Primera Division,11.4,26,16,11,14,1,15,44,34.1,29,20,5,15,22,48,29,0
Lautaro Morales,ARG,GK,23,Lanús,Primera Division,8.9,0,0,0,0,0,0,0,0.0,0,0,0,0,0,0,2,1
Diego Braghieri,ARG,DF,35,Lanús,Primera Division,5.1,5,3,4,1,0,2,3,66.7,1,9,6,3,4,9,36,0
Facundo Pérez,ARG,"MF,FW",23,Lanús,Primera Division,2.7,7,3,6,0,1,1,4,25.0,3,3,0,3,5,12,4,1
Julio Soler,ARG,DF,17,Lanús,Primera Division,2.3,4,2,4,0,0,2,3,66.7,1,3,1,2,2,6,7,0
Leonel Di Plácido,ARG,DF,29,Lanús,Primera Division,1.7,6,5,3,1,2,3,9,33.3,6,2,0,2,7,13,5,0
José Sand,ARG,"FW,MF",42,Lanús,Primera Division,2.7,1,1,0,0,1,0,1,0.0,1,0,0,0,0,1,3,0
Julián Aude,ARG,DF,19,Lanús,Primera Division,1.6,3,2,0,2,1,1,3,33.3,2,5,0,5,1,4,5,0
Pablo Aranda,ARG,DF,21,Lanús,Primera Division,1.0,2,1,1,0,1,2,5,40.0,3,2,0,2,2,4,0,0
Brian Blando,ARG,FW,27,Lanús,Primera Division,0.7,4,3,2,1,1,2,2,100.0,0,2,1,1,0,4,1,0
Brian Aguilar,ARG,DF,19,Lanús,Primera Division,0.6,0,0,0,0,0,0,1,0.0,1,1,0,1,0,0,5,0
Mateo Sanabria,ARG,FW,18,Lanús,Primera Division,0.2,1,1,0,1,0,1,1,100.0,0,0,0,0,0,1,0,0
Dylan Aquino,ARG,"FW,MF",17,Lanús,Primera Division,0.1,2,1,0,2,0,1,1,100.0,0,1,0,1,1,3,0,0
David González,ARG,MF,18,Lanús,Primera Division,0.0,0,0,0,0,0,0,0,0.0,0,0,0,0,0,0,0,0
Jorge Agustín Rodríguez,ARG,"MF,DF",27,Estudiantes,Primera Division,25.8,69,39,24,43,2,30,60,50.0,30,35,10,25,27,96,71,2
Benjamín Rollheiser,ARG,"MF,FW",22,Estudiantes,Primera Division,22.5,28,16,11,11,6,13,36,36.1,23,18,1,17,7,35,7,1
Mariano Andújar,ARG,GK,39,Estudiantes,Primera Division,25.0,1,1,1,0,0,1,2,50.0,1,0,0,0,2,3,2,0
Santiago Ascacíbar,ARG,MF,25,Estudiantes,Primera Division,24.3,71,42,27,36,8,32,92,34.8,60,47,5,42,35,106,24,0
Luciano Lollo,ARG,DF,35,Estudiantes,Primera Division,22.9,41,29,28,12,1,20,26,76.9,6,23,15,8,21,62,124,0
Zaid Romero,ARG,DF,23,Estudiantes,Primera Division,21.2,28,20,16,10,2,18,24,75.0,6,23,14,9,31,59,72,1
Leonardo Godoy,ARG,"DF,FW",27,Estudiantes,Primera Division,19.7,19,15,12,5,2,13,26,50.0,13,16,2,14,16,35,30,1
Mauro Boselli,ARG,FW,37,Estudiantes,Primera Division,15.2,3,1,0,2,1,1,10,10.0,9,2,0,2,0,3,16,0
Fernando Zuqui,ARG,MF,31,Estudiantes,Primera Division,16.1,33,23,9,19,5,13,41,31.7,28,27,7,20,12,45,14,1
Gastón Benedetti,ARG,"DF,FW",21,Estudiantes,Primera Division,15.6,40,27,21,16,3,20,41,48.8,21,18,3,15,22,62,33,0
Santiago Núñez,ARG,DF,22,Estudiantes,Primera Division,14.4,28,16,20,7,1,15,24,62.5,9,14,11,3,29,57,69,0
Emmanuel Más,ARG,DF,34,Estudiantes,Primera Division,11.8,21,14,12,7,2,15,25,60.0,10,12,4,8,8,29,20,1
Guido Carrillo,ARG,FW,31,Estudiantes,Primera Division,8.5,2,0,1,1,0,0,3,0.0,3,6,0,6,2,4,6,0
Mauro Méndez,URU,"FW,MF",24,Estudiantes,Primera Division,8.2,3,1,1,2,0,1,5,20.0,4,6,0,6,0,3,3,0
José Sosa,ARG,"MF,FW",37,Estudiantes,Primera Division,8.9,25,19,8,10,7,10,27,37.0,17,16,1,15,4,29,8,0
Eros Mancuso,ARG,DF,23,Estudiantes,Primera Division,7.9,19,12,6,11,2,9,23,39.1,14,7,0,7,6,25,17,0
Matías Godoy,ARG,"MF,FW",21,Estudiantes,Primera Division,7.9,15,8,6,5,4,3,14,21.4,11,5,0,5,2,17,3,0
Pablo Piatti,ARG,"MF,FW",33,Estudiantes,Primera Division,4.1,8,6,3,5,0,3,13,23.1,10,9,1,8,0,8,1,0
Franco Zapiola,ARG,"MF,FW",21,Estudiantes,Primera Division,3.7,9,5,3,5,1,4,12,33.3,8,2,0,2,1,10,0,0
Ezequiel Muñoz,ARG,DF,32,Estudiantes,Primera Division,3.3,4,3,2,1,1,2,3,66.7,1,2,2,0,1,5,8,0
Juan Guasone,ARG,DF,21,Estudiantes,Primera Division,2.5,5,4,4,1,0,3,7,42.9,4,1,1,0,3,8,12,0
Daniel Sappa,ARG,GK,27,Estudiantes,Primera Division,2.0,0,0,0,0,0,0,0,0.0,0,0,0,0,0,0,0,0
Mateo Pellegrino,ARG,"FW,MF",21,Estudiantes,Primera Division,2.4,3,3,0,3,0,0,0,0.0,0,0,0,0,1,4,1,0
Nicolás Fernández,ARG,"DF,FW",20,Estudiantes,Primera Division,1.1,5,1,3,2,0,1,2,50.0,1,1,0,1,2,7,2,0
Nicolás Palavecino,ARG,"MF,FW",19,Estudiantes,Primera Division,0.7,0,0,0,0,0,0,0,0.0,0,2,0,2,0,0,0,0
Martiniano Moreno,ARG,"FW,MF",19,Estudiantes,Primera Division,0.7,1,0,0,0,1,0,1,0.0,1,0,0,0,0,1,0,0
Deian Verón,ARG,MF,22,Estudiantes,Primera Division,0.4,1,1,1,0,0,1,3,33.3,2,0,0,0,0,1,1,0
Axel Atum,ARG,"FW,MF",17,Estudiantes,Primera Division,0.4,1,1,1,0,0,1,1,100.0,0,0,0,0,1,2,0,0
Gonzalo Piñeiro,ARG,MF,22,Estudiantes,Primera Division,0.1,1,1,1,0,0,1,1,100.0,0,1,0,1,0,1,0,0
Nicolás Fernández,ARG,FW,26,Defensa y Just,Primera Division,23.6,13,7,3,3,7,4,22,18.2,18,15,3,12,0,13,25,0
Alexis Soto,ARG,DF,29,Defensa y Just,Primera Division,22.5,50,31,27,21,2,25,58,43.1,33,29,7,22,35,85,67,1
Tomás Cardona,ARG,DF,27,Defensa y Just,Primera Division,22.0,33,22,21,11,1,12,23,52.2,11,33,18,15,36,69,116,0
Kevin Facundo Gutiérrez,ARG,MF,25,Defensa y Just,Primera Division,21.8,70,36,35,30,5,29,68,42.6,39,35,5,30,27,97,35,1
Ezequiel Unsain,ARG,GK,27,Defensa y Just,Primera Division,21.0,0,0,0,0,0,0,0,0.0,0,1,0,1,1,1,7,0
Agustín Sant'Anna,URU,DF,25,Defensa y Just,Primera Division,20.7,60,36,37,14,9,36,64,56.3,28,23,9,14,33,93,65,1
Julián López,ARG,MF,23,Defensa y Just,Primera Division,17.7,51,19,15,33,3,20,64,31.3,44,27,7,20,13,64,24,0
Nazareno Colombo,ARG,DF,23,Defensa y Just,Primera Division,17.0,22,15,12,9,1,15,24,62.5,9,23,19,4,27,49,88,1
David Barbona,ARG,"MF,FW",27,Defensa y Just,Primera Division,16.9,23,16,3,17,3,12,21,57.1,9,20,0,20,7,30,14,0
Santiago Solari,ARG,"FW,MF",25,Defensa y Just,Primera Division,15.5,38,27,19,16,3,17,31,54.8,14,16,1,15,12,50,6,0
Gastón Togni,ARG,"FW,MF",25,Defensa y Just,Primera Division,14.6,5,2,1,4,0,3,16,18.8,13,20,2,18,3,8,12,0
Gabriel Alanís,ARG,"FW,MF",28,Defensa y Just,Primera Division,13.1,24,16,13,7,4,9,27,33.3,18,14,2,12,6,30,17,0
Julián Malatini,ARG,DF,21,Defensa y Just,Primera Division,10.8,14,8,9,4,1,4,9,44.4,5,11,4,7,14,28,52,2
Rodrigo Bogarín,PAR,MF,25,Defensa y Just,Primera Division,6.5,11,6,4,7,0,8,20,40.0,12,6,1,5,6,17,5,0
Nicolás Tripichio,ARG,"MF,DF",27,Defensa y Just,Primera Division,9.1,20,11,7,8,5,9,16,56.3,7,13,2,11,10,30,13,0
Lautaro Escalante,ARG,MF,23,Defensa y Just,Primera Division,7.1,15,8,6,9,0,7,24,29.2,17,13,4,9,6,21,5,0
Enrique Bologna,ARG,GK,40,Defensa y Just,Primera Division,6.0,0,0,0,0,0,0,0,0.0,0,0,0,0,0,0,3,0
Darío Cáceres,PAR,"DF,MF",25,Defensa y Just,Primera Division,6.1,14,8,8,4,2,4,13,30.8,9,14,1,13,9,23,15,0
Santi Ramos Mingo,ARG,DF,21,Defensa y Just,Primera Division,5.3,3,1,1,2,0,0,0,0.0,0,7,3,4,7,10,37,0
Gonzalo Castellani,ARG,MF,35,Defensa y Just,Primera Division,3.5,9,7,4,5,0,7,19,36.8,12,10,3,7,6,15,10,1
Benjamín Schamine,ARG,"MF,FW",19,Defensa y Just,Primera Division,1.6,2,2,1,1,0,2,3,66.7,1,4,2,2,0,2,2,0
Federico Versaci,ARG,"FW,MF",20,Defensa y Just,Primera Division,1.5,4,2,2,0,2,1,1,100.0,0,0,0,0,0,4,1,0
Juan Miritello,ARG,"FW,MF",23,Defensa y Just,Primera Division,2.4,0,0,0,0,0,0,3,0.0,3,0,0,0,1,1,3,0
Andrés Ríos,ARG,"FW,MF",33,Defensa y Just,Primera Division,1.3,0,0,0,0,0,0,2,0.0,2,2,0,2,0,0,0,0
Thiago Schiavulli,ARG,DF,19,Defensa y Just,Primera Division,1.0,2,2,2,0,0,1,1,100.0,0,1,0,1,1,3,4,0
Esteban Lucero,ARG,DF,17,Defensa y Just,Primera Division,0.9,1,1,0,1,0,1,1,100.0,0,0,0,0,1,2,6,0
Alan Morinigo,ARG,FW,17,Defensa y Just,Primera Division,0.6,2,0,1,0,1,1,2,50.0,1,3,0,3,0,2,0,0
Edwin Mosquera,COL,"FW,MF",21,Defensa y Just,Primera Division,1.4,1,1,1,0,0,1,3,33.3,2,0,0,0,1,2,1,0
Angel Benítez,PAR,MF,27,Defensa y Just,Primera Division,0.9,3,2,2,1,0,3,7,42.9,4,1,0,1,1,4,3,0
Facundo Echevarría,ARG,FW,20,Defensa y Just,Primera Division,0.5,1,1,0,1,0,0,0,0.0,0,0,0,0,2,3,0,0
Tomás Ortiz,ARG,FW,22,Defensa y Just,Primera Division,0.4,1,1,0,0,1,0,0,0.0,0,0,0,0,0,1,0,0
Lautaro Fedele,ARG,FW,21,Defensa y Just,Primera Division,0.1,0,0,0,0,0,0,0,0.0,0,0,0,0,0,0,0,0
Lautaro Vargas,ARG,DF,17,Defensa y Just,Primera Division,0.1,1,1,1,0,0,0,0,0.0,0,0,0,0,0,1,1,0
Ricardo Solbes,ARG,MF,16,Defensa y Just,Primera Division,0.1,0,0,0,0,0,0,0,0.0,0,0,0,0,1,1,0,0
Sergio Romero,ARG,GK,35,Boca Juniors,Primera Division,23.0,1,1,1,0,0,1,2,50.0,1,0,0,0,2,3,6,0
Jorge Figal,ARG,DF,28,Boca Juniors,Primera Division,22.1,35,27,26,8,1,20,29,69.0,9,29,18,11,15,50,63,2
Guillermo Matías Fernández,ARG,MF,31,Boca Juniors,Primera Division,19.5,42,26,18,21,3,21,53,39.6,32,27,8,19,20,62,18,1
Alan Varela,ARG,MF,21,Boca Juniors,Primera Division,19.0,47,21,19,28,0,23,48,47.9,25,34,13,21,28,75,21,0
Luis Advíncula,PER,"DF,FW",32,Boca Juniors,Primera Division,16.0,35,20,17,17,1,21,27,77.8,6,20,4,16,6,41,16,0
Bruno Valdez,PAR,DF,30,Boca Juniors,Primera Division,14.8,22,14,11,10,1,12,17,70.6,5,21,11,10,24,46,52,0
Frank Fabra,COL,DF,31,Boca Juniors,Primera Division,15.5,28,21,17,7,4,15,27,55.6,12,13,5,8,21,49,27,0
Sebastián Villa,COL,"FW,MF",26,Boca Juniors,Primera Division,14.9,15,11,4,9,2,7,16,43.8,9,11,0,11,8,23,3,0
Marcelo Weigandt,ARG,DF,23,Boca Juniors,Primera Division,13.5,24,17,15,7,2,16,28,57.1,12,21,3,18,11,35,35,1
Cristian Medina,ARG,"MF,FW",20,Boca Juniors,Primera Division,14.7,33,19,12,15,6,18,37,48.6,19,14,1,13,5,38,9,0
Miguel Merentiel,URU,FW,26,Boca Juniors,Primera Division,13.7,7,6,0,4,3,2,7,28.6,5,6,0,6,1,8,6,1
Oscar Romero,PAR,"MF,FW",30,Boca Juniors,Primera Division,11.9,18,13,3,12,3,10,28,35.7,18,9,0,9,7,25,4,0
Darío Benedetto,ARG,FW,32,Boca Juniors,Primera Division,9.9,3,0,0,2,1,1,7,14.3,6,6,1,5,1,4,4,0
Nicolás Valentini,ARG,DF,21,Boca Juniors,Primera Division,11.2,16,11,8,8,0,12,16,75.0,4,8,5,3,9,25,53,0
Valentín Barco,ARG,"DF,FW",18,Boca Juniors,Primera Division,9.2,19,15,9,8,2,7,17,41.2,10,7,1,6,8,27,9,1
Ignacio Fernández,ARG,MF,20,Boca Juniors,Primera Division,10.8,36,23,10,23,3,14,29,48.3,15,25,2,23,18,54,3,1
Facundo Roncaglia,ARG,DF,35,Boca Juniors,Primera Division,10.8,23,14,15,8,0,14,20,70.0,6,15,9,6,17,40,36,1
Luca Langoni,ARG,"FW,MF",20,Boca Juniors,Primera Division,7.9,8,4,3,5,0,4,11,36.4,7,3,0,3,2,10,1,0
Juan Ramírez,ARG,"MF,FW",29,Boca Juniors,Primera Division,6.2,16,9,5,7,4,5,11,45.5,6,10,0,10,4,20,1,0
Martín Payero,ARG,MF,24,Boca Juniors,Primera Division,5.6,14,11,2,11,1,5,11,45.5,6,7,0,7,1,15,3,0
Felicia Karlsson,ARG,DF,29,Boca Juniors,Primera Division,5.1,8,8,5,3,0,5,10,50.0,5,5,0,5,4,12,11,2
Luis Vázquez,ARG,FW,22,Boca Juniors,Primera Division,4.8,5,4,1,4,0,1,6,16.7,5,2,1,1,0,5,3,0
Javier Hernán García,ARG,GK,36,Boca Juniors,Primera Division,4.0,0,0,0,0,0,0,0,0.0,0,0,0,0,0,0,0,0
Nicolás Orsini,ARG,FW,28,Boca Juniors,Primera Division,2.3,1,1,0,0,1,0,0,0.0,0,4,1,3,1,2,1,0
Norberto Briasco,ARM,"FW,MF",26,Boca Juniors,Primera Division,3.8,6,5,0,5,1,0,5,0.0,5,6,0,6,0,6,0,0
Esteban Rolón,ARG,MF,27,Boca Juniors,Primera Division,1.6,11,3,5,5,1,8,10,80.0,2,4,0,4,0,11,2,0
Nahuel Génez,ARG,DF,19,Boca Juniors,Primera Division,1.0,1,1,1,0,0,1,2,50.0,1,1,0,1,0,1,1,0
Exequiel Zeballos,ARG,"MF,FW",20,Boca Juniors,Primera Division,1.2,3,1,0,2,1,0,0,0.0,0,4,0,4,0,3,0,0
Aaron Anselmino,ARG,DF,17,Boca Juniors,Primera Division,0.5,2,1,1,1,0,2,2,100.0,0,0,0,0,1,3,2,0
Diego González,ARG,MF,34,Boca Juniors,Primera Division,0.4,0,0,0,0,0,0,1,0.0,1,2,1,1,2,2,0,0
Brandon Cortés,CHI,FW,21,Boca Juniors,Primera Division,0.2,0,0,0,0,0,0,1,0.0,1,2,0,2,1,1,0,0
Javier Morales,ARG,FW,19,Boca Juniors,Primera Division,0.1,0,0,0,0,0,0,0,0.0,0,0,0,0,0,0,0,0
Facundo Mallo,URU,DF,28,Rosario Central,Primera Division,26.0,36,20,24,11,1,22,39,56.4,17,25,18,7,52,88,154,1
Alan Rodríguez,PAR,DF,22,Rosario Central,Primera Division,25.0,47,31,27,18,2,32,63,50.8,31,26,6,20,29,76,68,0
Víctor Malcorra,ARG,"MF,FW",35,Rosario Central,Primera Division,23.0,13,9,3,6,4,7,36,19.4,29,16,0,16,2,15,3,1
Damián Martínez,ARG,DF,33,Rosario Central,Primera Division,22.4,56,33,33,17,6,30,63,47.6,33,26,7,19,23,79,35,0
Carlos Quintana,ARG,DF,34,Rosario Central,Primera Division,22.3,65,41,45,19,1,33,49,67.3,16,30,18,12,44,109,132,1
Jorge Broun,ARG,GK,36,Rosario Central,Primera Division,23.0,0,0,0,0,0,0,1,0.0,1,1,0,1,1,1,4,1
Kevin Ortíz,ARG,MF,22,Rosario Central,Primera Division,21.1,76,47,40,30,6,34,98,34.7,64,51,12,39,47,123,46,0
Jaminton Campaz,COL,"FW,MF",22,Rosario Central,Primera Division,20.3,45,27,16,23,6,22,49,44.9,27,27,1,26,6,51,5,0
Alejo Véliz,ARG,FW,19,Rosario Central,Primera Division,19.8,5,3,1,2,2,2,6,33.3,4,12,3,9,2,7,36,0
Francis Mac Allister,ARG,MF,27,Rosario Central,Primera Division,13.7,52,35,19,29,4,21,56,37.5,35,25,3,22,19,71,28,0
Laurtaro Giaccone,ARG,"FW,MF",21,Rosario Central,Primera Division,12.5,12,9,6,2,4,6,27,22.2,21,17,4,13,6,18,14,0
Juan Cruz Komar,ARG,DF,26,Rosario Central,Primera Division,11.8,17,8,11,6,0,10,16,62.5,6,10,5,5,14,31,63,0
Walter Montoya,ARG,MF,29,Rosario Central,Primera Division,10.3,25,19,13,10,2,14,44,31.8,30,14,2,12,13,38,9,0
Gino Infantino,ARG,"MF,FW",19,Rosario Central,Primera Division,9.0,18,11,6,9,3,14,26,53.8,12,10,0,10,5,23,2,0
Jhonatan Candia,URU,FW,27,Rosario Central,Primera Division,6.2,3,3,0,2,1,3,5,60.0,2,5,0,5,3,6,8,0
Agustín Toledo,ARG,MF,22,Rosario Central,Primera Division,5.4,15,11,5,10,0,11,24,45.8,13,9,0,9,12,27,10,0
Gaspar Servio,ARG,GK,30,Rosario Central,Primera Division,4.0,0,0,0,0,0,0,0,0.0,0,0,0,0,0,0,3,3
Fabricio Oviedo,ARG,FW,18,Rosario Central,Primera Division,2.1,6,2,0,2,4,2,6,33.3,4,1,1,0,2,8,1,0
Ismael Cortéz,ARG,DF,21,Rosario Central,Primera Division,4.5,21,14,11,8,2,13,24,54.2,11,5,0,5,5,26,25,1
Lucas Rodríguez,ARG,DF,29,Rosario Central,Primera Division,2.3,6,2,4,2,0,4,8,50.0,4,2,2,0,2,8,5,0
Luciano Ferreyra,ARG,"MF,FW",20,Rosario Central,Primera Division,1.6,4,2,1,3,0,2,3,66.7,1,2,0,2,0,4,0,0
Tomás O'Connor,ARG,"MF,FW",18,Rosario Central,Primera Division,1.5,5,3,3,2,0,3,8,37.5,5,3,0,3,0,5,0,0
Facundo Aguero,ARG,DF,28,Rosario Central,Primera Division,1.4,4,1,2,2,0,1,4,25.0,3,1,0,1,3,7,11,0
Octavio Bianchi,ARG,"FW,MF",27,Rosario Central,Primera Division,3.8,5,2,1,2,2,2,4,50.0,2,4,0,4,0,5,7,0
Luca Martínez,MEX,FW,22,Rosario Central,Primera Division,1.7,2,1,1,1,0,2,3,66.7,1,2,1,1,0,2,3,0
Francesco Lo Celso,ARG,"MF,FW",22,Rosario Central,Primera Division,1.5,8,5,4,3,1,6,8,75.0,2,1,0,1,1,9,1,0
Kevin Silva,ARG,DF,19,Rosario Central,Primera Division,0.2,0,0,0,0,0,0,1,0.0,1,1,1,0,0,0,2,1
Diego Matías Rodríguez,ARG,GK,33,Godoy Cruz,Primera Division,26.0,2,2,2,0,0,1,1,100.0,0,1,0,1,1,3,11,2
Federico Rasmussen,ARG,DF,30,Godoy Cruz,Primera Division,26.0,64,36,41,22,1,35,55,63.6,20,34,17,17,51,115,135,1
Gonzalo Abrego,ARG,MF,23,Godoy Cruz,Primera Division,23.7,49,30,16,27,6,24,58,41.4,34,37,6,31,21,70,21,0
Roberto Nicolás Fernández,URU,"FW,MF",24,Godoy Cruz,Primera Division,23.3,50,35,18,27,5,20,75,26.7,55,37,3,34,17,67,25,0
Pier Barrios,ARG,DF,32,Godoy Cruz,Primera Division,23.1,33,18,26,6,1,21,37,56.8,16,28,10,18,17,50,78,0
Lucas Arce,ARG,DF,25,Godoy Cruz,Primera Division,23.3,51,31,26,22,3,35,70,50.0,35,30,4,26,26,77,73,0
Salomón Rodríguez,URU,FW,22,Godoy Cruz,Primera Division,19.7,11,7,1,8,2,1,13,7.7,12,16,3,13,3,14,11,0
Hernán López Muñoz,ARG,MF,22,Godoy Cruz,Primera Division,17.0,39,21,4,25,10,8,36,22.2,28,18,1,17,8,47,6,0
Tadeo Allende,ARG,"FW,MF",23,Godoy Cruz,Primera Division,18.2,28,20,10,12,6,17,40,42.5,23,13,1,12,9,37,9,0
Bruno Leyes,ARG,MF,21,Godoy Cruz,Primera Division,14.6,23,14,10,13,0,13,30,43.3,17,21,3,18,31,54,20,0
Thomas Galdames,CHI,DF,24,Godoy Cruz,Primera Division,14.4,32,16,15,16,1,20,33,60.6,13,26,8,18,22,54,29,1
Tomás Conechny,ARG,"FW,MF",24,Godoy Cruz,Primera Division,15.9,25,16,7,14,4,12,39,30.8,27,22,3,19,8,33,11,0
Juan Meli,ARG,DF,22,Godoy Cruz,Primera Division,11.9,29,14,16,10,3,16,33,48.5,17,13,3,10,20,49,36,0
Juan Andrada,ARG,MF,28,Godoy Cruz,Primera Division,6.8,12,4,2,9,1,8,16,50.0,8,10,3,7,13,25,8,0
Brian Salvareschi,ARG,DF,23,Godoy Cruz,Primera Division,5.3,9,7,5,4,0,2,2,100.0,0,6,3,3,13,22,30,0
Matías Ramírez,ARG,"MF,FW",23,Godoy Cruz,Primera Division,5.7,3,2,0,2,1,0,8,0.0,8,6,1,5,6,9,5,0
Gianluca Ferrari,ARG,DF,25,Godoy Cruz,Primera Division,2.5,8,4,5,3,0,5,8,62.5,3,6,4,2,0,8,7,0
Cristian Núñez,PAR,MF,25,Godoy Cruz,Primera Division,5.2,22,17,11,11,0,9,18,50.0,9,6,0,6,7,29,10,0
Enzo Larrosa,URU,"FW,MF",21,Godoy Cruz,Primera Division,3.9,7,1,1,5,1,3,6,50.0,3,5,0,5,0,7,5,0
Luciano Cingolani,ARG,"MF,FW",21,Godoy Cruz,Primera Division,2.0,7,5,2,4,1,5,7,71.4,2,3,0,3,2,9,2,0
Mateo Mendoza,ARG,DF,18,Godoy Cruz,Primera Division,1.2,6,3,6,0,0,3,6,50.0,3,3,2,1,2,8,9,0
Silvio Ulariaga,ARG,"MF,FW",20,Godoy Cruz,Primera Division,1.0,0,0,0,0,0,0,1,0.0,1,2,0,2,0,0,0,0
Claudio Valverde,ARG,MF,20,Godoy Cruz,Primera Division,1.0,3,1,1,1,1,3,6,50.0,3,4,0,4,1,4,3,0
Rodrigo Saracho,ARG,GK,29,Godoy Cruz,Primera Division,1.0,1,0,1,0,0,1,1,100.0,0,0,0,0,0,1,3,1
Julián Eseiza,ARG,"DF,MF",20,Godoy Cruz,Primera Division,1.9,3,3,2,1,0,3,7,42.9,4,0,0,0,2,5,11,0
Gastón Pedernera,ARG,MF,22,Godoy Cruz,Primera Division,0.5,0,0,0,0,0,0,0,0.0,0,2,0,2,0,0,0,0
Facundo Altamira,ARG,MF,22,Godoy Cruz,Primera Division,0.2,0,0,0,0,0,0,1,0.0,1,0,0,0,0,0,0,0
Enzo Rivamar,ARG,MF,20,Godoy Cruz,Primera Division,0.2,0,0,0,0,0,0,0,0.0,0,0,0,0,0,0,0,0
Lucas Villalba,ARG,DF,28,Arg Juniors,Primera Division,23.8,47,26,23,20,4,24,40,60.0,16,16,11,5,49,96,78,1
Gabriel Ávalos,PAR,FW,32,Arg Juniors,Primera Division,19.7,7,4,0,3,4,2,9,22.2,7,9,1,8,3,10,12,0
Kevin Mac Allister,ARG,DF,25,Arg Juniors,Primera Division,19.2,59,38,29,27,3,30,57,52.6,27,37,8,29,27,86,56,0
Francisco González,ARG,MF,25,Arg Juniors,Primera Division,17.6,33,22,9,17,7,9,36,25.0,27,21,1,20,7,40,7,0
Javier Cabrera,URU,"DF,MF",30,Arg Juniors,Primera Division,17.3,28,25,10,12,6,13,41,31.7,28,22,1,21,10,38,17,0
Santiago Montiel,ARG,"DF,MF",22,Arg Juniors,Primera Division,18.0,37,22,15,13,9,24,43,55.8,19,22,3,19,15,52,14,0
Franco Moyano,ARG,MF,25,Arg Juniors,Primera Division,17.4,29,18,11,16,2,14,30,46.7,16,10,3,7,14,43,19,1
Miguel Ángel Torrén,ARG,DF,34,Arg Juniors,Primera Division,13.8,15,11,11,3,1,10,14,71.4,4,15,9,6,13,28,53,0
Gastón Verón,ARG,"FW,MF",21,Arg Juniors,Primera Division,14.5,17,9,1,8,8,8,15,53.3,7,13,4,9,3,20,10,0
Federico Lanzillota,ARG,GK,30,Arg Juniors,Primera Division,14.0,0,0,0,0,0,0,1,0.0,1,0,0,0,1,1,6,1
Federico Redondo,ARG,MF,20,Arg Juniors,Primera Division,14.2,32,19,16,12,4,11,28,39.3,17,20,5,15,11,43,16,1
Alexis Martin Arias,ARG,GK,30,Arg Juniors,Primera Division,13.0,2,1,2,0,0,2,2,100.0,0,0,0,0,0,2,8,0
Alan Rodríguez,URU,MF,23,Arg Juniors,Primera Division,12.9,36,25,9,19,8,11,29,37.9,18,10,3,7,11,47,7,0
Marco Di Cesare,ARG,DF,21,Arg Juniors,Primera Division,12.1,20,12,17,3,0,15,20,75.0,5,10,7,3,14,34,70,0
Thiago Nuss,ARG,"FW,MF",21,Arg Juniors,Primera Division,10.1,7,4,0,3,4,2,10,20.0,8,16,0,16,1,8,6,0
Luciano Sánchez,ARG,"DF,FW",29,Arg Juniors,Primera Division,9.5,26,18,19,6,1,17,33,51.5,16,15,3,12,11,37,19,1
Rodrigo Cabral,ARG,"DF,MF",22,Arg Juniors,Primera Division,8.7,11,6,5,5,1,6,13,46.2,7,4,0,4,5,16,1,0
Fabricio Domínguez,URU,"MF,DF",24,Arg Juniors,Primera Division,8.6,26,15,8,15,3,12,20,60.0,8,15,0,15,13,39,4,0
Leonardo Heredia,ARG,"FW,MF",27,Arg Juniors,Primera Division,7.3,5,4,3,1,1,0,0,0.0,0,5,0,5,2,7,3,0
Matías Vera,ARG,MF,27,Arg Juniors,Primera Division,5.8,13,12,3,9,1,7,13,53.8,6,10,2,8,4,17,9,1
Leonel González,ARG,DF,28,Arg Juniors,Primera Division,4.3,5,3,5,0,0,2,5,40.0,3,9,3,6,6,11,18,0
Mariano Bíttolo,ARG,"DF,MF",32,Arg Juniors,Primera Division,3.9,4,3,3,1,0,3,13,23.1,10,4,0,4,2,6,11,0
Pablo Minissale,ARG,DF,22,Arg Juniors,Primera Division,4.1,6,2,5,1,0,3,3,100.0,0,4,2,2,3,9,11,0
José Herrera,ARG,"DF,FW",17,Arg Juniors,Primera Division,3.5,6,4,0,1,5,1,6,16.7,5,6,0,6,0,6,0,0
Facundo Ferreyra,ARG,"FW,MF",31,Arg Juniors,Primera Division,2.1,2,1,0,2,0,0,1,0.0,1,1,0,1,0,2,2,0
Román Riquelme,ARG,DF,20,Arg Juniors,Primera Division,0.5,2,2,2,0,0,1,1,100.0,0,0,0,0,0,2,2,0
Tomás Marchiori,ARG,GK,27,Atlé Tucumán,Primera Division,27.0,1,1,1,0,0,1,1,100.0,0,0,0,0,0,1,6,2
Matías Orihuela,ARG,DF,30,Atlé Tucumán,Primera Division,24.7,59,40,34,25,0,29,61,47.5,32,38,9,29,30,89,55,0
Joaquín Pereyra,ARG,MF,24,Atlé Tucumán,Primera Division,24.7,57,37,16,35,6,27,69,39.1,42,37,5,32,22,79,31,0
Mateo Coronel,ARG,FW,24,Atlé Tucumán,Primera Division,21.5,14,9,1,7,6,7,18,38.9,11,13,0,13,3,17,1,0
Bruno Bianchi,ARG,DF,33,Atlé Tucumán,Primera Division,24.0,46,26,37,8,1,25,39,64.1,14,34,24,10,32,78,131,0
Guillermo Acosta,ARG,MF,34,Atlé Tucumán,Primera Division,20.8,39,29,21,14,4,23,45,51.1,22,19,7,12,26,65,31,2
Nicolás Romero,ARG,DF,19,Atlé Tucumán,Primera Division,21.1,28,16,24,4,0,15,31,48.4,16,25,12,13,26,54,97,0
Marcelo Estigarribia,ARG,FW,27,Atlé Tucumán,Primera Division,19.3,19,10,1,13,5,5,15,33.3,10,19,1,18,3,22,29,0
Renzo Tesuri,ARG,"DF,MF",26,Atlé Tucumán,Primera Division,19.6,62,40,26,29,7,39,78,50.0,39,49,6,43,14,76,46,1
Adrián Guillermo Sánchez,ARG,MF,23,Atlé Tucumán,Primera Division,16.3,43,25,18,21,4,22,47,46.8,25,33,4,29,13,56,33,0
Bautista Kociubinski,ARG,MF,21,Atlé Tucumán,Primera Division,14.1,42,21,18,22,2,15,34,44.1,19,18,2,16,28,70,20,0
Marcelo Ortiz,ARG,DF,29,Atlé Tucumán,Primera Division,11.9,20,11,10,10,0,10,20,50.0,10,14,6,8,16,36,35,0
Ramiro Ruiz,ARG,"FW,MF",22,Atlé Tucumán,Primera Division,11.5,11,9,4,6,1,5,15,33.3,10,6,2,4,4,15,9,0
Hernán De La Fuente,ARG,DF,26,Atlé Tucumán,Primera Division,6.4,20,17,13,6,1,9,20,45.0,11,4,0,4,3,23,12,0
Francisco Di Franco,ARG,"MF,DF",28,Atlé Tucumán,Primera Division,5.5,13,5,6,5,2,1,16,6.3,15,6,2,4,2,15,9,0
Yonathan Cabral,ARG,DF,30,Atlé Tucumán,Primera Division,5.4,4,3,1,3,0,3,11,27.3,8,9,7,2,9,13,30,2
Francisco Flores,ARG,DF,21,Atlé Tucumán,Primera Division,3.0,7,4,7,0,0,4,5,80.0,1,3,3,0,2,9,8,0
Marcelo González,PAR,MF,26,Atlé Tucumán,Primera Division,2.7,5,5,1,3,1,4,9,44.4,5,5,1,4,1,6,1,0
Moisés Brandán,ARG,DF,22,Atlé Tucumán,Primera Division,2.3,4,4,3,1,0,3,7,42.9,4,3,0,3,3,7,7,0
Cristian Menéndez,ARG,FW,34,Atlé Tucumán,Primera Division,4.2,2,2,1,1,0,0,2,0.0,2,5,2,3,2,4,2,0
Ignacio Maestro Puch,ARG,"FW,MF",19,Atlé Tucumán,Primera Division,4.0,4,1,2,1,1,0,3,0.0,3,5,0,5,0,4,5,0
Braian Guille,ARG,"MF,FW",25,Atlé Tucumán,Primera Division,3.8,5,4,0,4,1,2,4,50.0,2,5,0,5,0,5,1,0
Wilson Ibarrola,PAR,DF,26,Atlé Tucumán,Primera Division,1.8,5,4,3,1,1,2,5,40.0,3,2,0,2,0,5,11,0
Lucas Naranjo,ARG,MF,21,Atlé Tucumán,Primera Division,0.1,3,2,1,2,0,1,1,100.0,0,0,0,0,0,3,0,0
Maximiliano Alanís,ARG,DF,19,Atlé Tucumán,Primera Division,0.0,0,0,0,0,0,0,0,0.0,0,0,0,0,0,0,0,0
Kevin Isa,ARG,MF,21,Atlé Tucumán,Primera Division,0.0,1,1,1,0,0,0,0,0.0,0,0,0,0,0,1,0,0
Gabriel Arias,CHI,GK,35,Racing Club,Primera Division,23.7,0,0,0,0,0,0,3,0.0,3,2,0,2,0,0,8,1
Juan Nardoni,ARG,MF,20,Racing Club,Primera Division,21.1,51,35,21,27,3,26,60,43.3,34,19,3,16,27,78,32,0
Leonardo Sigali,ARG,DF,35,Racing Club,Primera Division,18.3,26,17,19,7,0,15,29,51.7,14,22,13,9,23,49,80,0
Gonzalo Piovi,ARG,"DF,MF",28,Racing Club,Primera Division,17.7,44,29,24,18,2,23,52,44.2,29,17,4,13,29,73,89,0
Jonathan David Gómez,ARG,MF,33,Racing Club,Primera Division,17.3,37,22,9,21,7,16,42,38.1,26,12,1,11,11,48,11,0
Facundo Mura,ARG,"DF,MF",23,Racing Club,Primera Division,17.0,29,14,20,5,4,20,36,55.6,16,19,4,15,18,47,37,1
Gabriel Hauche,ARG,"FW,MF",36,Racing Club,Primera Division,16.8,12,10,2,9,1,5,23,21.7,18,14,0,14,4,16,6,0
Maximiliano Romero,ARG,FW,24,Racing Club,Primera Division,16.1,6,5,1,4,1,2,4,50.0,2,1,1,0,3,9,16,0
Aníbal Moreno,ARG,MF,23,Racing Club,Primera Division,15.5,43,27,22,18,3,28,59,47.5,31,24,6,18,15,58,24,0
Gabriel Rojas,ARG,"DF,MF",25,Racing Club,Primera Division,14.9,22,16,13,5,4,15,34,44.1,19,11,3,8,10,32,36,0
Nicolás Oróz,ARG,"MF,FW",28,Racing Club,Primera Division,14.4,22,16,9,8,5,12,32,37.5,20,16,2,14,14,36,5,0
Matías Rojas,PAR,FW,27,Racing Club,Primera Division,11.3,21,13,10,8,3,12,23,52.2,11,8,1,7,2,23,0,0
Tomás Avilés,ARG,"DF,MF",18,Racing Club,Primera Division,11.1,30,21,18,10,2,11,28,39.3,17,15,5,10,17,47,26,0
Emiliano Insúa,ARG,DF,34,Racing Club,Primera Division,9.2,21,14,13,8,0,11,17,64.7,6,8,4,4,16,37,25,0
Santiago Quiros,ARG,DF,19,Racing Club,Primera Division,7.3,6,3,5,1,0,3,13,23.1,10,9,5,4,5,11,24,1
Maximiliano Moralez,ARG,"MF,FW",35,Racing Club,Primera Division,7.3,8,5,5,2,1,3,16,18.8,13,7,3,4,3,11,8,0
Jonathan Galván,ARG,DF,30,Racing Club,Primera Division,6.5,11,10,10,1,0,4,9,44.4,5,9,7,2,13,24,33,0
Johan Carbonero,COL,FW,23,Racing Club,Primera Division,5.0,2,0,0,1,1,1,4,25.0,3,5,0,5,3,5,0,0
Paolo Guerrero,PER,FW,39,Racing Club,Primera Division,6.5,1,0,1,0,0,0,2,0.0,2,3,0,3,0,1,5,0
Baltasar Gallego,ARG,"FW,MF",19,Racing Club,Primera Division,5.2,15,11,3,10,2,2,16,12.5,14,3,0,3,1,16,3,0
Emiliano Saliadarre,ARG,"FW,MF",20,Racing Club,Primera Division,3.8,4,3,1,3,0,0,2,0.0,2,1,0,1,1,5,7,0
Nicolás Reniero,ARG,"FW,MF",27,Racing Club,Primera Division,5.0,8,6,1,5,2,1,6,16.7,5,6,0,6,1,9,5,0
Oscar Opazo,CHI,DF,32,Racing Club,Primera Division,4.9,15,11,8,7,0,5,11,45.5,6,3,0,3,6,21,7,1
Matías Tagliamonte,ARG,GK,24,Racing Club,Primera Division,3.3,0,0,0,0,0,0,0,0.0,0,0,0,0,0,0,1,0
Tobías Rubio,ARG,"MF,DF",18,Racing Club,Primera Division,3.0,7,2,4,3,0,3,10,30.0,7,1,0,1,2,9,4,0
Iván Pillud,ARG,"DF,MF",36,Racing Club,Primera Division,4.5,9,6,6,3,0,5,8,62.5,3,7,1,6,4,13,8,0
Agustin Ojeda,ARG,FW,18,Racing Club,Primera Division,1.9,2,2,1,0,1,0,1,0.0,1,2,0,2,1,3,0,0
Héctor Fértoli,ARG,"FW,MF",28,Racing Club,Primera Division,1.6,1,1,0,0,1,1,3,33.3,2,1,0,1,0,1,0,0
Edwin Cardona,COL,"FW,MF",30,Racing Club,Primera Division,1.0,1,1,1,0,0,1,2,50.0,1,1,0,1,0,1,0,0
Juan Cáceres,PAR,DF,22,Racing Club,Primera Division,0.4,2,2,2,0,0,0,0,0.0,0,1,0,1,1,3,1,0
Catriel Cabellos,PER,"MF,FW",18,Racing Club,Primera Division,1.3,1,1,1,0,0,0,3,0.0,3,0,0,0,0,1,1,0
Tomás Pérez,ARG,FW,16,Racing Club,Primera Division,0.6,0,0,0,0,0,0,1,0.0,1,0,0,0,0,0,4,0
Santino Vera,ARG,"MF,FW",16,Racing Club,Primera Division,0.5,3,3,1,1,1,2,3,66.7,1,1,0,1,0,3,0,0
Román Fernández,ARG,FW,17,Racing Club,Primera Division,0.4,1,0,1,0,0,0,0,0.0,0,0,0,0,0,1,0,0
Ignacio Galván,ARG,DF,20,Racing Club,Primera Division,0.1,0,0,0,0,0,0,0,0.0,0,0,0,0,0,0,0,0
Ramiro Degregorio,ARG,MF,19,Racing Club,Primera Division,0.1,0,0,0,0,0,0,0,0.0,0,0,0,0,0,0,0,0
Santiago Longo,ARG,MF,24,Belgrano,Primera Division,26.8,88,59,46,39,3,47,100,47.0,53,30,4,26,28,116,32,0
Pablo Vegetti,ARG,FW,34,Belgrano,Primera Division,26.5,8,5,2,5,1,4,22,18.2,18,15,3,12,1,9,30,0
Nahuel Losada,ARG,GK,29,Belgrano,Primera Division,25.5,1,1,1,0,0,1,1,100.0,0,1,0,1,0,1,11,3
Ulises Sánchez,ARG,MF,24,Belgrano,Primera Division,23.8,35,19,18,15,2,17,51,33.3,34,29,5,24,13,48,18,0
Alejandro Rébola,ARG,DF,34,Belgrano,Primera Division,23.0,18,9,14,4,0,9,19,47.4,10,12,7,5,41,59,97,0
Bruno Zapelli,ARG,"MF,FW",20,Belgrano,Primera Division,20.2,37,26,8,26,3,19,53,35.8,34,22,2,20,11,48,10,1
Nicolás Meriano,ARG,DF,22,Belgrano,Primera Division,17.4,26,16,20,5,1,13,27,48.1,14,24,8,16,27,53,71,0
Juan Barinaga,ARG,DF,22,Belgrano,Primera Division,13.7,42,28,28,12,2,28,44,63.6,16,16,2,14,19,61,30,0
Erik Godoy,ARG,DF,29,Belgrano,Primera Division,14.4,11,9,5,5,1,8,11,72.7,3,18,10,8,18,29,61,0
Matias Ibacache,CHI,DF,24,Belgrano,Primera Division,12.0,13,8,4,9,0,8,13,61.5,5,4,2,2,3,16,24,1
Ariel Rojas,ARG,MF,37,Belgrano,Primera Division,11.7,32,21,8,23,1,14,35,40.0,21,15,8,7,19,51,12,0
Franco Jara,ARG,FW,34,Belgrano,Primera Division,9.9,16,7,2,9,5,3,16,18.8,13,15,0,15,1,17,14,0
Lucas Diarte,ARG,DF,29,Belgrano,Primera Division,10.8,27,15,17,7,3,16,26,61.5,10,13,4,9,10,37,22,0
Gabriel Compagnucci,ARG,"DF,MF",31,Belgrano,Primera Division,10.8,17,9,10,6,1,7,13,53.8,6,5,1,4,8,25,21,0
Matías García,ARG,MF,31,Belgrano,Primera Division,8.2,30,13,6,17,7,15,26,57.7,11,9,1,8,5,35,8,0
Tomas Castro,ARG,MF,20,Belgrano,Primera Division,4.6,8,6,1,4,3,4,9,44.4,5,10,0,10,2,10,5,0
Iván Ortigoza,ARG,"FW,MF",27,Belgrano,Primera Division,4.5,8,4,2,4,2,5,11,45.5,6,2,0,2,2,10,2,0
Guillermo Pereira,ARG,"DF,MF",29,Belgrano,Primera Division,5.8,20,16,7,9,4,9,24,37.5,15,8,1,7,9,29,16,0
Matias Moreno,ARG,DF,19,Belgrano,Primera Division,3.1,1,0,0,1,0,1,1,100.0,0,2,1,1,5,6,10,0
Ibrahim Hesar,SYR,"MF,FW",29,Belgrano,Primera Division,5.9,12,9,3,7,2,5,13,38.5,8,13,2,11,5,17,10,0
Diego Novaretti,ARG,DF,37,Belgrano,Primera Division,2.6,5,4,5,0,0,3,3,100.0,0,2,1,1,7,12,21,0
Fabián Bordagaray,ARG,"FW,MF",35,Belgrano,Primera Division,2.6,3,3,2,1,0,2,3,66.7,1,5,0,5,2,5,2,0
Daniel Barrea,ARG,FW,21,Belgrano,Primera Division,2.1,0,0,0,0,0,0,5,0.0,5,2,0,2,1,1,1,0
Mariano Miño,ARG,MF,28,Belgrano,Primera Division,1.8,2,1,0,2,0,0,1,0.0,1,2,0,2,1,3,0,0
Manuel Vicentini,ARG,GK,32,Belgrano,Primera Division,1.5,0,0,0,0,0,0,0,0.0,0,0,0,0,1,1,0,0
Francisco Oliver,ARG,DF,27,Belgrano,Primera Division,1.1,2,2,1,1,0,1,1,100.0,0,1,0,1,2,4,5,0
Joaquín Susvielles,ARG,"FW,DF",31,Belgrano,Primera Division,2.0,3,0,1,1,1,1,1,100.0,0,3,1,2,0,3,8,0
Iván Ramírez,ARG,MF,32,Belgrano,Primera Division,1.6,4,4,3,1,0,3,8,37.5,5,5,0,5,2,6,4,0
Gerónimo Tomasetti,ARG,MF,22,Belgrano,Primera Division,0.6,2,1,0,2,0,1,3,33.3,2,1,0,1,0,2,2,0
Andrés Felipe Amaya,COL,MF,21,Belgrano,Primera Division,0.3,0,0,0,0,0,0,0,0.0,0,1,0,1,0,0,0,0
Francisco Facello,ARG,DF,20,Belgrano,Primera Division,0.2,1,1,1,0,0,1,1,100.0,0,0,0,0,1,2,1,0
Facundo Lencioni,ARG,MF,21,Belgrano,Primera Division,0.2,1,1,1,0,0,1,1,100.0,0,2,0,2,2,3,0,0
Lucas Hoyos,ARG,GK,33,Newell's OB,Primera Division,27.0,2,2,2,0,0,2,2,100.0,0,0,0,0,1,3,11,2
Juan Sforza,ARG,MF,20,Newell's OB,Primera Division,20.9,46,27,14,29,3,20,48,41.7,28,24,4,20,26,72,38,0
Jorge Eduardo Recalde,PAR,FW,30,Newell's OB,Primera Division,20.4,14,8,2,8,4,3,17,17.6,14,13,3,10,3,17,11,0
Iván Gómez,ARG,MF,25,Newell's OB,Primera Division,19.5,52,31,18,23,11,26,57,45.6,31,25,1,24,21,73,22,1
Jherson Mosquera,COL,DF,23,Newell's OB,Primera Division,18.9,38,24,21,15,2,13,33,39.4,20,11,2,9,32,70,23,0
Gustavo Velásquez,PAR,DF,31,Newell's OB,Primera Division,17.6,27,19,21,6,0,17,27,63.0,10,10,6,4,33,60,81,0
Cristian Ferreira,ARG,MF,23,Newell's OB,Primera Division,17.0,20,9,5,10,5,7,27,25.9,20,11,2,9,5,25,5,0
Ramiro Sordo,ARG,"FW,MF",22,Newell's OB,Primera Division,16.4,28,17,13,11,4,14,28,50.0,14,19,1,18,6,34,5,0
Willer Ditta,COL,DF,26,Newell's OB,Primera Division,16.2,11,7,10,1,0,6,8,75.0,2,16,10,6,14,25,56,0
Bruno Pittón,ARG,DF,29,Newell's OB,Primera Division,15.4,38,27,23,12,3,19,36,52.8,17,16,3,13,14,52,27,0
Brian Aguirre,ARG,FW,19,Newell's OB,Primera Division,14.8,15,7,8,5,2,6,19,31.6,13,9,0,9,2,17,1,0
Guillermo Ortiz,ARG,DF,30,Newell's OB,Primera Division,12.9,17,11,15,2,0,11,15,73.3,4,11,7,4,14,31,51,0
Zahir Mansilla,ARG,DF,23,Newell's OB,Primera Division,11.1,12,6,8,3,1,9,13,69.2,4,13,8,5,27,39,39,1
Marcos Portillo,ARG,"MF,FW",23,Newell's OB,Primera Division,10.4,26,17,10,14,2,12,32,37.5,20,14,1,13,12,38,15,1
Angelo Martino,ARG,"DF,MF",24,Newell's OB,Primera Division,8.6,16,10,11,2,3,6,9,66.7,3,16,6,10,22,38,14,0
Armando Méndez,URU,"DF,MF",26,Newell's OB,Primera Division,7.8,15,10,10,3,2,11,16,68.8,5,9,1,8,4,19,5,0
Jeremías Pérez Tica,ARG,FW,19,Newell's OB,Primera Division,8.1,10,9,5,3,2,8,16,50.0,8,7,0,7,3,13,4,0
Djorkaeff Reasco,ECU,"FW,MF",24,Newell's OB,Primera Division,7.4,2,2,0,2,0,1,8,12.5,7,7,0,7,1,3,3,0
Lisandro Montenegro,ARG,MF,19,Newell's OB,Primera Division,6.8,8,5,3,4,1,3,11,27.3,8,7,0,7,9,17,1,0
Jony,ARG,"FW,MF",28,Newell's OB,Primera Division,4.2,4,1,1,3,0,1,9,11.1,8,4,0,4,0,4,2,0
Pablo Pérez,ARG,MF,37,Newell's OB,Primera Division,4.3,7,4,1,4,2,4,15,26.7,11,5,1,4,2,9,4,0
Guillermo Balzi,ARG,"MF,FW",21,Newell's OB,Primera Division,2.1,8,7,1,7,0,4,5,80.0,1,1,0,1,3,11,0,0
Francisco González,ARG,"FW,MF",21,Newell's OB,Primera Division,1.7,0,0,0,0,0,0,2,0.0,2,2,0,2,0,0,0,0
Justo Giani,ARG,"MF,FW",23,Newell's OB,Primera Division,1.3,2,2,2,0,0,1,2,50.0,1,0,0,0,0,2,3,0
David Sotelo,ARG,MF,19,Newell's OB,Primera Division,1.1,1,1,0,1,0,0,0,0.0,0,0,0,0,1,2,2,0
Ian Glavinovich,ARG,DF,21,Newell's OB,Primera Division,1.0,1,0,0,1,0,1,1,100.0,0,4,3,1,1,2,5,0
Leonel Vangioni,ARG,DF,35,Newell's OB,Primera Division,1.0,0,0,0,0,0,0,1,0.0,1,1,0,1,2,2,0,0
Genaro Rossi,ARG,FW,20,Newell's OB,Primera Division,0.6,0,0,0,0,0,0,0,0.0,0,0,0,0,0,0,0,0
Julián Contrera,ARG,"FW,MF",19,Newell's OB,Primera Division,0.7,2,2,0,2,0,2,2,100.0,0,0,0,0,0,2,0,0
Nazareno Funez,ARG,"FW,MF",21,Newell's OB,Primera Division,0.4,0,0,0,0,0,0,0,0.0,0,0,0,0,0,0,0,0
Fabrizio Sartori,ARG,FW,20,Newell's OB,Primera Division,0.1,1,1,1,0,0,0,0,0.0,0,0,0,0,0,1,0,0
Marcelo Esponda,ARG,MF,20,Newell's OB,Primera Division,0.1,1,1,0,1,0,1,1,100.0,0,0,0,0,0,1,1,0
Iván Tapia,ARG,MF,24,Barracas Central,Primera Division,26.8,38,22,10,21,7,21,59,35.6,38,20,1,19,12,50,15,0
Francisco Álvarez,ARG,DF,22,Barracas Central,Primera Division,25.0,41,19,33,8,0,24,39,61.5,15,30,11,19,46,87,121,1
Andrés Desábato,ARG,GK,32,Barracas Central,Primera Division,24.0,2,0,2,0,0,2,3,66.7,1,2,0,2,1,3,16,1
Bruno Sepúlveda,ARG,FW,30,Barracas Central,Primera Division,21.9,13,7,1,5,7,5,23,21.7,18,20,8,12,1,14,31,0
Facundo Mater,ARG,"MF,DF",24,Barracas Central,Primera Division,20.9,55,36,27,15,13,36,73,49.3,37,27,1,26,19,74,37,0
Mauro Peinipil,ARG,"DF,MF",23,Barracas Central,Primera Division,19.9,28,20,13,12,3,20,34,58.8,14,20,5,15,28,56,50,0
Juan Ignacio Díaz,ARG,DF,24,Barracas Central,Primera Division,19.4,55,35,30,23,2,22,43,51.2,21,31,11,20,44,99,69,0
Carlos Arce,ARG,MF,32,Barracas Central,Primera Division,16.5,51,33,21,27,3,27,47,57.4,20,35,7,28,16,67,45,0
Brian Calderara,ARG,"MF,DF",24,Barracas Central,Primera Division,15.9,41,29,19,17,5,17,30,56.7,13,22,3,19,14,55,10,0
Nicolás Capraro,ARG,DF,24,Barracas Central,Primera Division,16.8,32,18,18,12,2,20,32,62.5,12,20,7,13,25,57,71,1
Rodrigo Insúa,ARG,DF,25,Barracas Central,Primera Division,15.6,28,19,16,7,5,21,33,63.6,12,19,3,16,13,41,36,0
Rodrigo Herrera,ARG,MF,22,Barracas Central,Primera Division,12.8,40,28,20,18,2,19,45,42.2,26,26,3,23,18,58,20,0
Lucas Colitto,ARG,MF,28,Barracas Central,Primera Division,9.0,12,5,5,4,3,8,21,38.1,13,12,0,12,7,19,5,0
Alexis Dominguez,ARG,FW,26,Barracas Central,Primera Division,8.4,9,5,1,6,2,3,10,30.0,7,8,0,8,0,9,9,0
Ricardo Centurión,ARG,"FW,MF",30,Barracas Central,Primera Division,6.2,7,5,1,6,0,4,11,36.4,7,4,0,4,3,10,0,0
Fernando Prado,URU,DF,21,Barracas Central,Primera Division,4.6,7,4,6,1,0,6,12,50.0,6,6,1,5,8,15,20,1
Marcos Benítez,ARG,"MF,FW",21,Barracas Central,Primera Division,6.6,11,6,4,4,3,6,14,42.9,8,3,0,3,4,15,5,0
Agustín Dáttola,ARG,DF,23,Barracas Central,Primera Division,3.8,4,4,3,1,0,3,5,60.0,2,3,1,2,4,8,5,0
Maximiliano Rodríguez,ARG,"DF,MF",34,Barracas Central,Primera Division,5.4,11,7,6,5,0,7,14,50.0,7,5,3,2,8,19,16,0
Maximiliano Puig,ARG,MF,22,Barracas Central,Primera Division,3.5,8,6,3,4,1,2,10,20.0,8,4,0,4,1,9,1,0
Guido Villar,ARG,GK,24,Barracas Central,Primera Division,3.0,2,1,2,0,0,2,2,100.0,0,0,0,0,0,2,2,0
Alan Cantero,ARG,"FW,MF",24,Barracas Central,Primera Division,5.6,5,3,2,1,2,3,11,27.3,8,2,0,2,1,6,5,0
Nicolás Tolosa,ARG,"MF,DF",21,Barracas Central,Primera Division,1.8,2,2,1,1,0,1,5,20.0,4,0,0,0,6,8,5,0
Franco Frías,ARG,FW,20,Barracas Central,Primera Division,1.3,2,1,0,2,0,0,2,0.0,2,0,0,0,0,2,0,0
Lucas López,ARG,MF,25,Barracas Central,Primera Division,0.9,2,1,0,1,1,0,2,0.0,2,1,0,1,0,2,1,0
Julián Viollaz,ARG,"FW,MF",20,Barracas Central,Primera Division,0.5,0,0,0,0,0,0,0,0.0,0,1,0,1,0,0,0,0
Kevin Quejada,COL,"MF,DF",20,Barracas Central,Primera Division,0.4,0,0,0,0,0,0,0,0.0,0,2,1,1,0,0,1,0
Manuel Brondo,ARG,FW,20,Barracas Central,Primera Division,0.1,0,0,0,0,0,0,0,0.0,0,0,0,0,0,0,1,0
Alex Juárez,ARG,MF,18,Barracas Central,Primera Division,0.1,0,0,0,0,0,0,0,0.0,0,0,0,0,0,0,0,0
Bruno Mastronicola,ARG,DF,22,Barracas Central,Primera Division,0.0,0,0,0,0,0,0,0,0.0,0,0,0,0,0,0,1,0
Gonzalo Marinelli,ARG,GK,33,Tigre,Primera Division,25.0,0,0,0,0,0,0,2,0.0,2,0,0,0,2,2,9,7
Brian Luciatti,ARG,DF,29,Tigre,Primera Division,22.7,46,32,34,9,3,27,32,84.4,5,26,13,13,34,80,106,0
Mateo Retegui,ITA,FW,23,Tigre,Primera Division,19.9,15,13,3,9,3,2,15,13.3,13,12,2,10,2,17,17,0
Facundo Colidio,ARG,"MF,FW",23,Tigre,Primera Division,18.5,17,7,3,9,5,9,23,39.1,14,17,0,17,1,18,6,1
Alexis Castro,ARG,"MF,FW",28,Tigre,Primera Division,16.6,49,25,15,29,5,27,62,43.5,35,25,3,22,17,66,15,0
Lucas Menossi,ARG,"MF,FW",30,Tigre,Primera Division,16.9,31,18,10,14,7,18,46,39.1,28,22,1,21,17,48,9,1
Blas Armoa,PAR,"FW,MF",22,Tigre,Primera Division,15.9,12,8,5,4,3,3,12,25.0,9,11,1,10,11,23,3,0
Sebastián Prieto,ARG,DF,29,Tigre,Primera Division,16.2,46,26,19,21,6,29,48,60.4,19,19,3,16,12,58,42,0
Lucas Blondel,ARG,DF,26,Tigre,Primera Division,13.9,39,24,22,12,5,23,53,43.4,30,28,4,24,29,68,37,1
Emanuel Aguilera,ARG,DF,33,Tigre,Primera Division,14.0,12,6,10,1,1,7,15,46.7,8,10,6,4,24,36,71,2
Aaron Nicolás Molinas,ARG,"MF,FW",22,Tigre,Primera Division,13.1,24,14,6,9,9,12,19,63.2,7,20,1,19,10,34,13,0
Sebastián Prediger,ARG,MF,36,Tigre,Primera Division,12.4,48,36,20,27,1,16,41,39.0,25,16,3,13,21,69,18,0
Agustín Cardozo,ARG,MF,25,Tigre,Primera Division,15.0,27,15,15,10,2,14,26,53.8,12,11,2,9,21,48,22,0
Víctor Cabrera,ARG,DF,29,Tigre,Primera Division,11.7,30,19,18,11,1,15,26,57.7,11,13,7,6,23,53,49,0
Cristian Zabala,ARG,MF,24,Tigre,Primera Division,11.7,27,14,12,13,2,11,31,35.5,20,22,0,22,16,43,26,2
Lautaro Montoya,ARG,DF,28,Tigre,Primera Division,8.5,6,3,4,1,1,3,20,15.0,17,15,5,10,13,19,20,0
Martín Ortega,ARG,"DF,MF",23,Tigre,Primera Division,8.3,18,12,7,9,2,11,19,57.9,8,10,2,8,5,23,21,1
Brian Alexis Leizza,ARG,DF,22,Tigre,Primera Division,8.8,15,9,12,2,1,9,10,90.0,1,8,3,5,15,30,36,0
Tomás Badaloni,ARG,FW,22,Tigre,Primera Division,7.5,2,0,1,0,1,1,6,16.7,5,4,1,3,3,5,4,0
Martin Garay,ARG,"DF,MF",23,Tigre,Primera Division,7.6,7,5,3,4,0,4,10,40.0,6,18,4,14,5,12,11,0
Gonzalo Flores,ARG,"FW,MF",20,Tigre,Primera Division,4.4,10,5,2,5,3,7,10,70.0,3,4,1,3,2,12,3,0
Santiago Rojas,PAR,GK,26,Tigre,Primera Division,2.0,0,0,0,0,0,0,0,0.0,0,0,0,0,0,0,1,0
Ezequiel Forclaz,ARG,"MF,FW",19,Tigre,Primera Division,2.0,7,5,3,3,1,3,6,50.0,3,4,2,2,3,10,1,0
Agustín Obando,ARG,"MF,FW",22,Tigre,Primera Division,2.4,3,1,0,2,1,1,4,25.0,3,3,0,3,0,3,2,0
Sebastián Medina,ARG,MF,22,Tigre,Primera Division,1.3,2,0,0,0,2,0,1,0.0,1,2,0,2,0,2,1,0
Mateo Caceres,ARG,FW,20,Tigre,Primera Division,0.1,1,1,0,1,0,0,0,0.0,0,0,0,0,0,1,0,0
Ijiel Protti,ARG,MF,28,Tigre,Primera Division,0.0,0,0,0,0,0,0,0,0.0,0,2,0,2,1,1,0,0
Nicolás Castro,ARG,"MF,FW",32,Platense,Primera Division,22.1,66,39,25,34,7,29,72,40.3,43,44,3,41,27,93,24,0
Ramiro Macagno,ARG,GK,25,Platense,Primera Division,22.0,0,0,0,0,0,0,2,0.0,2,1,0,1,1,1,6,1
Sasha Marcich,ARG,"DF,MF",24,Platense,Primera Division,21.1,49,28,27,12,10,25,46,54.3,21,32,8,24,13,62,63,0
Vicente Taborda,ARG,"MF,FW",21,Platense,Primera Division,19.7,35,26,13,19,3,13,36,36.1,23,23,0,23,8,43,1,0
Nicolás Servetto,ARG,FW,26,Platense,Primera Division,18.1,10,6,2,6,2,2,9,22.2,7,8,2,6,1,11,17,0
Ronaldo Martínez,PAR,"FW,MF",26,Platense,Primera Division,16.4,13,8,4,7,2,4,21,19.0,17,11,4,7,11,24,25,0
Ignacio Vázquez,ARG,DF,25,Platense,Primera Division,17.9,40,26,17,23,0,29,43,67.4,14,20,9,11,37,77,73,0
Marco Pellegrino,ARG,DF,21,Platense,Primera Division,16.9,30,19,19,10,1,22,34,64.7,12,25,12,13,20,50,130,0
Nicolás Morgantini,ARG,DF,28,Platense,Primera Division,16.7,35,22,19,9,7,20,37,54.1,17,24,9,15,13,48,43,0
Iván Rossi,ARG,MF,29,Platense,Primera Division,14.6,49,37,19,28,2,23,52,44.2,29,24,4,20,32,81,23,0
Franco Díaz,ARG,MF,22,Platense,Primera Division,14.1,45,28,18,24,3,24,54,44.4,30,29,3,26,17,62,22,0
Juan Infante,ARG,DF,27,Platense,Primera Division,12.0,29,15,11,14,4,13,27,48.1,14,19,5,14,16,45,25,0
Franco Baldassarra,ARG,"MF,FW",24,Platense,Primera Division,11.5,21,12,11,8,2,12,33,36.4,21,22,1,21,4,25,8,0
Gastón Suso,ARG,DF,31,Platense,Primera Division,11.2,18,10,9,9,0,7,8,87.5,1,12,7,5,27,45,63,0
Mauro Quiroga,ARG,FW,33,Platense,Primera Division,9.3,0,0,0,0,0,0,4,0.0,4,4,0,4,0,0,12,0
Jerónimo Cacciabue,ARG,MF,25,Platense,Primera Division,8.8,22,12,8,12,2,10,25,40.0,15,12,5,7,7,29,14,0
Miguel Jacquet Duarte,PAR,DF,27,Platense,Primera Division,8.5,10,4,5,5,0,7,10,70.0,3,9,6,3,8,18,56,1
Ignacio Arce,ARG,GK,30,Platense,Primera Division,5.0,0,0,0,0,0,0,0,0.0,0,0,0,0,0,0,2,1
Raúl Lozano,ARG,DF,25,Platense,Primera Division,4.9,11,10,8,3,0,8,11,72.7,3,5,0,5,0,11,6,0
Gonzalo Asis,ARG,DF,26,Platense,Primera Division,4.8,14,7,14,0,0,10,22,45.5,12,11,2,9,8,22,12,0
Maximiliano Zalazar,ARG,"MF,FW",21,Platense,Primera Division,4.6,10,4,2,6,2,9,15,60.0,6,7,0,7,4,14,0,0
Ignacio Schor,ARG,"MF,FW",22,Platense,Primera Division,5.6,10,6,5,5,0,3,15,20.0,12,9,1,8,2,12,4,0
Gonzalo Valdivia,ARG,"MF,DF",21,Platense,Primera Division,2.5,2,2,1,1,0,1,7,14.3,6,1,0,1,3,5,10,0
Juan Pignani,ARG,"DF,FW",21,Platense,Primera Division,2.4,8,6,6,2,0,6,7,85.7,1,1,1,0,0,8,9,0
Agustín Alonso,ARG,"FW,MF",23,Platense,Primera Division,2.6,4,3,1,3,0,3,6,50.0,3,1,0,1,1,5,5,0
Alexis Sabella,ARG,MF,21,Platense,Primera Division,1.9,1,1,0,0,1,1,9,11.1,8,2,0,2,0,1,3,0
Nadir Zeineddin,ARG,FW,22,Platense,Primera Division,1.5,2,2,0,2,0,1,6,16.7,5,1,0,1,0,2,3,0
Alejo Monje,ARG,FW,21,Platense,Primera Division,0.1,1,1,0,1,0,1,2,50.0,1,0,0,0,1,2,1,0
Gastón Lodico,ARG,MF,24,Instituto,Primera Division,25.9,65,43,33,25,7,32,90,35.6,58,45,4,41,22,87,20,0
Fernando Alarcón,ARG,DF,28,Instituto,Primera Division,26.0,47,29,31,15,1,30,45,66.7,15,30,14,16,27,74,140,1
Adrián Martínez,ARG,FW,30,Instituto,Primera Division,25.3,22,14,1,17,4,7,26,26.9,19,19,5,14,1,23,24,0
Sebastián Corda,ARG,DF,27,Instituto,Primera Division,22.4,47,32,32,13,2,27,49,55.1,22,20,5,15,27,74,53,1
Gabriel Graciani,ARG,"MF,FW",29,Instituto,Primera Division,19.6,48,31,21,17,10,19,42,45.2,23,20,3,17,8,56,32,0
Santiago Rodriguez,ARG,"FW,MF",25,Instituto,Primera Division,19.2,18,10,1,11,6,6,19,31.6,13,20,0,20,3,21,2,0
Nicolás Linares,ARG,MF,26,Instituto,Primera Division,17.9,52,36,22,22,8,26,59,44.1,33,20,5,15,28,80,27,0
Leonel Mosevich,ARG,DF,25,Instituto,Primera Division,17.6,30,17,18,12,0,21,33,63.6,12,13,5,8,30,60,65,0
Jorge Carranza,ARG,GK,41,Instituto,Primera Division,16.9,1,1,1,0,0,1,3,33.3,2,0,0,0,0,1,11,0
Giuliano Cerato,ARG,DF,24,Instituto,Primera Division,17.0,29,18,15,10,4,13,41,31.7,28,20,5,15,17,46,44,0
Franco Watson,ARG,MF,23,Instituto,Primera Division,13.4,20,13,7,10,3,11,30,36.7,19,16,0,16,4,24,5,0
Roberto Bochi,ARG,MF,33,Instituto,Primera Division,12.5,29,17,7,19,3,15,28,53.6,13,19,3,16,17,46,18,0
Brian Cuello,ARG,"MF,FW",25,Instituto,Primera Division,13.0,22,17,10,8,4,7,26,26.9,19,20,0,20,8,30,21,0
Juan Franco Arrellaga,PAR,DF,30,Instituto,Primera Division,9.5,14,12,6,6,2,4,6,66.7,2,8,2,6,17,31,18,0
Manuel Roffo,ARG,GK,22,Instituto,Primera Division,10.1,0,0,0,0,0,0,1,0.0,1,0,0,0,0,0,3,0
Ezequiel Parnisari,ARG,DF,32,Instituto,Primera Division,8.3,6,2,5,1,0,5,9,55.6,4,7,5,2,7,13,37,0
Axel Rodríguez,ARG,FW,25,Instituto,Primera Division,5.0,3,1,1,2,0,2,4,50.0,2,3,1,2,0,3,6,0
Jonathan Bay,ARG,DF,29,Instituto,Primera Division,4.7,12,5,7,4,1,8,12,66.7,4,5,1,4,7,19,9,1
Joaquín Varela,URU,DF,24,Instituto,Primera Division,2.6,3,2,3,0,0,2,5,40.0,3,3,1,2,5,8,16,0
Nicólas Watson,ARG,MF,24,Instituto,Primera Division,1.3,5,4,2,3,0,1,7,14.3,6,2,0,2,2,7,5,0
Lucas Albertengo,ARG,"FW,MF",32,Instituto,Primera Division,2.4,7,5,3,3,1,1,2,50.0,1,0,0,0,0,7,3,0
Oscar Garrido,ARG,"MF,FW",25,Instituto,Primera Division,2.4,8,3,2,6,0,3,6,50.0,3,5,1,4,3,11,1,0
Nicolás Barrientos,ARG,"MF,FW",27,Instituto,Primera Division,1.2,2,2,0,2,0,1,1,100.0,0,0,0,0,0,2,0,0
Gregorio Rodríguez,ARG,"FW,MF",23,Instituto,Primera Division,1.1,4,4,1,3,0,3,5,60.0,2,4,1,3,0,4,3,0
Leonardo Monje,ARG,MF,20,Instituto,Primera Division,0.4,1,0,1,0,0,0,2,0.0,2,2,1,1,1,2,0,0
Jonathan Dellarossa,ARG,FW,23,Instituto,Primera Division,0.1,0,0,0,0,0,0,0,0.0,0,0,0,0,0,0,0,0
Damián Puebla,ARG,FW,20,Instituto,Primera Division,0.1,0,0,0,0,0,0,0,0.0,0,0,0,0,0,0,0,0
Juan Manuel Insaurralde,ARG,DF,38,Sarmiento,Primera Division,23.8,22,16,17,4,1,12,16,75.0,4,23,17,6,11,33,134,0
Emiliano Méndez,ARG,MF,33,Sarmiento,Primera Division,21.1,68,42,31,35,2,27,69,39.1,42,31,11,20,26,94,48,0
Gonzalo Bettini,ARG,"DF,MF",30,Sarmiento,Primera Division,20.7,56,33,35,18,3,26,58,44.8,32,26,7,19,29,85,55,0
Sebastián Meza,ARG,GK,22,Sarmiento,Primera Division,21.0,0,0,0,0,0,0,0,0.0,0,0,0,0,0,0,7,1
Luciano Gondou,ARG,"FW,MF",21,Sarmiento,Primera Division,18.4,9,7,3,5,1,2,11,18.2,9,15,1,14,3,12,17,0
Manuel García,ARG,"DF,MF",23,Sarmiento,Primera Division,18.3,46,28,27,17,2,17,42,40.5,25,33,13,20,23,69,67,0
Fernando Martínez,PAR,MF,28,Sarmiento,Primera Division,16.3,39,27,18,16,5,17,44,38.6,27,25,10,15,25,64,27,0
Javier Toledo,ARG,FW,36,Sarmiento,Primera Division,17.7,10,6,0,9,1,1,13,7.7,12,8,2,6,1,11,12,0
Gabriel Díaz,ARG,"DF,MF",22,Sarmiento,Primera Division,16.2,38,25,17,14,7,16,29,55.2,13,14,3,11,32,70,49,0
Lisandro López,ARG,"FW,MF",39,Sarmiento,Primera Division,13.9,19,8,5,11,3,11,31,35.5,20,13,0,13,3,22,10,0
Franco Sbuttoni,ARG,DF,33,Sarmiento,Primera Division,13.8,14,9,9,5,0,9,14,64.3,5,17,12,5,17,31,75,0
Alejandro Donatti,ARG,DF,36,Sarmiento,Primera Division,12.0,2,0,2,0,0,1,4,25.0,3,17,13,4,10,12,73,0
Jean Pierre Rosso,URU,"DF,MF",25,Sarmiento,Primera Division,11.2,27,21,18,7,2,13,28,46.4,15,16,2,14,18,45,31,0
Sergio Quiroga,ARG,MF,28,Sarmiento,Primera Division,12.6,32,20,9,16,7,7,29,24.1,22,9,0,9,5,37,20,0
Lucas Melano,ARG,"FW,MF",29,Sarmiento,Primera Division,12.1,20,15,6,11,3,5,9,55.6,4,7,3,4,4,24,4,0
Manuel Mónaco,ARG,"MF,FW",22,Sarmiento,Primera Division,11.3,22,12,9,9,4,5,21,23.8,16,13,2,11,3,25,11,0
Juan Hernández,URU,DF,25,Sarmiento,Primera Division,9.1,19,11,8,11,0,9,19,47.4,10,13,4,9,12,31,47,0
Franco Quinteros,ARG,"DF,MF",24,Sarmiento,Primera Division,6.2,25,16,17,5,3,14,27,51.9,13,16,7,9,8,33,24,0
José Devecchi,ARG,GK,27,Sarmiento,Primera Division,6.0,1,1,1,0,0,1,1,100.0,0,0,0,0,0,1,5,0
Juan Cruz Kaprof,ARG,"FW,MF",27,Sarmiento,Primera Division,3.7,14,9,9,4,1,6,11,54.5,5,7,0,7,3,17,3,0
David Gallardo,ARG,"MF,DF",25,Sarmiento,Primera Division,2.3,8,6,4,3,1,2,6,33.3,4,5,2,3,2,10,1,0
Guido Mainero,ARG,"MF,FW",27,Sarmiento,Primera Division,2.2,4,4,1,2,1,2,4,50.0,2,3,0,3,3,7,1,0
Harrinson Mancilla,COL,MF,31,Sarmiento,Primera Division,2.1,7,3,4,3,0,2,9,22.2,7,6,2,4,1,8,4,1
José Mauri,ITA,MF,26,Sarmiento,Primera Division,1.1,7,5,4,3,0,2,2,100.0,0,2,2,0,1,8,3,0
Yair Ezequiel Arismendi,ARG,"DF,MF",24,Sarmiento,Primera Division,1.3,3,2,3,0,0,2,4,50.0,2,1,0,1,1,4,2,0
Ayrton Cougo,URU,"MF,DF",26,Sarmiento,Primera Division,0.8,2,1,2,0,0,1,4,25.0,3,2,0,2,1,3,6,0
Lautaro Cerato,ARG,FW,22,Sarmiento,Primera Division,0.4,0,0,0,0,0,0,0,0.0,0,0,0,0,1,1,0,0
Joaquín Gho,ARG,MF,19,Sarmiento,Primera Division,0.3,0,0,0,0,0,0,2,0.0,2,1,0,1,0,0,1,0
Nicolás Femia,ARG,"MF,FW",26,Sarmiento,Primera Division,0.2,1,1,0,1,0,1,1,100.0,0,0,0,0,0,1,0,0
Santiago Morales,ARG,MF,22,Sarmiento,Primera Division,0.1,0,0,0,0,0,0,0,0.0,0,0,0,0,0,0,0,0
Pablo Gerzel,ARG,MF,23,Sarmiento,Primera Division,0.1,0,0,0,0,0,0,0,0.0,0,0,0,0,0,0,0,0
Yamil Garnier,ARG,MF,40,Sarmiento,Primera Division,0.0,1,0,1,0,0,0,0,0.0,0,0,0,0,0,1,1,0
Claudio Corvalán,ARG,DF,33,Unión,Primera Division,24.7,54,34,38,16,0,27,34,79.4,7,22,11,11,50,104,109,0
Federico Vera,ARG,DF,24,Unión,Primera Division,21.0,50,36,26,18,6,32,52,61.5,20,31,10,21,23,73,41,0
Franco Calderón,ARG,DF,24,Unión,Primera Division,21.9,23,13,12,9,2,14,30,46.7,16,21,15,6,23,46,112,0
Imanol Machuca,ARG,"FW,MF",23,Unión,Primera Division,20.7,26,20,10,13,3,10,32,31.3,22,16,1,15,2,28,6,0
Mauro Luna Diale,ARG,"MF,FW",23,Unión,Primera Division,20.3,44,26,14,23,7,15,37,40.5,22,31,4,27,2,46,27,0
Yeison Gordillo,COL,MF,30,Unión,Primera Division,19.9,86,48,44,39,3,47,93,50.5,46,34,3,31,29,115,34,0
Kevin Zenon,ARG,"DF,MF",21,Unión,Primera Division,16.7,28,18,16,10,2,17,28,60.7,11,22,0,22,15,43,19,0
Enzo Martín Roldán,ARG,MF,22,Unión,Primera Division,16.5,30,17,17,12,1,11,27,40.7,16,19,3,16,25,55,14,0
Santiago Mele,URU,GK,25,Unión,Primera Division,16.0,0,0,0,0,0,0,0,0.0,0,0,0,0,0,0,6,1
Jerónimo Domina,ARG,FW,17,Unión,Primera Division,12.8,7,4,3,2,2,4,15,26.7,11,8,1,7,3,10,3,0
Oscar Piris,ARG,DF,33,Unión,Primera Division,12.0,24,15,10,13,1,15,24,62.5,9,15,7,8,18,42,50,0
Luciano Aued,ARG,MF,35,Unión,Primera Division,11.3,26,18,9,13,4,16,25,64.0,9,12,2,10,12,38,13,0
Lucas Esquivel,ARG,DF,21,Unión,Primera Division,11.5,30,19,14,14,2,18,33,54.5,15,21,3,18,14,44,26,0
Sebastián Moyano,ARG,GK,32,Unión,Primera Division,11.0,0,0,0,0,0,0,0,0.0,0,0,0,0,0,0,3,2
Nicolás Paz,ARG,DF,20,Unión,Primera Division,9.9,28,20,17,9,2,20,30,66.7,10,4,3,1,10,38,43,0
Daniel Juárez,ARG,"MF,FW",21,Unión,Primera Division,7.2,14,9,5,5,4,7,23,30.4,16,12,1,11,3,17,5,0
Ezequiel Cañete,ARG,"FW,MF",23,Unión,Primera Division,6.6,17,10,7,8,2,5,17,29.4,12,9,4,5,4,21,7,0
Junior Marabel,PAR,FW,24,Unión,Primera Division,6.5,7,2,6,1,0,1,7,14.3,6,3,1,2,0,7,7,0
Thiago Vecino,URU,FW,23,Unión,Primera Division,4.9,4,3,0,4,0,0,2,0.0,2,4,3,1,2,6,5,0
Francisco Gerometta,ARG,"DF,MF",23,Unión,Primera Division,5.7,21,14,15,5,1,12,22,54.5,10,7,1,6,5,26,22,0
Joaquín Mosqueira,ARG,MF,18,Unión,Primera Division,4.4,12,5,1,10,1,6,11,54.5,5,5,0,5,0,12,5,0
Mateo Del Blanco,ARG,"DF,MF",19,Unión,Primera Division,3.7,8,5,1,6,1,6,10,60.0,4,8,1,7,3,11,4,0
Tomás González,ARG,"MF,FW",19,Unión,Primera Division,2.8,9,5,3,3,3,3,7,42.9,4,6,0,6,3,12,0,0
Juan Ludueña,ARG,DF,19,Unión,Primera Division,2.7,5,3,3,2,0,3,8,37.5,5,4,2,2,7,12,10,0
Mariano Meynier,ARG,FW,19,Unión,Primera Division,0.9,3,2,1,2,0,1,3,33.3,2,0,0,0,0,3,2,0
Gastón Comas,ARG,MF,24,Unión,Primera Division,0.7,2,1,1,1,0,2,5,40.0,3,1,1,0,0,2,1,0
Bryan Castrillón,COL,"FW,MF",23,Unión,Primera Division,2.6,5,3,2,3,0,0,4,0.0,4,5,0,5,1,6,0,0
Lisandro Morales,ARG,DF,19,Unión,Primera Division,0.3,0,0,0,0,0,0,0,0.0,0,0,0,0,1,1,0,0
Valentino Venetucci,ARG,MF,21,Unión,Primera Division,0.0,0,0,0,0,0,0,0,0.0,0,0,0,0,1,1,1,0
Facundo Cambeses,ARG,GK,25,Banfield,Primera Division,27.0,0,0,0,0,0,0,2,0.0,2,0,0,0,0,0,10,0
Juan Bisanz,ARG,"MF,FW",21,Banfield,Primera Division,22.5,37,26,12,19,6,20,47,42.6,27,39,2,37,13,50,7,0
Brahian Alemán,URU,MF,33,Banfield,Primera Division,20.7,40,22,16,19,5,18,39,46.2,21,23,4,19,18,58,25,0
Alejandro Cabrera,ARG,MF,30,Banfield,Primera Division,19.9,68,53,24,37,7,38,69,55.1,31,34,5,29,42,110,29,0
Alejandro Maciel,ARG,DF,25,Banfield,Primera Division,20.6,41,28,28,13,0,25,42,59.5,17,23,15,8,25,66,112,0
Emanuel Coronel,ARG,DF,25,Banfield,Primera Division,19.7,52,37,26,23,3,23,40,57.5,17,27,4,23,29,81,59,1
Eric Remedi,ARG,MF,27,Banfield,Primera Division,19.5,40,26,15,24,1,17,58,29.3,41,38,3,35,24,64,26,0
Emanuel Insúa,ARG,DF,31,Banfield,Primera Division,18.8,67,42,37,28,2,32,55,58.2,23,22,2,20,27,94,47,0
Milton Giménez,ARG,FW,26,Banfield,Primera Division,17.2,36,27,3,24,9,9,24,37.5,15,26,2,24,3,39,13,0
Aaron Quirós,ARG,DF,21,Banfield,Primera Division,15.1,20,11,14,5,1,10,18,55.6,8,20,8,12,15,35,56,1
Emanuel Olivera,ARG,DF,32,Banfield,Primera Division,15.0,26,19,15,10,1,19,29,65.5,10,17,10,7,15,41,69,0
Nicolás Sosa,URU,"MF,FW",26,Banfield,Primera Division,11.9,29,16,8,12,9,13,31,41.9,18,20,2,18,6,35,26,0
Andrés Chávez,ARG,FW,31,Banfield,Primera Division,11.1,6,3,1,2,3,2,8,25.0,6,8,1,7,0,6,11,0
Sebastián Sosa,URU,FW,28,Banfield,Primera Division,9.8,7,5,0,4,3,2,16,12.5,14,13,3,10,6,13,10,0
Matías Romero,ARG,"DF,MF",26,Banfield,Primera Division,10.6,23,11,14,7,2,19,38,50.0,19,4,1,3,13,36,26,0
Ignacio Rodríguez,ARG,MF,20,Banfield,Primera Division,8.0,10,4,4,1,5,5,11,45.5,6,7,1,6,5,15,5,0
Pedro Souto,ARG,DF,22,Banfield,Primera Division,6.7,14,11,7,7,0,8,16,50.0,8,9,0,9,13,27,18,0
Luis Mago,VEN,DF,28,Banfield,Primera Division,5.2,14,9,10,4,0,6,10,60.0,4,8,5,3,8,22,16,1
Mateo Pérez,ARG,DF,22,Banfield,Primera Division,3.4,6,3,2,4,0,4,5,80.0,1,0,0,0,3,9,8,0
Nicolás Bertolo,ARG,MF,37,Banfield,Primera Division,2.0,2,2,1,1,0,0,0,0.0,0,1,0,1,0,2,1,0
Alan Di Pippa,ARG,MF,22,Banfield,Primera Division,2.6,9,7,1,6,2,5,11,45.5,6,6,3,3,4,13,3,0
Alejandro Piedrahita,COL,"MF,FW",20,Banfield,Primera Division,1.8,2,0,0,1,1,1,2,50.0,1,3,1,2,1,3,2,0
Horacio Tijanovich,ARG,MF,26,Banfield,Primera Division,1.5,0,0,0,0,0,0,1,0.0,1,0,0,0,0,0,0,0
Agustín Urzi,ARG,MF,22,Banfield,Primera Division,0.7,3,1,1,0,2,1,2,50.0,1,0,0,0,2,5,0,0
Lautaro Ríos,ARG,"MF,FW",22,Banfield,Primera Division,1.7,10,4,3,5,2,3,7,42.9,4,2,1,1,4,14,0,0
Geronimo Rivera,ARG,"MF,FW",19,Banfield,Primera Division,1.5,2,1,0,1,1,0,2,0.0,2,6,0,6,0,2,1,0
Matías González,ARG,MF,20,Banfield,Primera Division,0.6,2,2,0,2,0,0,3,0.0,3,0,0,0,0,2,0,0
Tomás Adoryán,ARG,MF,21,Banfield,Primera Division,0.4,1,0,0,1,0,0,1,0.0,1,0,0,0,0,1,0,0
Tomás Durso,ARG,GK,23,Gimnasia–LP,Primera Division,26.0,1,1,1,0,0,1,1,100.0,0,1,0,1,1,2,11,0
Felipe Sánchez,ARG,DF,18,Gimnasia–LP,Primera Division,25.8,28,18,22,6,0,18,34,52.9,16,22,16,6,30,58,129,1
Leonardo Morales,ARG,DF,31,Gimnasia–LP,Primera Division,23.9,30,24,24,6,0,19,30,63.3,11,33,25,8,40,70,120,1
Ignacio Miramon,ARG,MF,19,Gimnasia–LP,Primera Division,18.8,66,54,35,27,4,31,64,48.4,33,27,4,23,17,83,20,0
Matías Melluso,ARG,DF,24,Gimnasia–LP,Primera Division,15.7,69,47,37,28,4,35,52,67.3,17,20,5,15,37,106,41,0
Franco Soldano,ARG,"FW,MF",28,Gimnasia–LP,Primera Division,15.0,24,15,7,14,3,12,21,57.1,9,34,8,26,9,33,27,0
Alan Lescano,ARG,"MF,FW",21,Gimnasia–LP,Primera Division,13.6,20,11,6,10,4,10,35,28.6,25,14,0,14,12,32,9,0
Cristian Tarragona,ARG,FW,31,Gimnasia–LP,Primera Division,15.2,20,10,1,10,9,4,12,33.3,8,15,2,13,0,20,10,0
Guillermo Enrique,ARG,DF,22,Gimnasia–LP,Primera Division,13.7,30,22,23,4,3,14,31,45.2,17,17,4,13,14,44,35,0
Benjamín Domínguez,ARG,FW,19,Gimnasia–LP,Primera Division,12.7,10,4,2,5,3,2,8,25.0,6,17,1,16,1,11,5,0
Bautista Barros Schelotto,ARG,DF,23,Gimnasia–LP,Primera Division,12.7,29,20,20,8,1,18,30,60.0,12,4,0,4,9,38,37,0
Agustín Bolívar,ARG,MF,27,Gimnasia–LP,Primera Division,11.9,23,16,6,14,3,13,28,46.4,15,9,3,6,18,41,25,0
Nicolás Colazo,ARG,"DF,MF",32,Gimnasia–LP,Primera Division,9.7,16,12,8,5,3,8,15,53.3,7,14,4,10,16,32,28,1
Eric Ramírez,ARG,"MF,FW",26,Gimnasia–LP,Primera Division,11.1,24,14,6,13,5,8,21,38.1,13,8,0,8,4,28,9,0
Nicolás Sánchez,ARG,MF,18,Gimnasia–LP,Primera Division,6.4,11,7,7,4,0,9,21,42.9,12,9,2,7,13,24,16,0
Antonio Napolitano,ARG,"MF,FW",23,Gimnasia–LP,Primera Division,6.7,32,22,13,16,3,8,23,34.8,15,8,1,7,11,43,10,1
Maximiliano Comba,ARG,MF,29,Gimnasia–LP,Primera Division,5.9,16,8,5,8,3,8,14,57.1,6,9,1,8,6,22,3,0
Ivo Mammini,ARG,"FW,MF",19,Gimnasia–LP,Primera Division,7.3,7,5,2,4,1,3,9,33.3,6,8,1,7,2,9,5,0
Alan Sosa,ARG,"MF,FW",19,Gimnasia–LP,Primera Division,5.5,7,5,2,3,2,4,9,44.4,5,12,0,12,5,12,2,0
Alexis Steimbach,ARG,FW,20,Gimnasia–LP,Primera Division,5.4,20,9,10,8,2,10,23,43.5,13,11,3,8,3,23,13,0
Rodrigo Castillo,ARG,FW,23,Gimnasia–LP,Primera Division,4.7,7,4,1,4,2,4,6,66.7,2,7,2,5,1,8,5,0
Franco Torres,ARG,"FW,MF",23,Gimnasia–LP,Primera Division,5.9,10,5,3,5,2,5,13,38.5,8,3,0,3,0,10,3,0
Tomás Muro,ARG,"MF,FW",20,Gimnasia–LP,Primera Division,3.7,8,4,1,7,0,3,7,42.9,4,4,0,4,6,14,3,0
Bruno Palazzo,ARG,DF,22,Gimnasia–LP,Primera Division,3.5,10,6,6,4,0,6,11,54.5,5,2,0,2,5,15,27,0
Matías Bazzo,ARG,DF,21,Gimnasia–LP,Primera Division,3.4,5,4,3,2,0,5,5,100.0,0,2,1,1,4,9,11,0
Leandro Contín,ARG,FW,27,Gimnasia–LP,Primera Division,2.4,4,2,1,3,0,4,5,80.0,1,1,0,1,0,4,5,0
Leandro Mamut,ARG,MF,19,Gimnasia–LP,Primera Division,3.6,7,3,2,4,1,2,6,33.3,4,1,0,1,2,9,4,0
Diego Mastrángelo,ARG,DF,20,Gimnasia–LP,Primera Division,1.2,2,2,1,1,0,1,3,33.3,2,4,3,1,4,6,6,0
Nelson Insfrán,ARG,GK,27,Gimnasia–LP,Primera Division,1.0,0,0,0,0,0,0,0,0.0,0,0,0,0,0,0,1,0
Germán Guiffrey,ARG,DF,25,Gimnasia–LP,Primera Division,0.9,4,4,2,2,0,1,1,100.0,0,0,0,0,1,5,1,0
Rodrigo Gallo,ARG,DF,22,Gimnasia–LP,Primera Division,0.8,4,1,3,1,0,2,3,66.7,1,1,0,1,2,6,5,0
Gonzalo Ezequiel González,ARG,DF,27,Gimnasia–LP,Primera Division,0.6,2,2,2,0,0,2,3,66.7,1,3,1,2,2,4,0,0
Agustín Ramírez,ARG,"FW,DF",22,Gimnasia–LP,Primera Division,0.5,2,1,0,1,1,1,2,50.0,1,0,0,0,1,3,0,0
Sebastián Cocimano,ARG,"FW,MF",22,Gimnasia–LP,Primera Division,0.3,3,0,0,1,2,1,1,100.0,0,0,0,0,0,3,0,0
Tomás Fernández,ARG,DF,23,Gimnasia–LP,Primera Division,0.2,0,0,0,0,0,0,1,0.0,1,0,0,0,0,0,0,0
Fabio Pereyra,ARG,DF,33,Cen. Córdoba–SdE,Primera Division,26.0,40,22,31,9,0,26,43,60.5,17,40,33,7,24,64,166,0
Brian Blasi,ARG,DF,26,Cen. Córdoba–SdE,Primera Division,22.4,37,22,25,11,1,21,44,47.7,23,24,9,15,29,66,63,0
Mauro Pittón,ARG,MF,28,Cen. Córdoba–SdE,Primera Division,23.3,78,46,29,41,8,43,105,41.0,62,36,17,19,45,123,45,0
Gustavo Canto,ARG,DF,28,Cen. Córdoba–SdE,Primera Division,23.2,57,35,41,14,2,27,50,54.0,23,46,16,30,47,104,113,0
Brian Farioli,ARG,"MF,FW",24,Cen. Córdoba–SdE,Primera Division,20.0,21,14,5,16,0,5,28,17.9,23,12,0,12,5,26,6,0
Ciro Rius,ARG,"MF,FW",34,Cen. Córdoba–SdE,Primera Division,19.0,38,30,24,11,3,21,50,42.0,29,20,2,18,19,57,38,0
Leandro Maciel,ARG,MF,27,Cen. Córdoba–SdE,Primera Division,18.2,40,21,13,22,5,14,43,32.6,29,24,4,20,19,59,29,0
Lucas Gamba,ARG,FW,35,Cen. Córdoba–SdE,Primera Division,20.3,16,10,3,12,1,5,16,31.3,11,12,1,11,1,17,0,0
Lucas Besozzi,ARG,"MF,FW",20,Cen. Córdoba–SdE,Primera Division,17.7,24,15,8,14,2,7,18,38.9,11,19,0,19,9,33,3,0
Marcos Ignacio Ledesma,ARG,GK,26,Cen. Córdoba–SdE,Primera Division,18.0,0,0,0,0,0,0,1,0.0,1,0,0,0,1,1,7,2
Gonzalo Goñi,ARG,DF,24,Cen. Córdoba–SdE,Primera Division,13.8,24,15,13,11,0,11,17,64.7,6,17,10,7,7,31,59,0
Marcelo Benitez,ARG,DF,32,Cen. Córdoba–SdE,Primera Division,14.8,26,13,13,11,2,11,30,36.7,19,11,1,10,26,52,45,1
Facundo Castelli,ARG,"FW,MF",27,Cen. Córdoba–SdE,Primera Division,9.6,15,10,3,6,6,8,10,80.0,2,10,1,9,1,16,12,0
Matías Mansilla,ARG,GK,26,Cen. Córdoba–SdE,Primera Division,9.0,0,0,0,0,0,0,1,0.0,1,0,0,0,0,0,3,0
Enzo Kalinski,ARG,MF,35,Cen. Córdoba–SdE,Primera Division,7.3,22,13,9,10,3,12,18,66.7,6,5,2,3,13,35,25,1
Cristian Torres,ARG,"FW,MF",23,Cen. Córdoba–SdE,Primera Division,8.1,14,9,6,7,1,7,21,33.3,14,8,0,8,1,15,7,0
Jesús Soraire,ARG,MF,34,Cen. Córdoba–SdE,Primera Division,7.0,18,11,7,10,1,9,25,36.0,16,9,1,8,5,23,9,0
Julián Navas,ARG,DF,29,Cen. Córdoba–SdE,Primera Division,4.3,9,5,4,5,0,4,12,33.3,8,9,2,7,7,16,13,0
José Gómez,ARG,DF,22,Cen. Córdoba–SdE,Primera Division,3.5,10,8,4,5,1,7,11,63.6,4,6,2,4,3,13,10,0
Federico Jourdan,ARG,"MF,DF",32,Cen. Córdoba–SdE,Primera Division,4.1,8,5,3,3,2,6,7,85.7,1,3,1,2,1,9,3,0
Luis Miguel Rodríguez,ARG,"MF,FW",38,Cen. Córdoba–SdE,Primera Division,2.5,1,0,0,0,1,1,4,25.0,3,1,0,1,1,2,0,0
Ramón Cansinos,ARG,FW,20,Cen. Córdoba–SdE,Primera Division,1.3,3,3,1,2,0,2,4,50.0,2,2,0,2,0,3,0,0
Sebastián Valdez,ARG,DF,27,Cen. Córdoba–SdE,Primera Division,0.7,2,1,1,1,0,1,1,100.0,0,0,0,0,0,2,2,0
Leandro Ciccolini,ARG,"MF,DF",27,Cen. Córdoba–SdE,Primera Division,0.7,1,1,1,0,0,1,1,100.0,0,0,0,0,1,2,0,0
Diego Vásquez,ARG,"MF,FW",22,Cen. Córdoba–SdE,Primera Division,1.2,6,5,6,0,0,1,3,33.3,2,1,0,1,1,7,2,0
Nicolás Leguizamón,ARG,FW,28,Cen. Córdoba–SdE,Primera Division,0.6,0,0,0,0,0,0,1,0.0,1,1,0,1,0,0,0,0
Rodrigo Rey,ARG,GK,31,Independiente,Primera Division,27.0,1,1,1,0,0,1,1,100.0,0,0,0,0,1,2,8,0
Ayrton Costa,ARG,DF,23,Independiente,Primera Division,24.0,71,45,34,29,8,32,75,42.7,43,35,4,31,48,119,52,0
Martín Cauteruccio,URU,FW,35,Independiente,Primera Division,23.8,10,8,1,6,3,3,16,18.8,13,9,4,5,7,17,18,0
Cristian Báez,PAR,DF,32,Independiente,Primera Division,22.5,33,18,22,9,2,16,22,72.7,6,19,11,8,34,67,96,0
Iván Marcone,ARG,MF,32,Independiente,Primera Division,20.3,40,26,21,18,1,20,44,45.5,24,27,8,19,19,59,27,0
Mateo Barcia,URU,"DF,MF",21,Independiente,Primera Division,18.0,71,50,34,32,5,23,56,41.1,33,24,3,21,19,90,34,0
Matías Giménez,ARG,"FW,MF",23,Independiente,Primera Division,18.4,13,8,1,6,6,6,11,54.5,5,21,1,20,6,19,20,0
Sergio Ortíz,ARG,MF,21,Independiente,Primera Division,16.2,66,41,18,37,11,30,60,50.0,30,36,5,31,16,82,15,0
Sergio Barreto,ARG,DF,23,Independiente,Primera Division,12.9,22,17,13,9,0,14,22,63.6,8,22,9,13,22,44,53,3
Javier Vallejo,ARG,"MF,FW",19,Independiente,Primera Division,12.7,16,8,5,8,3,10,21,47.6,11,16,1,15,4,20,10,0
Edgar Elizalde,URU,DF,22,Independiente,Primera Division,12.6,23,16,14,9,0,10,15,66.7,5,16,11,5,22,45,51,2
Brian Martínez,ARG,MF,23,Independiente,Primera Division,12.0,18,11,7,9,2,5,24,20.8,19,11,0,11,10,28,9,0
Luciano Gómez,ARG,DF,26,Independiente,Primera Division,7.8,20,14,12,6,2,11,15,73.3,4,6,3,3,10,30,15,0
Joaquín Laso,ARG,DF,32,Independiente,Primera Division,10.3,17,12,13,4,0,9,15,60.0,6,10,2,8,23,40,46,1
Kevin Lopez,ARG,MF,21,Independiente,Primera Division,8.3,16,14,7,5,4,7,14,50.0,7,17,2,15,8,24,8,0
Martín Sarrafiore,ARG,MF,25,Independiente,Primera Division,7.9,19,14,6,12,1,12,24,50.0,12,12,2,10,6,25,3,0
Agustín Mulet,ARG,MF,22,Independiente,Primera Division,6.3,13,10,3,9,1,3,12,25.0,9,5,0,5,6,19,12,0
Juan Cazares,ECU,"MF,FW",30,Independiente,Primera Division,7.4,8,5,0,7,1,3,8,37.5,5,7,0,7,2,10,2,0
Damián Pérez,ARG,DF,34,Independiente,Primera Division,4.8,10,5,4,6,0,5,9,55.6,4,10,3,7,7,17,14,0
Javier Osatchuk,ARG,DF,22,Independiente,Primera Division,4.8,9,5,3,5,1,6,15,40.0,9,4,0,4,9,18,9,0
Mauricio Cuero,COL,"MF,FW",30,Independiente,Primera Division,4.5,6,6,4,1,1,4,10,40.0,6,0,0,0,3,9,2,0
Rodrigo Márquez,ARG,"FW,MF",20,Independiente,Primera Division,3.0,4,1,2,2,0,1,3,33.3,2,3,1,2,0,4,2,0
Santiago Salle,ARG,"DF,MF",18,Independiente,Primera Division,2.8,8,5,1,4,3,5,8,62.5,3,4,0,4,2,10,3,1
Tomás Pozzo,ARG,"FW,MF",22,Independiente,Primera Division,2.2,10,5,5,3,2,6,10,60.0,4,3,1,2,0,10,1,0
Tomás Rambert,ARG,"MF,DF",19,Independiente,Primera Division,0.9,2,1,0,1,1,1,2,50.0,1,0,0,0,0,2,1,0
Santiago Hidalgo,ARG,"FW,MF",17,Independiente,Primera Division,1.9,5,3,1,4,0,2,8,25.0,6,4,0,4,2,7,1,0
Rodrigo Atencio,ARG,"MF,FW",20,Independiente,Primera Division,1.0,3,2,2,1,0,2,5,40.0,3,2,0,2,0,3,0,0
Rubén Martínez,ARG,MF,18,Independiente,Primera Division,0.7,7,6,4,3,0,6,6,100.0,0,2,0,2,1,8,2,0
Agustin Quiroga,ARG,DF,20,Independiente,Primera Division,0.2,0,0,0,0,0,0,0,0.0,0,1,0,1,0,0,1,0
Santiago López,ARG,MF,16,Independiente,Primera Division,0.0,0,0,0,0,0,0,0,0.0,0,0,0,0,0,0,0,0
Francisco Ortega,ARG,DF,23,Vélez Sarsfield,Primera Division,24.8,58,38,36,18,4,31,53,58.5,22,29,5,24,26,84,55,1
Lautaro Gianetti,ARG,DF,29,Vélez Sarsfield,Primera Division,19.0,34,22,27,7,0,19,29,65.5,10,27,16,11,45,79,97,0
Leonardo Burián,URU,GK,39,Vélez Sarsfield,Primera Division,18.5,0,0,0,0,0,0,1,0.0,1,0,0,0,1,1,3,0
Jose Florentín,PAR,MF,26,Vélez Sarsfield,Primera Division,16.6,37,24,18,16,3,20,60,33.3,40,27,3,24,33,70,24,0
Tomás Guidara,ARG,DF,26,Vélez Sarsfield,Primera Division,16.1,49,30,31,17,1,27,47,57.4,20,19,5,14,21,70,38,0
Abiel Osorio,ARG,FW,20,Vélez Sarsfield,Primera Division,16.0,12,8,2,7,3,3,9,33.3,6,18,1,17,1,13,7,0
Miguel Brizuela,ARG,DF,26,Vélez Sarsfield,Primera Division,14.6,23,13,17,6,0,14,21,66.7,7,16,10,6,22,45,49,0
Lucas Janson,ARG,FW,28,Vélez Sarsfield,Primera Division,14.2,8,5,1,6,1,1,19,5.3,18,12,4,8,7,15,10,0
Lucas Pratto,ARG,"MF,FW",34,Vélez Sarsfield,Primera Division,14.0,18,11,5,8,5,5,16,31.3,11,18,2,16,2,20,30,1
Christian Ordoñez,ARG,MF,18,Vélez Sarsfield,Primera Division,12.2,26,18,11,14,1,17,37,45.9,20,28,6,22,18,44,15,0
Gianluca Prestianni,ARG,"FW,MF",17,Vélez Sarsfield,Primera Division,14.6,13,10,3,9,1,7,25,28.0,18,20,2,18,13,26,3,0
Diego Godín,URU,DF,36,Vélez Sarsfield,Primera Division,12.8,25,17,20,4,1,10,14,71.4,4,13,10,3,28,53,49,0
Valentín Gómez,ARG,DF,19,Vélez Sarsfield,Primera Division,12.4,25,15,16,9,0,14,24,58.3,10,13,5,8,20,45,46,0
Walter Bou,ARG,"FW,MF",29,Vélez Sarsfield,Primera Division,10.6,26,14,6,16,4,9,22,40.9,13,16,3,13,5,31,7,0
Elías Cabrera,ARG,MF,19,Vélez Sarsfield,Primera Division,12.8,22,14,5,13,4,5,24,20.8,19,19,1,18,6,28,5,0
Juan Ignacio Méndez,ARG,MF,25,Vélez Sarsfield,Primera Division,9.4,26,17,7,18,1,12,22,54.5,10,8,0,8,3,29,14,0
Gastón Gómez,ARG,GK,26,Vélez Sarsfield,Primera Division,8.5,0,0,0,0,0,0,2,0.0,2,0,0,0,0,0,3,0
Leonardo Jara,ARG,"DF,MF",31,Vélez Sarsfield,Primera Division,7.0,26,20,20,6,0,20,27,74.1,7,8,2,6,10,36,18,0
Damián Fernández,ARG,"MF,DF",22,Vélez Sarsfield,Primera Division,6.1,22,12,7,12,3,10,20,50.0,10,10,2,8,6,28,22,0
Julián Fernández,ARG,"FW,MF",19,Vélez Sarsfield,Primera Division,7.1,12,7,4,6,2,8,20,40.0,12,9,1,8,6,18,5,1
Roberto Joaquín García,ARG,DF,21,Vélez Sarsfield,Primera Division,6.6,15,10,5,8,2,7,14,50.0,7,10,0,10,5,20,15,0
Santiago Castro,ARG,"FW,MF",18,Vélez Sarsfield,Primera Division,7.1,9,3,1,6,2,4,16,25.0,12,6,0,6,1,10,13,0
Nicolás Garayalde,ARG,MF,23,Vélez Sarsfield,Primera Division,4.9,13,10,5,7,1,10,25,40.0,15,12,2,10,12,25,6,0
Mateo Seoane,ARG,MF,18,Vélez Sarsfield,Primera Division,4.6,10,6,1,8,1,6,12,50.0,6,11,1,10,8,18,8,0
Lenny Lobato,BRA,"FW,MF",21,Vélez Sarsfield,Primera Division,3.6,7,5,4,2,1,4,12,33.3,8,4,0,4,3,10,0,0
Thiago Fernández,ARG,"FW,MF",18,Vélez Sarsfield,Primera Division,1.3,3,1,2,0,1,2,4,50.0,2,4,0,4,0,3,3,0
Patricio Pernicone,ARG,DF,21,Vélez Sarsfield,Primera Division,1.1,1,1,1,0,0,0,1,0.0,1,2,0,2,0,1,2,0
Lucas Chávez,ARG,GK,27,Huracán,Primera Division,25.0,2,1,2,0,0,2,2,100.0,0,0,0,0,2,4,10,0
Santiago Hezze,ARG,MF,21,Huracán,Primera Division,23.6,64,43,27,31,6,32,70,45.7,38,31,4,27,57,121,32,0
Guillermo Benítez,ARG,DF,29,Huracán,Primera Division,21.9,60,36,28,27,5,26,54,48.1,28,32,5,27,26,86,48,1
Matías Cóccaro,URU,FW,25,Huracán,Primera Division,18.2,17,10,1,5,11,7,21,33.3,14,9,0,9,4,21,10,0
Fernando Tobio,ARG,DF,33,Huracán,Primera Division,18.6,25,11,20,5,0,13,18,72.2,5,14,9,5,24,49,75,0
Guillermo Soto,CHI,DF,29,Huracán,Primera Division,18.4,52,38,27,19,6,28,46,60.9,18,21,5,16,24,76,41,0
Federico Fattori,ARG,MF,30,Huracán,Primera Division,18.3,35,20,14,20,1,22,37,59.5,15,20,4,16,30,65,28,0
Juan Gauto,ARG,"MF,FW",18,Huracán,Primera Division,18.4,25,18,10,10,5,12,33,36.4,21,16,0,16,8,33,4,0
Joaquín Ariel Novillo,ARG,DF,24,Huracán,Primera Division,16.7,17,7,9,8,0,11,21,52.4,10,16,8,8,21,38,54,1
Nicolás Cordero,ARG,FW,23,Huracán,Primera Division,13.2,15,9,2,5,8,4,16,25.0,12,12,2,10,0,15,15,0
Walter Mazzantti,ARG,"FW,MF",26,Huracán,Primera Division,11.4,18,11,7,8,3,6,29,20.7,23,35,2,33,6,24,2,0
Jonás Acevedo,ARG,"MF,FW",25,Huracán,Primera Division,9.4,15,8,4,8,3,6,21,28.6,15,12,0,12,5,20,1,0
Gabriel Gudiño,ARG,"MF,FW",30,Huracán,Primera Division,8.7,26,14,13,8,5,11,23,47.8,12,16,3,13,12,38,6,0
Gastón Sauro,ARG,DF,32,Huracán,Primera Division,8.5,8,6,4,4,0,5,9,55.6,4,8,5,3,15,23,32,0
Fernando Torrent,ARG,DF,31,Huracán,Primera Division,7.5,7,6,4,3,0,6,15,40.0,9,8,2,6,3,10,20,0
Fernando Godoy,ARG,MF,32,Huracán,Primera Division,7.0,12,4,5,7,0,5,15,33.3,10,9,4,5,10,22,12,0
Matías Gómez,ARG,"MF,FW",19,Huracán,Primera Division,5.4,21,11,3,13,5,7,23,30.4,16,11,1,10,5,26,4,0
Lucas Castro,ARG,"MF,FW",33,Huracán,Primera Division,6.7,11,9,2,7,2,7,13,53.8,6,5,0,5,5,16,4,0
Lucas Carrizo,ARG,DF,25,Huracán,Primera Division,6.4,24,17,21,3,0,13,17,76.5,4,8,1,7,7,31,20,0
Patricio Pizarro,ARG,DF,22,Huracán,Primera Division,6.4,9,6,6,3,0,6,14,42.9,8,3,2,1,9,18,32,0
Juan Manuel García,ARG,"FW,MF",30,Huracán,Primera Division,5.9,12,8,2,7,3,2,4,50.0,2,8,0,8,0,12,6,0
César Ibáñez,ARG,DF,23,Huracán,Primera Division,3.8,16,14,12,3,1,11,17,64.7,6,7,0,7,4,20,8,0
Agostino Spina,ARG,MF,21,Huracán,Primera Division,3.4,6,4,2,4,0,2,9,22.2,7,3,2,1,10,16,8,0
Valentín Burgoa,ARG,"FW,MF",23,Huracán,Primera Division,3.7,9,6,1,8,0,5,10,50.0,5,6,0,6,8,17,2,0
Santiago Luján,ARG,"MF,FW",21,Huracán,Primera Division,2.6,9,6,2,7,0,7,11,63.6,4,0,0,0,1,10,1,0
Dante Campisi,ARG,GK,26,Huracán,Primera Division,2.0,0,0,0,0,0,0,0,0.0,0,0,0,0,0,0,3,1
Juan Fernando Garro,ARG,"MF,FW",30,Huracán,Primera Division,3.0,2,1,1,1,0,1,5,20.0,4,1,0,1,1,3,1,0
Lucas Merolla,ARG,DF,27,Huracán,Primera Division,1.0,1,1,1,0,0,1,2,50.0,1,2,2,0,0,1,7,0
Valentin Sanchez,ARG,MF,20,Huracán,Primera Division,0.6,3,2,0,2,1,0,0,0.0,0,1,0,1,2,5,0,0
Enzo Luna,ARG,"MF,FW",20,Huracán,Primera Division,0.4,0,0,0,0,0,0,1,0.0,1,3,0,3,0,0,0,0
Ignacio Chicco,ARG,GK,26,Colón,Primera Division,27.0,1,1,1,0,0,1,2,50.0,1,0,0,0,0,1,11,1
Facundo Garcés,ARG,DF,23,Colón,Primera Division,26.0,60,36,35,25,0,33,52,63.5,19,44,17,27,31,91,110,0
Santiago Pierotti,ARG,"FW,MF",21,Colón,Primera Division,23.5,58,32,12,28,18,21,57,36.8,36,39,2,37,8,66,15,0
Paolo Goltz,ARG,DF,37,Colón,Primera Division,22.2,33,17,24,8,1,18,33,54.5,15,30,13,17,26,59,102,0
Eric Meza,ARG,"DF,FW",23,Colón,Primera Division,20.8,49,30,34,11,4,25,55,45.5,30,19,3,16,33,82,20,0
Baldomero Perlaza,COL,MF,30,Colón,Primera Division,21.1,47,28,14,30,3,21,50,42.0,29,24,9,15,22,69,30,0
Rafael Marcelo Delgado,ARG,DF,33,Colón,Primera Division,20.0,45,26,25,17,3,27,49,55.1,22,43,11,32,22,67,64,1
Ramón Ábila,ARG,FW,33,Colón,Primera Division,17.5,4,4,0,2,2,2,7,28.6,5,8,3,5,5,9,7,0
Juan Álvarez,ARG,"MF,FW",26,Colón,Primera Division,15.2,19,11,8,6,5,13,38,34.2,25,21,1,20,19,38,13,0
Gian Nardelli,ARG,DF,22,Colón,Primera Division,13.3,16,10,12,4,0,10,18,55.6,8,18,6,12,17,33,69,1
Carlos Arrua,PAR,MF,25,Colón,Primera Division,11.2,18,10,5,11,2,7,28,25.0,21,12,0,12,5,23,2,0
Julián Chicco,ARG,MF,25,Colón,Primera Division,10.6,25,15,11,10,4,13,25,52.0,12,16,2,14,17,42,14,0
Cristian Vega,ARG,MF,29,Colón,Primera Division,10.0,38,24,21,16,1,19,34,55.9,15,21,3,18,15,53,12,1
Stéfano Moreyra,ARG,MF,21,Colón,Primera Division,7.2,20,9,4,14,2,13,25,52.0,12,16,3,13,18,38,8,0
Jorge Benítez,PAR,FW,30,Colón,Primera Division,8.0,10,7,2,6,2,2,14,14.3,12,8,1,7,2,12,10,0
Leonel Picco,ARG,MF,23,Colón,Primera Division,6.2,33,20,13,13,7,18,32,56.3,14,20,3,17,12,45,12,0
Andrew Teuten,URU,"DF,MF",24,Colón,Primera Division,5.6,10,9,8,2,0,7,13,53.8,6,3,0,3,7,17,11,0
Facundo Farías,ARG,"FW,MF",20,Colón,Primera Division,5.1,2,1,0,2,0,0,4,0.0,4,3,0,3,1,3,0,0
Joaquín Ibáñez,ARG,"FW,MF",26,Colón,Primera Division,5.0,6,5,3,3,0,4,9,44.4,5,9,0,9,1,7,7,1
Tomás Galván,ARG,"MF,FW",22,Colón,Primera Division,5.9,8,7,3,5,0,3,12,25.0,9,9,1,8,3,11,1,0
José Neris,URU,FW,22,Colón,Primera Division,4.3,4,4,1,2,1,2,2,100.0,0,0,0,0,0,4,0,0
Augusto Schott,ARG,DF,23,Colón,Primera Division,3.8,3,2,2,1,0,1,6,16.7,5,4,0,4,7,10,13,0
Lucas Acevedo,ARG,DF,31,Colón,Primera Division,2.1,4,3,4,0,0,2,4,50.0,2,3,3,0,0,4,23,1
Natanael Troncoso,ARG,"MF,FW",21,Colón,Primera Division,3.2,11,8,1,9,1,6,14,42.9,8,5,1,4,1,12,3,0
Thiago Yossen,ARG,DF,18,Colón,Primera Division,0.4,1,1,1,0,0,0,0,0.0,0,0,0,0,2,3,2,0
Gonzalo Silva,ARG,"DF,MF",23,Colón,Primera Division,0.6,1,1,1,0,0,0,1,0.0,1,0,0,0,0,1,1,0
Guillermo Gonzálvez,ARG,MF,19,Colón,Primera Division,0.2,1,1,0,0,1,1,1,100.0,0,0,0,0,0,1,0,0
Facundo Taborda,ARG,"FW,MF",22,Colón,Primera Division,0.2,1,1,0,1,0,0,1,0.0,1,2,0,2,0,1,0,0
Alejandro Medina,ARG,GK,35,Arsenal,Primera Division,27.0,1,1,1,0,0,1,1,100.0,0,1,1,0,0,1,11,4
Adrián Sporle,ARG,DF,27,Arsenal,Primera Division,22.8,62,35,34,20,8,31,58,53.4,27,38,7,31,34,96,54,0
Felipe Peña,ARG,MF,21,Arsenal,Primera Division,21.2,36,29,18,17,1,13,48,27.1,35,32,9,23,25,61,42,1
Lautaro Guzmán,ARG,"FW,MF",23,Arsenal,Primera Division,20.8,23,12,13,6,4,9,41,22.0,32,18,2,16,12,35,8,0
Lucas Souto,ARG,DF,24,Arsenal,Primera Division,20.7,53,38,29,17,7,29,39,74.4,10,18,4,14,19,72,64,0
Joaquín Pombo,ARG,DF,21,Arsenal,Primera Division,18.9,44,28,36,8,0,22,44,50.0,22,23,9,14,41,85,85,0
Maximiliano Centurión,ARG,DF,23,Arsenal,Primera Division,19.6,26,18,18,8,0,19,29,65.5,10,32,15,17,26,52,118,2
Santiago Toloza,ARG,"MF,FW",20,Arsenal,Primera Division,18.3,15,9,3,10,2,2,20,10.0,18,12,1,11,6,21,5,0
Néstor Breitenbruch,ARG,DF,27,Arsenal,Primera Division,16.9,43,22,30,11,2,23,45,51.1,22,29,13,16,12,55,50,0
Flabián Londoño,COL,"FW,MF",22,Arsenal,Primera Division,12.8,13,9,2,8,3,2,17,11.8,15,14,0,14,3,16,17,0
Gonzalo Muscia,ARG,MF,23,Arsenal,Primera Division,12.7,35,22,22,11,2,16,37,43.2,21,21,5,16,17,52,21,0
Tiago Banega,ARG,MF,23,Arsenal,Primera Division,10.9,34,24,7,26,1,6,28,21.4,22,20,4,16,11,45,9,0
Lucas Brochero,ARG,"FW,MF",24,Arsenal,Primera Division,10.3,17,8,10,4,3,6,13,46.2,7,15,0,15,7,24,9,0
Facundo Pons,ARG,FW,27,Arsenal,Primera Division,10.1,7,5,3,2,2,0,8,0.0,8,10,1,9,1,8,12,0
Braian Rivero,ARG,MF,26,Arsenal,Primera Division,9.6,25,10,9,14,2,13,35,37.1,22,10,4,6,13,38,3,0
Luís Leal,STP,FW,35,Arsenal,Primera Division,9.6,1,1,0,0,1,0,4,0.0,4,8,4,4,0,1,13,0
Ignacio Gariglio,ARG,DF,24,Arsenal,Primera Division,8.2,19,10,14,4,1,9,15,60.0,6,8,4,4,13,32,45,0
Facundo Cardozo,ARG,DF,27,Arsenal,Primera Division,7.1,15,9,10,5,0,8,15,53.3,7,9,2,7,7,22,33,1
Franco Vega,ARG,"MF,FW",21,Arsenal,Primera Division,4.2,9,4,3,4,2,7,13,53.8,6,6,1,5,1,10,0,0
Juan Cuesta,COL,"MF,FW",20,Arsenal,Primera Division,3.8,4,3,1,1,2,2,5,40.0,3,3,0,3,3,7,7,0
Santiago Paiva,URU,"FW,MF",24,Arsenal,Primera Division,2.7,5,3,0,3,2,3,4,75.0,1,0,0,0,1,6,2,0
Daniel Lucero,ARG,"FW,MF",20,Arsenal,Primera Division,2.5,5,3,1,3,1,3,5,60.0,2,8,1,7,0,5,0,0
Leonardo Marchi,ARG,DF,26,Arsenal,Primera Division,1.6,2,1,2,0,0,0,2,0.0,2,1,1,0,1,3,3,0
Tomás Sives,ARG,"MF,FW",20,Arsenal,Primera Division,1.2,6,4,2,4,0,4,6,66.7,2,1,0,1,1,7,0,0
Juan Peinipil,ARG,"FW,MF",21,Arsenal,Primera Division,1.1,1,1,0,1,0,0,3,0.0,3,2,0,2,0,1,0,0
Tobías Zarate,ARG,"MF,FW",22,Arsenal,Primera Division,0.6,0,0,0,0,0,0,0,0.0,0,1,0,1,0,0,0,0
Emiliano Viveros,ARG,MF,20,Arsenal,Primera Division,0.2,0,0,0,0,0,0,0,0.0,0,0,0,0,0,0,0,0
Aaron Bibout,CMR,FW,18,LA Galaxy,MLS,0.3,0,0,0,0,0,0,0,0.0,0,0,0,0,0,0,0,0
Aaron Boupendza,GAB,FW,26,FC Cincinnati,MLS,6.7,7,4,0,5,2,2,6,33.3,4,13,0,13,1,8,1,0
Aaron Connolly,IRL,FW,23,Hull City,EFL,13.5,6,4,2,3,1,0,4,0.0,4,5,0,5,3,9,4,0
Aaron Drewe,ENG,DF,22,QPR,EFL,1.0,3,1,2,0,1,2,4,50.0,2,2,0,2,1,4,5,0
Aaron Herrera,GUA,"DF,MF",25,CF Montréal,MLS,15.6,30,21,14,11,5,7,19,36.8,12,20,5,15,14,44,31,0
Aaron Long,USA,DF,30,LAFC,MLS,16.9,30,20,18,10,2,11,13,84.6,2,20,9,11,20,50,75,0
Aaron Mejía Montoya,MEX,DF,22,Tijuana,Liga MX,7.9,20,16,7,10,3,9,16,56.3,7,5,2,3,6,26,21,0
Aaron Opoku,GER,"FW,MF",24,Kaiserslautern,2. Bundesliga,9.9,4,3,3,1,0,1,19,5.3,18,17,1,16,4,8,7,0
Aaron Ramsey,WAL,"MF,FW",32,Cardiff City,EFL,8.0,15,9,7,6,2,2,6,33.3,4,8,2,6,5,20,3,0
Aaron Zehnter,GER,"DF,MF",18,Paderborn 07,2. Bundesliga,10.7,15,8,7,8,0,12,20,60.0,8,14,2,12,13,28,24,0
Abdallah N'dour,SEN,DF,29,Guingamp,Ligue 2,6.7,8,6,5,3,0,5,8,62.5,3,14,5,9,5,13,15,0
Abdel Abdallah,COM,"DF,FW",25,Rodez Aveyron,Ligue 2,25.6,33,19,15,15,3,18,37,48.6,19,22,8,14,27,60,37,0
Abdelwahed Wahib,MAR,DF,23,US Concarneau,Ligue 2,8.4,27,18,12,12,3,15,26,57.7,11,12,5,7,12,39,20,0
Abdi Salim,SOM,DF,21,Orlando City,MLS,1.6,4,2,2,1,1,3,3,100.0,0,2,1,1,4,8,3,0
Abdoul Guiebre,BFA,DF,26,Bari,Serie B,1.1,3,2,2,1,0,2,2,100.0,0,0,0,0,1,4,4,0
Abdoul Guiebre,BFA,DF,26,Modena,Serie B,4.3,11,5,2,4,5,2,3,66.7,1,10,2,8,6,17,7,2
Abdoul-Fessal Tapsoba,BFA,"FW,MF",21,Amiens,Ligue 2,5.6,17,7,7,8,2,4,12,33.3,8,9,0,9,4,21,5,0
Abdoulaye Bamba,CIV,DF,33,Angers,Ligue 2,32.1,27,16,17,10,0,14,24,58.3,10,30,19,11,31,58,105,1
Abdoulaye Cissoko,FRA,DF,23,Seattle,MLS,1.0,1,0,0,0,1,0,0,0.0,0,0,0,0,0,1,1,0
Abdoulaye Kanté,FRA,MF,18,Troyes,Ligue 2,17.3,45,31,19,22,4,26,44,59.1,18,18,2,16,27,72,24,1
Abdoulaye Niakhate Ndiaye,SEN,DF,21,Troyes,Ligue 2,31.0,59,43,44,14,1,26,50,52.0,24,64,42,22,42,101,165,3
Abdoulie Sanyang,GAM,"FW,MF",24,Grenoble,Ligue 2,14.3,28,19,17,9,2,15,29,51.7,14,11,0,11,9,37,4,0
Abdoullah Ba,FRA,"MF,FW",20,Sunderland,EFL,21.4,17,13,5,10,2,8,17,47.1,9,9,1,8,11,28,7,0
Abdu Conté,POR,DF,25,Troyes,Ligue 2,16.5,29,19,15,10,4,18,25,72.0,7,24,1,23,13,42,26,0
Abdul Fatawu Issahaku,GHA,FW,19,Leicester City,EFL,31.3,61,42,33,16,12,27,51,52.9,24,40,7,33,20,81,39,0
Abdülkadir Ömür,TUR,"MF,FW",24,Hull City,EFL,11.0,29,20,11,14,4,13,23,56.5,10,12,0,12,9,38,6,0
Abel,ESP,DF,23,Oviedo,Segunda Division,36.1,85,55,49,25,11,54,100,54.0,46,54,4,50,35,120,73,0
Aboubakary Kanté,GAM,"FW,MF",29,Huesca,Segunda Division,4.0,4,3,0,2,2,1,2,50.0,1,2,0,2,2,6,0,0
Abraham Bass,MEX,"MF,FW",21,Atlas,Liga MX,4.4,9,6,4,4,1,3,7,42.9,4,6,1,5,7,16,6,0
Abraham Flores,MEX,DF,21,Tijuana,Liga MX,0.3,0,0,0,0,0,0,0,0.0,0,1,1,0,0,0,2,1
Abraham Rando,ESP,DF,22,Villarreal B,Segunda Division,12.3,27,16,19,8,0,15,23,65.2,8,18,9,9,20,47,55,0
Abraham Rodriguez,USA,GK,20,Rapids,MLS,1.0,0,0,0,0,0,0,0,0.0,0,0,0,0,0,0,1,0
Abraham Villegas,MEX,DF,20,Toluca,Liga MX,3.7,19,13,15,4,0,8,16,50.0,8,5,2,3,1,20,5,0
Achraf Laaziri,MAR,"FW,MF",19,Dunkerque,Ligue 2,8.7,12,11,10,1,1,8,16,50.0,8,12,1,11,5,17,3,0
Adalberto Carrasquilla,PAN,"FW,MF",24,Dynamo FC,MLS,22.6,11,7,3,7,1,4,28,14.3,24,19,2,17,9,20,13,0
Adam Armstrong,ENG,"FW,MF",26,Southampton,EFL,41.6,25,16,8,8,9,13,28,46.4,15,30,3,27,9,34,23,0
Adam Boayar,ESP,"FW,DF",18,Elche,Segunda Division,2.5,7,4,1,6,0,0,2,0.0,2,5,0,5,1,8,3,0
Adam Dźwigała,POL,"DF,MF",27,St. Pauli,2. Bundesliga,8.2,21,11,15,6,0,13,23,56.5,10,10,4,6,17,38,24,1
Adam Forshaw,ENG,"MF,FW",31,Norwich City,EFL,2.1,8,3,4,4,0,2,6,33.3,4,0,0,0,5,13,0,0
Adam Forshaw,ENG,MF,31,Plymouth Argyle,EFL,7.2,15,11,6,9,0,6,19,31.6,13,11,3,8,11,26,8,1
Adam Idah,IRL,FW,22,Norwich City,EFL,14.2,6,5,1,4,1,0,6,0.0,6,13,1,12,3,9,14,0
Adam Lundqvist,SWE,"DF,MF",28,Austin,MLS,9.6,29,15,16,10,3,17,33,51.5,16,17,4,13,12,41,22,0
Adam Mayor,ENG,"MF,FW",18,Millwall,EFL,0.6,1,1,0,1,0,1,2,50.0,1,0,0,0,0,1,0,0
Adam Pearlman,CAN,DF,17,Toronto FC,MLS,0.1,1,0,1,0,0,0,0,0.0,0,1,0,1,0,1,0,1
Adam Randell,ENG,MF,22,Plymouth Argyle,EFL,30.7,48,34,18,23,7,22,44,50.0,22,39,18,21,34,82,44,1
Adam Reach,ENG,"DF,MF",30,West Brom,EFL,7.1,14,9,8,5,1,8,14,57.1,6,15,5,10,9,23,14,0
Adam Wharton,ENG,MF,19,Blackburn,EFL,21.7,60,36,27,21,12,26,66,39.4,40,30,6,24,32,92,17,1
Adama Camara,FRA,MF,26,Paris FC,Ligue 2,25.9,94,59,34,42,18,46,71,64.8,25,50,9,41,35,129,19,0
Adama Diomande,NOR,FW,32,Toronto FC,MLS,1.8,0,0,0,0,0,0,3,0.0,3,1,0,1,0,0,2,0
Adama Traoré,MLI,"FW,MF",28,Hull City,EFL,11.9,13,8,3,6,4,6,22,27.3,16,21,2,19,12,25,17,0
Adel Lembezat,FRA,"FW,MF",24,Pau FC,Ligue 2,0.5,0,0,0,0,0,0,3,0.0,3,0,0,0,0,0,0,0
Adil Aouchiche,FRA,"MF,FW",21,Sunderland,EFL,12.2,25,16,7,9,9,9,25,36.0,16,11,0,11,10,35,6,0
Adilson Malanda,FRA,DF,21,Charlotte,MLS,28.5,39,24,27,11,1,23,37,62.2,14,40,23,17,32,71,116,2
Ado Onaiwu,JPN,FW,27,Auxerre,Ligue 2,21.1,14,6,3,8,3,5,16,31.3,11,10,1,9,7,21,21,0
Adonis Frías,ARG,"DF,MF",25,León,Liga MX,30.2,53,34,34,16,3,29,47,61.7,18,38,25,13,35,88,102,1
Adrian Baquerin,ESP,"FW,MF",17,Valladolid,Segunda Division,0.8,1,0,0,0,1,1,2,50.0,1,2,0,2,0,1,1,0
Adrian Benedyczak,POL,FW,22,Parma,Serie B,20.3,17,11,2,10,5,8,18,44.4,10,19,0,19,15,32,23,0
Adrian Bernabe,ESP,MF,22,Parma,Serie B,28.8,56,29,18,27,11,25,44,56.8,19,24,3,21,21,77,18,1
Adrian Šemper,CRO,GK,25,Como,Serie B,37.8,0,0,0,0,0,0,2,0.0,2,0,0,0,0,0,13,1
Adriano Grimaldi,GER,"FW,MF",32,Paderborn 07,2. Bundesliga,14.5,15,7,1,10,4,1,8,12.5,7,17,2,15,5,20,12,0
Adrien Hunou,FRA,"FW,MF",29,Angers,Ligue 2,3.1,7,2,4,3,0,2,7,28.6,5,6,0,6,2,9,2,0
Adrien Monfray,FRA,DF,32,Grenoble,Ligue 2,26.5,64,39,47,16,1,40,59,67.8,19,34,18,16,51,115,140,1
Adrià Altimira,ESP,"DF,MF",23,Villarreal B,Segunda Division,25.2,55,33,35,14,6,25,46,54.3,21,20,3,17,22,77,44,0
Adrià Vilanova,ESP,DF,27,FC Andorra,Segunda Division,16.8,19,11,12,6,1,8,18,44.4,10,13,6,7,15,34,47,2
Adrián Aldrete,MEX,DF,35,UNAM,Liga MX,19.3,27,21,18,7,2,16,29,55.2,13,27,2,25,29,56,56,1
Adrián Liso,ESP,"FW,MF",19,Zaragoza,Segunda Division,8.1,14,8,6,5,3,4,13,30.8,9,7,0,7,6,20,2,0
Adrián Mora,MEX,DF,25,Toluca,Liga MX,2.4,1,0,1,0,0,1,2,50.0,1,4,3,1,5,6,8,0
Adrián de la Fuente,ESP,DF,25,Levante,Segunda Division,28.8,33,17,18,15,0,13,23,56.5,10,38,24,14,46,79,148,1
Ager Aketxe,ESP,"FW,MF",30,Eibar,Segunda Division,30.8,53,36,16,26,11,27,70,38.6,43,34,3,31,18,71,20,0
Agus Medina,ESP,MF,29,Albacete,Segunda Division,29.0,77,43,32,36,9,39,89,43.8,50,43,8,35,37,114,35,0
Agustín Oliveros,URU,DF,24,Necaxa,Liga MX,20.7,24,18,15,8,1,13,24,54.2,11,21,9,12,20,44,64,1
Agustín Urzi,ARG,"MF,FW",23,FC Juárez,Liga MX,3.8,12,5,6,3,3,6,12,50.0,6,5,0,5,8,20,0,0
Agustín Álvarez Martínez,URU,"FW,MF",22,Sampdoria,Serie B,8.6,5,3,1,4,0,1,4,25.0,3,7,1,6,2,7,3,0
Ahmad Benali,LBY,MF,31,Bari,Serie B,24.3,58,43,26,26,6,36,68,52.9,32,36,12,24,34,92,45,0
Ahmad Ngouyamsa,CMR,DF,22,Rodez Aveyron,Ligue 2,20.5,52,33,31,17,4,34,56,60.7,22,27,6,21,24,76,44,0
Ahmed Hamdi,EGY,"MF,FW",24,CF Montréal,MLS,5.3,16,5,7,7,2,3,11,27.3,8,7,0,7,1,17,4,0
Ahmed Kashi,ALG,MF,34,Annecy,Ligue 2,20.7,55,43,22,28,5,28,48,58.3,20,19,11,8,16,71,32,0
Ahmet Arslan,GER,"MF,FW",29,Magdeburg,2. Bundesliga,2.8,4,3,2,1,1,2,7,28.6,5,3,0,3,2,6,2,0
Ahmet Gürleyen,GER,DF,24,Nürnberg,2. Bundesliga,10.6,12,7,8,4,0,5,7,71.4,2,18,11,7,14,26,71,0
Aidan Dausch,ENG,"MF,FW",17,Coventry City,EFL,0.1,0,0,0,0,0,0,0,0.0,0,0,0,0,0,0,0,0
Aidan Morris,USA,MF,21,Crew,MLS,28.7,98,58,36,49,13,34,97,35.1,63,33,3,30,44,142,11,0
Aidomo Emakhu,IRL,"MF,FW",19,Millwall,EFL,7.4,19,13,9,5,5,9,15,60.0,6,6,0,6,2,21,4,1
Aimar Govea,ECU,"FW,MF",17,Swansea City,EFL,0.8,0,0,0,0,0,0,0,0.0,0,1,0,1,0,0,0,0
Aimen Moueffek,FRA,MF,22,Saint-Étienne,Ligue 2,20.8,39,26,17,18,4,12,25,48.0,13,30,4,26,18,57,13,0
Aimé Mabika,ZAM,DF,24,Toronto FC,MLS,16.8,25,19,21,4,0,11,17,64.7,6,36,28,8,11,36,61,1
Aitor Buñuel,ESP,DF,26,Tenerife,Segunda Division,17.1,24,20,12,10,2,14,31,45.2,17,19,5,14,19,43,54,0
Aitor Córdoba,ESP,DF,29,Burgos,Segunda Division,40.2,55,33,37,17,1,29,34,85.3,5,46,31,15,72,127,156,1
Aitor García,ESP,"FW,MF",29,FC Juárez,Liga MX,26.1,24,16,8,12,4,10,33,30.3,23,13,1,12,18,42,11,0
Aitor Gelardo,ESP,MF,21,Villarreal B,Segunda Division,12.3,34,16,10,21,3,20,37,54.1,17,23,5,18,11,45,22,1
Aitor Sanz,ESP,MF,39,Tenerife,Segunda Division,18.4,51,31,20,26,5,27,48,56.3,21,29,11,18,28,79,45,0
Ajani Fortune,TRI,MF,20,Atlanta Utd,MLS,4.2,8,2,2,5,1,3,7,42.9,4,3,2,1,4,12,5,1
Ajay Matthews,ENG,FW,17,Middlesbrough,EFL,0.1,0,0,0,0,0,0,0,0.0,0,0,0,0,0,0,1,0
Ajibola Alese,ENG,DF,22,Sunderland,EFL,5.1,10,9,6,3,1,4,7,57.1,3,7,1,6,6,16,13,0
Akil Watts,USA,"DF,MF",22,St. Louis,MLS,9.8,31,18,18,9,4,14,29,48.3,15,8,2,6,14,45,26,0
Akim Djibril,ITA,MF,17,Cittadella,Serie B,0.2,0,0,0,0,0,0,0,0.0,0,0,0,0,0,0,0,0
Akim Zedadka,ALG,DF,29,Zaragoza,Segunda Division,7.6,17,8,10,5,2,13,17,76.5,4,10,2,8,12,29,26,0
Akin Famewo,ENG,DF,24,Sheffield Weds,EFL,29.2,60,41,29,23,8,35,53,66.0,18,43,16,27,41,101,80,0
Akpa Chukwu Hemsley,ITA,"FW,MF",18,Bari,Serie B,0.3,0,0,0,0,0,0,0,0.0,0,0,0,0,0,0,0,0
Al Hassan Toure,AUS,"MF,FW",23,Ajaccio,Ligue 2,2.5,2,2,1,1,0,1,2,50.0,1,2,0,2,0,2,1,0
Alain Ipiélé,CGO,"FW,MF",25,Dunkerque,Ligue 2,5.0,2,0,1,1,0,1,4,25.0,3,4,0,4,4,6,1,0
Alan Browne,IRL,"MF,DF",28,Preston,EFL,35.2,76,49,35,30,11,40,81,49.4,41,53,14,39,54,130,56,3
Alan Cervantes,MEX,MF,25,Santos,Liga MX,29.5,40,24,17,20,3,16,45,35.6,29,37,16,21,22,62,33,3
Alan Do Marcolino,GAB,"FW,MF",21,Quevilly-Rouen,Ligue 2,3.1,2,2,1,1,0,1,5,20.0,4,0,0,0,1,3,3,0
Alan Godoy,ESP,FW,21,CD Mirandés,Segunda Division,4.0,4,1,0,2,2,2,5,40.0,3,4,0,4,0,4,7,0
Alan Medina,URU,"FW,MF",25,León,Liga MX,10.5,23,16,10,11,2,14,33,42.4,19,17,1,16,4,27,7,0
Alan Medina,MEX,"FW,MF",25,Mazatlán,Liga MX,11.7,20,12,6,11,3,6,18,33.3,12,3,0,3,12,32,2,1
Alan Mozo,MEX,DF,26,Guadalajara,Liga MX,29.6,94,54,44,39,11,52,90,57.8,38,23,6,17,25,119,45,1
Alan Pulido,MEX,FW,31,Sporting KC,MLS,24.5,13,7,4,5,4,1,10,10.0,9,7,2,5,4,17,11,0
Alan Torres,MEX,MF,23,Guadalajara,Liga MX,2.5,2,1,1,1,0,1,4,25.0,3,9,4,5,3,5,3,0
Alan Velasco,ARG,"FW,MF",20,FC Dallas,MLS,25.1,45,29,25,13,7,19,60,31.7,41,23,0,23,20,65,14,0
Alan Zubiri,MEX,DF,22,Cruz Azul,Liga MX,1.0,1,1,1,0,0,1,1,100.0,0,0,0,0,3,4,6,0
Alassán,ESP,"FW,MF",21,Tenerife,Segunda Division,2.1,4,3,2,0,2,3,5,60.0,2,6,0,6,1,5,0,0
Albert Adomah,GHA,"DF,FW",35,QPR,EFL,4.1,20,9,10,7,3,6,15,40.0,9,5,0,5,3,23,8,0
Albert Eames,ENG,DF,17,Watford,EFL,0.0,1,1,1,0,0,1,1,100.0,0,0,0,0,0,1,0,0
Albert Rusnák,SVK,"MF,FW",28,Seattle,MLS,29.1,18,8,6,8,4,7,30,23.3,23,13,2,11,22,40,5,0
Alberth Elis,HON,FW,27,Bordeaux,Ligue 2,11.7,12,7,2,7,3,5,9,55.6,4,11,2,9,4,16,4,0
Alberto Cerri,ITA,FW,27,Como,Serie B,2.0,2,1,1,1,0,2,2,100.0,0,1,1,0,0,2,0,0
Alberto Del Moral,ESP,MF,23,Villarreal B,Segunda Division,19.3,43,27,21,21,1,22,45,48.9,23,25,7,18,15,58,44,1
Alberto García Jr.,MEX,"MF,FW",29,Querétaro,Liga MX,0.2,0,0,0,0,0,0,1,0.0,1,1,0,1,0,0,0,0
Alberto Herrera,MEX,"MF,DF",22,Puebla,Liga MX,8.2,17,11,10,7,0,13,19,68.4,6,16,2,14,8,25,14,0
Alberto Ocejo,MEX,FW,25,Santos,Liga MX,5.1,5,3,1,3,1,3,4,75.0,1,3,2,1,1,6,2,0
Alberto Quiles,ESP,"FW,MF",29,Albacete,Segunda Division,26.6,25,15,6,14,5,6,17,35.3,11,15,1,14,7,32,25,1
Alberto Quintana,ESP,DF,22,Valladolid,Segunda Division,2.8,3,1,2,1,0,2,3,66.7,1,6,4,2,2,5,9,0
Alberto Reina,ESP,MF,26,CD Mirandés,Segunda Division,33.2,83,47,38,37,8,43,70,61.4,27,48,13,35,43,126,46,0
Alberto Vaquero,ESP,"MF,FW",20,Zaragoza,Segunda Division,0.7,1,1,0,1,0,1,1,100.0,0,1,1,0,0,1,1,0
Albin Ekdal,SWE,MF,34,Spezia,Serie B,3.7,9,3,4,4,1,5,8,62.5,3,8,3,5,11,20,5,0
Aldahir Perez,MEX,DF,18,Querétaro,Liga MX,0.0,0,0,0,0,0,0,0,0.0,0,0,0,0,0,0,0,0
Aldasoro,ESP,MF,25,Racing Sant,Segunda Division,32.1,79,45,33,36,10,43,86,50.0,43,66,16,50,44,123,76,1
Aldo Cruz,MEX,DF,25,FC Juárez,Liga MX,8.5,15,7,8,6,1,8,15,53.3,7,15,4,11,6,21,12,0
Aldo Cruz,MEX,"DF,MF",25,Atlético,Liga MX,6.5,5,2,4,0,1,2,5,40.0,3,4,2,2,5,10,12,0
Aldo Florenzi,ITA,"FW,MF",21,Cosenza,Serie B,11.9,28,13,15,10,3,9,26,34.6,17,15,3,12,7,35,16,0
Aldo López,MEX,MF,23,Santos,Liga MX,16.2,28,19,10,17,1,14,30,46.7,16,24,10,14,26,54,21,0
Aldo Rocha,MEX,MF,30,Atlas,Liga MX,26.2,41,19,17,20,4,22,54,40.7,32,15,4,11,16,57,29,1
Alec Georgen,FRA,DF,24,US Concarneau,Ligue 2,28.1,74,52,49,17,8,45,72,62.5,27,35,9,26,54,128,77,1
Alec Kann,USA,GK,32,FC Cincinnati,MLS,1.0,0,0,0,0,0,0,0,0.0,0,0,0,0,0,0,0,0
Aleix Febas,ESP,MF,28,Elche,Segunda Division,28.0,70,48,31,32,7,28,55,50.9,27,23,1,22,14,84,5,0
Alejandro Andrade,MEX,MF,21,Necaxa,Liga MX,9.2,29,17,7,21,1,11,21,52.4,10,15,8,7,8,37,11,0
Alejandro Bedoya,USA,MF,35,Philadelphia,MLS,22.3,36,22,18,12,6,16,49,32.7,33,25,8,17,23,59,19,1
Alejandro Blanco,ESP,MF,24,Reggiana,Serie B,1.4,4,1,1,3,0,3,3,100.0,0,1,0,1,0,4,0,0
Alejandro Blanco,ESP,MF,24,Como,Serie B,1.9,1,0,1,0,0,1,1,100.0,0,3,1,2,1,2,3,0
Alejandro Blesa,ESP,MF,22,Levante,Segunda Division,0.1,0,0,0,0,0,0,1,0.0,1,0,0,0,1,1,0,0
Alejandro Francés,ESP,DF,21,Zaragoza,Segunda Division,35.5,55,31,33,19,3,28,40,70.0,12,24,14,10,55,110,138,0
Alejandro Granados,ESP,FW,16,Orlando City,MLS,0.0,0,0,0,0,0,0,0,0.0,0,0,0,0,0,0,0,0
Alejandro Gómez,MEX,DF,21,Tijuana,Liga MX,6.6,15,9,9,5,1,6,9,66.7,3,11,7,4,13,28,23,0
Alejandro Lozano,SPA,MF,19,Sporting Gijón,Segunda Division,0.8,3,2,2,1,0,2,6,33.3,4,1,0,1,1,4,0,0
Alejandro Martínez,ARG,"MF,FW",26,Tijuana,Liga MX,12.1,16,8,5,5,6,6,17,35.3,11,14,1,13,6,22,5,0
Alejandro Mayorga,MEX,DF,26,Guadalajara,Liga MX,4.4,7,6,5,2,0,6,12,50.0,6,4,3,1,4,11,11,0
Alejandro Mayorga,MEX,DF,26,Necaxa,Liga MX,4.8,11,8,10,0,1,7,9,77.8,2,6,0,6,7,18,8,0
Alejandro Sancris,ESP,"MF,FW",27,Burgos,Segunda Division,23.8,34,27,18,13,3,15,34,44.1,19,29,1,28,15,49,13,1
Alejandro Suárez,ESP,"FW,MF",20,Oviedo,Segunda Division,0.2,0,0,0,0,0,0,0,0.0,0,0,0,0,1,1,0,0
Alejandro Zendejas,USA,"FW,MF",25,América,Liga MX,19.6,49,32,21,21,7,13,32,40.6,19,27,3,24,17,66,6,0
Alek Álvarez,MEX,DF,20,Necaxa,Liga MX,0.1,1,1,1,0,0,0,0,0.0,0,0,0,0,0,1,1,0
Aleksandar Radovanović,SRB,DF,29,Austin,MLS,3.9,7,4,4,3,0,0,3,0.0,3,4,2,2,6,13,13,1
Aleksandar Vukotić,SRB,DF,28,Wehen,2. Bundesliga,25.9,61,39,42,19,0,36,60,60.0,24,38,20,18,38,99,190,0
Alessandro Arena,ITA,"FW,MF",22,Pisa,Serie B,17.0,21,12,7,8,6,11,23,47.8,12,17,0,17,5,26,5,0
Alessandro Arioli,ITA,FW,20,Cosenza,Serie B,1.9,1,1,0,1,0,1,2,50.0,1,2,1,1,3,4,3,0
Alessandro Bellemo,ITA,MF,27,Como,Serie B,30.9,59,30,20,32,7,20,36,55.6,16,32,12,20,33,92,41,1
Alessandro Bianco,ITA,MF,20,Reggiana,Serie B,33.5,51,35,26,19,6,23,48,47.9,25,44,10,34,31,82,35,0
Alessandro Bianconi,ITA,DF,24,Calcio Lecco 1912,Serie B,21.3,25,14,19,5,1,13,18,72.2,5,31,23,8,15,40,63,0
Alessandro Caporale,ITA,DF,27,Calcio Lecco 1912,Serie B,29.2,28,14,18,8,2,13,28,46.4,15,33,12,21,34,62,95,0
Alessandro Celli,ITA,DF,29,Ternana,Serie B,9.2,14,8,10,4,0,6,10,60.0,4,9,4,5,9,23,26,0
Alessandro Circati,AUS,DF,19,Parma,Serie B,28.1,25,13,15,8,2,15,22,68.2,7,34,26,8,25,50,98,1
Alessandro De Vitis,ITA,"DF,MF",31,Pisa,Serie B,1.1,3,1,1,2,0,0,1,0.0,1,0,0,0,0,3,4,0
Alessandro Fontanarosa,ITA,DF,20,Cosenza,Serie B,11.9,24,19,11,9,4,13,22,59.1,9,13,3,10,18,42,61,0
Alessandro Gabrielloni,ITA,"FW,MF",29,Como,Serie B,21.7,13,8,4,6,3,6,17,35.3,11,19,6,13,4,17,20,0
Alessandro Mallamo,ITA,MF,24,Südtirol,Serie B,4.3,7,6,5,2,0,1,4,25.0,3,7,2,5,5,12,6,0
Alessandro Marcandalli,ITA,DF,20,Reggiana,Serie B,32.4,45,29,33,12,0,18,21,85.7,3,40,27,13,54,99,106,5
Alessandro Micai,ITA,GK,30,Cosenza,Serie B,36.6,0,0,0,0,0,0,1,0.0,1,0,0,0,0,0,23,2
Alessandro Pietrelli,ITA,"MF,FW",20,FeralpiSalò,Serie B,1.7,7,5,3,2,2,4,5,80.0,1,2,1,1,2,9,2,0
Alessandro Pilati,ITA,DF,23,FeralpiSalò,Serie B,16.6,34,19,25,6,3,13,19,68.4,6,37,21,16,18,52,61,0
Alessandro Riccio,ITA,DF,21,Modena,Serie B,17.7,26,18,16,8,2,12,23,52.2,11,18,9,9,20,46,72,0
Alessandro Salvi,ITA,DF,35,Cittadella,Serie B,26.9,48,31,27,15,6,35,56,62.5,21,31,8,23,40,88,71,0
Alessandro Schöpf,AUT,MF,28,Vancouver W'caps,MLS,19.7,38,20,16,17,5,14,32,43.8,18,24,5,19,16,54,16,0
Alessandro Sersanti,ITA,MF,21,Calcio Lecco 1912,Serie B,25.1,81,55,34,40,7,25,55,45.5,30,39,10,29,33,114,53,1
Alessandro Tuia,ITA,DF,33,Cremonese,Serie B,1.7,7,4,5,2,0,2,2,100.0,0,2,2,0,4,11,8,1
Alessio Buttaro,ITA,"DF,MF",20,Palermo,Serie B,5.3,6,4,2,3,1,3,7,42.9,4,8,2,6,2,8,10,1
Alessio Iovine,ITA,DF,32,Como,Serie B,17.1,37,24,19,14,4,21,29,72.4,8,31,4,27,17,54,29,1
Alessio Rizza,ITA,DF,20,Cittadella,Serie B,5.5,9,5,5,4,0,6,14,42.9,8,9,2,7,4,13,13,0
Alessio Vita,ITA,MF,30,Cittadella,Serie B,32.9,48,25,28,15,5,22,59,37.3,37,42,6,36,28,76,43,0
Alessio da Cruz,CPV,FW,26,FeralpiSalò,Serie B,0.2,0,0,0,0,0,0,0,0.0,0,0,0,0,0,0,0,0
Alex Balboa,EQG,MF,23,Huesca,Segunda Division,4.5,10,5,5,4,1,4,7,57.1,3,4,2,2,10,20,6,0
Alex Bangura,SLE,DF,24,Middlesbrough,EFL,6.5,9,6,6,3,0,3,6,50.0,3,7,1,6,5,14,12,0
Alex Bono,USA,GK,28,D.C. United,MLS,9.5,1,0,1,0,0,1,1,100.0,0,0,0,0,0,1,3,0
Alex Ferrari,ITA,DF,29,Sampdoria,Serie B,2.7,1,1,1,0,0,1,4,25.0,3,6,5,1,8,9,9,0
Alex Gersbach,AUS,"DF,MF",25,Rapids,MLS,2.9,5,2,1,2,2,3,5,60.0,2,6,1,5,6,11,10,0
Alex Matos,ENG,MF,18,Huddersfield,EFL,14.2,43,26,19,17,7,24,51,47.1,27,25,5,20,27,70,19,1
Alex McCarthy,ENG,GK,33,Southampton,EFL,5.0,0,0,0,0,0,0,0,0.0,0,0,0,0,1,1,2,0
Alex Monis,PHI,FW,19,Fire,MLS,0.1,1,1,0,1,0,1,1,100.0,0,0,0,0,1,2,0,0
Alex Mowatt,ENG,MF,28,West Brom,EFL,36.1,59,34,29,20,10,34,61,55.7,27,49,24,25,31,90,40,0
Alex Muyl,USA,"MF,DF",27,Nashville,MLS,22.7,46,19,15,26,5,17,54,31.5,37,37,5,32,22,68,25,0
Alex Palmer,ENG,GK,26,West Brom,EFL,46.0,0,0,0,0,0,0,0,0.0,0,0,0,0,0,0,29,3
Alex Pastor,ESP,DF,24,FC Andorra,Segunda Division,23.8,53,36,37,13,3,25,44,56.8,19,24,12,12,31,84,66,0
Alex Petxa,ESP,DF,27,FC Andorra,Segunda Division,25.7,43,29,25,13,5,23,44,52.3,21,34,12,22,34,77,47,3
Alex Pritchard,ENG,"MF,FW",30,Birmingham City,EFL,3.7,8,4,2,5,1,3,6,50.0,3,4,0,4,4,12,4,0
Alex Pritchard,ENG,"MF,FW",30,Sunderland,EFL,12.5,18,11,7,9,2,7,18,38.9,11,5,0,5,6,24,8,0
Alex Roldan,SLV,DF,26,Seattle,MLS,26.9,53,38,24,22,7,33,59,55.9,26,25,5,20,23,76,51,1
Alexander Bernhardsson,SWE,"FW,MF",24,Holstein Kiel,2. Bundesliga,10.1,12,7,5,5,2,4,12,33.3,8,7,1,6,1,13,13,0
Alexander Freeman,USA,DF,18,Orlando City,MLS,0.0,0,0,0,0,0,0,0,0.0,0,0,0,0,0,0,0,0
Alexander Gilbert,IRL,"MF,FW",21,Middlesbrough,EFL,2.6,7,5,3,1,3,2,4,50.0,2,2,0,2,4,11,3,0
Alexander Jallow,SWE,DF,25,Brescia,Serie B,20.2,33,20,18,10,5,19,23,82.6,4,14,7,7,10,43,49,0
Alexander Nollenberger,GER,"MF,FW",26,Magdeburg,2. Bundesliga,7.0,7,5,4,3,0,2,8,25.0,6,10,4,6,2,9,8,0
Alexander Ring,FIN,"DF,MF",31,Austin,MLS,23.9,37,24,25,9,3,20,47,42.6,27,27,17,10,27,64,69,2
Alexander Rossipal,GER,DF,27,Hansa Rostock,2. Bundesliga,23.6,47,34,33,13,1,32,59,54.2,27,43,15,28,29,76,90,1
Alexandre Alemão,BRA,FW,26,Oviedo,Segunda Division,16.2,14,9,4,7,3,6,11,54.5,5,24,6,18,4,18,9,0
Alexandre Bonnet,FRA,MF,36,Quevilly-Rouen,Ligue 2,3.1,3,3,1,2,0,2,2,100.0,0,3,0,3,0,3,2,0
Alexandre Coeff,FRA,"DF,MF",31,Caen,Ligue 2,11.1,30,18,18,8,4,21,44,47.7,23,13,2,11,17,47,42,1
Alexandre Mendy,GNB,FW,29,Caen,Ligue 2,35.9,11,5,1,3,7,4,10,40.0,6,9,2,7,6,17,28,0
Alexandre Phliponeau,FRA,MF,23,US Concarneau,Ligue 2,30.4,60,33,21,32,7,34,73,46.6,39,29,2,27,23,83,15,1
Alexandru Mățan,ROU,"MF,FW",23,Crew,MLS,25.2,14,11,7,6,1,6,24,25.0,18,19,1,18,12,26,3,0
Alexandru Pașcanu,ROU,DF,25,Sporting Gijón,Segunda Division,21.2,48,29,35,13,0,30,65,46.2,35,33,12,21,19,67,78,0
Alexei Dominguez,MEX,"FW,MF",18,Pachuca,Liga MX,8.9,23,19,7,12,4,9,16,56.3,7,11,0,11,3,26,6,0
Alexi Pitu,ROU,"FW,MF",21,Bordeaux,Ligue 2,10.2,25,14,7,12,6,9,20,45.0,11,10,0,10,3,28,3,0
Alexis Canelo,ARG,FW,31,Tijuana,Liga MX,2.7,4,2,1,2,1,0,2,0.0,2,3,0,3,1,5,6,0
Alexis Ferrante,ITA,FW,28,Ternana,Serie B,0.5,0,0,0,0,0,0,0,0.0,0,0,0,0,0,0,0,0
Alexis Francisco Peña,MEX,DF,27,Necaxa,Liga MX,34.0,48,33,34,12,2,27,37,73.0,10,36,18,18,42,90,178,0
Alexis Gutiérrez,MEX,"MF,FW",23,Cruz Azul,Liga MX,11.8,14,8,4,9,1,5,18,27.8,13,4,0,4,3,17,1,0
Alexis Lefebvre,FRA,FW,20,Troyes,Ligue 2,3.5,2,0,2,0,0,1,2,50.0,1,4,0,4,1,3,2,0
Alexis Sauvage,FRA,GK,31,Amiens,Ligue 2,3.0,0,0,0,0,0,0,0,0.0,0,0,0,0,0,0,0,0
Alexis Vega,MEX,FW,25,Guadalajara,Liga MX,4.3,2,1,2,0,0,2,2,100.0,0,3,0,3,1,3,0,0
Alexis Vega,MEX,"FW,MF",25,Toluca,Liga MX,10.9,17,10,9,5,3,5,12,41.7,7,13,1,12,3,20,5,1
Alexy Bosetti,FRA,"MF,FW",30,Annecy,Ligue 2,2.0,7,5,1,5,1,4,10,40.0,6,4,0,4,1,8,0,0
Aleš Matějů,CZE,DF,27,Palermo,Serie B,15.1,26,16,16,6,4,14,23,60.9,9,18,9,9,26,52,37,1
Aleš Matějů,CZE,DF,27,Spezia,Serie B,16.5,31,16,18,11,2,20,25,80.0,5,13,6,7,16,47,29,1
Alfie Devine,ENG,"MF,FW",18,Plymouth Argyle,EFL,9.4,10,7,3,5,2,4,9,44.4,5,8,2,6,6,16,11,0
Alfie Jones,ENG,DF,25,Hull City,EFL,45.0,38,20,26,11,1,21,37,56.8,16,57,39,18,45,83,184,0
Alfonso Alvarado,MEX,"MF,FW",23,León,Liga MX,16.5,16,10,5,10,1,7,14,50.0,7,9,0,9,8,24,16,0
Alfonso Blanco Antúnez,MEX,GK,36,León,Liga MX,2.0,0,0,0,0,0,0,0,0.0,0,0,0,0,0,0,0,0
Alfonso González,MEX,"MF,FW",28,Monterrey,Liga MX,9.8,23,15,5,12,6,9,16,56.3,7,12,1,11,9,32,3,0
Alfredo Donnarumma,ITA,FW,32,Catanzaro,Serie B,6.4,3,2,0,2,1,2,7,28.6,5,2,0,2,3,6,2,0
Alfredo Gutierrez,MEX,DF,20,Necaxa,Liga MX,0.9,4,3,2,2,0,1,1,100.0,0,0,0,0,3,7,1,0
Alfredo Morales,USA,MF,32,NYCFC,MLS,12.9,23,9,12,10,1,9,21,42.9,12,17,4,13,11,34,20,0
Alfredo Ortuño,ESP,FW,33,Cartagena,Segunda Division,27.0,23,12,6,11,6,8,21,38.1,13,21,5,16,3,26,30,0
Alfredo Talavera,MEX,GK,40,FC Juárez,Liga MX,16.3,0,0,0,0,0,0,2,0.0,2,0,0,0,0,0,4,2
Ali Abdi,TUN,DF,29,Caen,Ligue 2,32.7,91,60,43,34,14,34,64,53.1,30,26,1,25,38,129,56,0
Ali Ahmed,CAN,"MF,DF",22,Vancouver W'caps,MLS,12.5,37,27,10,16,11,15,25,60.0,10,13,2,11,18,55,1,0
Ali Al Hamadi,IRQ,FW,21,Ipswich Town,EFL,3.3,2,2,2,0,0,1,4,25.0,3,1,0,1,1,3,0,0
Ali Dembélé,FRA,"DF,MF",19,Venezia,Serie B,1.9,4,3,4,0,0,1,2,50.0,1,2,0,2,2,6,9,0
Ali Loune,MAR,"MF,FW",21,Nürnberg,2. Bundesliga,4.0,16,9,7,7,2,10,15,66.7,5,5,0,5,8,24,8,0
Ali Ávila,MEX,"FW,MF",19,UNAM,Liga MX,1.2,1,1,0,0,1,0,1,0.0,1,0,0,0,0,1,0,0
Ali Ávila,MEX,FW,19,Monterrey,Liga MX,3.0,3,0,1,0,2,3,4,75.0,1,1,0,1,0,3,2,0
Ali-Eren Ersungur,TUR,"MF,FW",17,Karlsruher,2. Bundesliga,0.5,0,0,0,0,0,0,1,0.0,1,1,0,1,0,0,0,0
Alimani Gory,MLI,"FW,MF",26,Paris FC,Ligue 2,22.6,19,13,8,10,1,12,23,52.2,11,14,1,13,14,33,8,0
Aliou Badji,SEN,FW,25,Bordeaux,Ligue 2,6.1,3,0,0,2,1,0,2,0.0,2,5,1,4,0,3,7,0
Alioune Ba,FRA,DF,33,Dunkerque,Ligue 2,4.7,12,10,4,8,0,8,10,80.0,2,9,6,3,7,19,22,0
Alistair McCann,NIR,MF,23,Preston,EFL,23.0,104,58,38,59,7,54,102,52.9,48,45,4,41,42,146,51,1
Aliyu Ibrahim,NGA,FW,21,Dynamo FC,MLS,13.4,16,11,2,9,5,6,14,42.9,8,9,0,9,1,17,4,0
Aljaž Ivačič,SVN,GK,29,Portland Timbers,MLS,15.0,0,0,0,0,0,0,2,0.0,2,0,0,0,0,0,9,1
Aljosa Vasic,SRB,"MF,FW",21,Palermo,Serie B,7.7,14,6,7,5,2,6,12,50.0,6,8,4,4,10,24,12,0
Aljoscha Kemlein,GER,MF,18,St. Pauli,2. Bundesliga,11.0,26,15,5,17,4,12,19,63.2,7,3,0,3,9,35,4,0
Allahyar Sayyadmanesh,IRN,FW,22,Hull City,EFL,0.7,0,0,0,0,0,0,0,0.0,0,3,0,3,1,1,0,0
Allan Campbell,SCO,MF,25,Millwall,EFL,8.0,20,12,5,13,2,11,21,52.4,10,16,5,11,10,30,6,0
Allan Linguet,FRA,"DF,FW",23,Valenciennes,Ligue 2,25.2,35,24,20,10,5,24,40,60.0,16,18,4,14,31,66,43,0
Allan Nyom,CMR,DF,36,Leganés,Segunda Division,22.3,35,24,26,6,3,21,31,67.7,10,17,4,13,15,50,53,1
Allan Tchaptchet,FRA,DF,21,Grenoble,Ligue 2,1.0,1,1,1,0,0,1,1,100.0,0,1,0,1,1,2,4,0
Almamy Touré,MLI,DF,27,Kaiserslautern,2. Bundesliga,9.3,18,8,10,7,1,8,15,53.3,7,13,4,9,11,29,29,0
Alonso Coello,ESP,MF,23,Toronto FC,MLS,14.3,59,40,38,16,5,29,57,50.9,28,15,1,14,18,77,14,0
Alonso Escoboza,MEX,DF,30,Cruz Azul,Liga MX,0.9,1,0,0,1,0,0,0,0.0,0,0,0,0,1,2,4,0
Alonso Escoboza,MEX,"DF,MF",30,Mazatlán,Liga MX,4.1,7,5,5,2,0,6,7,85.7,1,3,0,3,3,10,5,0
Alonso Martínez,CRC,"FW,DF",24,NYCFC,MLS,0.4,1,1,0,1,0,1,1,100.0,0,4,0,4,0,1,0,0
Altube,ESP,GK,24,Albacete,Segunda Division,5.0,0,0,0,0,0,0,0,0.0,0,0,0,0,0,0,2,0
Alvaro Sanz,ESP,MF,23,CD Mirandés,Segunda Division,27.8,43,29,17,20,6,21,39,53.8,18,24,7,17,22,65,26,0
Alvas Powell,JAM,DF,28,FC Cincinnati,MLS,10.6,23,14,16,7,0,17,29,58.6,12,12,4,8,12,35,34,0
Aly Sidibé,FRA,MF,18,Troyes,Ligue 2,0.1,0,0,0,0,0,0,0,0.0,0,0,0,0,0,0,0,0
Alán Bautista,MEX,"MF,FW",20,Pachuca,Liga MX,8.5,4,4,0,3,1,1,10,10.0,9,6,0,6,5,9,4,0
Alán Montes,MEX,DF,22,Necaxa,Liga MX,27.9,58,35,36,22,0,31,47,66.0,16,48,28,20,54,112,163,0
Amadou Ba-Sy,FRA,FW,22,Dunkerque,Ligue 2,2.7,2,1,0,0,2,1,2,50.0,1,1,1,0,0,2,0,0
Amadou Ciss,SEN,"FW,MF",23,Amiens,Ligue 2,2.6,6,6,1,3,2,2,6,33.3,4,4,0,4,3,9,5,0
Amadou Sagna,SEN,"MF,FW",24,Guingamp,Ligue 2,22.6,37,24,19,12,6,19,36,52.8,17,26,0,26,16,53,15,0
Amar Sejdic,USA,MF,26,Atlanta Utd,MLS,11.8,18,12,9,7,2,6,29,20.7,23,17,3,14,12,30,7,0
Amar Ćatić,BIH,DF,24,Wehen,2. Bundesliga,10.2,36,20,21,12,3,17,28,60.7,11,16,5,11,11,47,21,0
Amara Conde,GER,MF,26,Magdeburg,2. Bundesliga,21.7,35,19,16,11,8,15,30,50.0,15,14,2,12,14,49,29,0
Amath,SEN,"MF,FW",27,Valladolid,Segunda Division,6.3,8,4,3,2,3,1,8,12.5,7,7,2,5,3,11,2,0
Amaury Escoto,MEX,"FW,MF",30,FC Juárez,Liga MX,6.0,3,1,2,0,1,1,2,50.0,1,6,0,6,0,3,5,0
Amaury Morales,MEX,"MF,FW",17,Cruz Azul,Liga MX,0.6,3,2,1,1,1,1,2,50.0,1,1,0,1,0,3,0,0
Ambroise Gboho,FRA,FW,28,US Concarneau,Ligue 2,4.4,3,2,0,2,1,2,5,40.0,3,3,0,3,1,4,6,0
Amet Korca,USA,DF,22,FC Dallas,MLS,1.7,1,0,1,0,0,1,1,100.0,0,3,3,0,4,5,1,1
Amine Bassi,FRA,"MF,FW",25,Dynamo FC,MLS,22.2,14,7,3,8,3,8,24,33.3,16,15,1,14,11,25,3,1
Amine Chabane,FRA,DF,16,Amiens,Ligue 2,0.1,1,1,0,1,0,1,1,100.0,0,1,0,1,1,2,2,0
Amine Cherni,TUN,"DF,MF",22,Stade Laval,Ligue 2,34.7,71,49,51,13,7,43,77,55.8,34,51,2,49,44,115,80,0
Amine El Ouazzani,MAR,FW,22,Guingamp,Ligue 2,33.6,26,15,4,13,9,7,25,28.0,18,23,1,22,13,39,9,0
Amine Salama,FRA,"FW,MF",23,Caen,Ligue 2,8.2,8,6,1,4,3,3,9,33.3,6,8,1,7,5,13,6,0
Amney Moutassime,ITA,FW,19,Südtirol,Serie B,0.1,0,0,0,0,0,0,0,0.0,0,0,0,0,0,0,0,0
Anaitz Arbilla,ESP,DF,37,Eibar,Segunda Division,39.0,47,30,36,11,0,32,47,68.1,15,51,33,18,50,97,158,2
Anass Zaroury,MAR,"FW,MF",22,Hull City,EFL,7.7,12,7,5,2,5,6,11,54.5,5,18,1,17,5,17,5,0
Ander Cantero,ESP,GK,29,Racing Ferrol,Segunda Division,42.0,0,0,0,0,0,0,2,0.0,2,0,0,0,0,0,25,1
Ander Capa,ESP,DF,32,Levante,Segunda Division,17.0,33,24,23,9,1,17,26,65.4,9,16,8,8,21,54,43,1
Ander Madariaga,ESP,"MF,FW",22,Eibar,Segunda Division,0.6,1,0,0,1,0,0,0,0.0,0,3,0,3,2,3,0,0
Ander Martin,ESP,"MF,DF",23,Burgos,Segunda Division,15.7,28,13,12,12,4,18,40,45.0,22,14,0,14,8,36,14,1
Anderson Arroyo,COL,DF,24,Burgos,Segunda Division,14.9,20,13,15,5,0,8,11,72.7,3,20,5,15,18,38,47,0
Anderson Arroyo,COL,DF,24,FC Andorra,Segunda Division,4.7,6,3,5,1,0,4,7,57.1,3,4,2,2,6,12,16,1
Anderson Julio,ECU,FW,26,RSL,MLS,12.8,8,6,2,4,2,3,13,23.1,10,13,1,12,2,10,10,0
Anderson Lucoqui,ANG,"DF,FW",26,Braunschweig,2. Bundesliga,4.2,5,1,4,1,0,3,6,50.0,3,10,0,10,4,9,9,0
Anderson Lucoqui,ANG,DF,26,Hertha BSC,2. Bundesliga,0.5,2,2,1,0,1,1,1,100.0,0,1,0,1,2,4,1,0
Anderson Santamaría,PER,DF,31,Atlas,Liga MX,16.7,40,26,29,11,0,15,22,68.2,7,24,12,12,24,64,73,1
Andi Hoti,KVX,DF,20,Magdeburg,2. Bundesliga,8.9,21,12,15,4,2,15,19,78.9,4,14,6,8,5,26,31,0
Andoni Zubiaurre,ESP,GK,27,Eldense,Segunda Division,10.0,1,0,1,0,0,1,2,50.0,1,0,0,0,1,2,4,0
Andre Blake,JAM,GK,32,Philadelphia,MLS,26.4,0,0,0,0,0,0,0,0.0,0,0,0,0,0,0,11,1
Andre Dozzell,ENG,MF,24,Birmingham City,EFL,7.0,15,9,5,8,2,7,8,87.5,1,10,2,8,4,19,2,0
Andre Dozzell,ENG,MF,24,QPR,EFL,21.8,28,16,12,11,5,9,21,42.9,12,16,8,8,20,48,23,0
Andre Shinyashiki,BRA,"MF,FW",27,Charlotte,MLS,2.1,6,3,1,5,0,3,9,33.3,6,2,0,2,1,7,0,0
Andrea Barberis,ITA,"MF,FW",29,Pisa,Serie B,5.1,8,5,6,2,0,4,7,57.1,3,2,0,2,9,17,8,0
Andrea Bertolacci,ITA,MF,32,Cremonese,Serie B,2.9,5,1,3,2,0,2,5,40.0,3,2,0,2,4,9,1,0
Andrea Cagnano,ITA,DF,25,Südtirol,Serie B,15.1,41,27,22,16,3,19,33,57.6,14,21,9,12,24,65,49,0
Andrea Cisco,ITA,MF,24,Südtirol,Serie B,4.3,3,1,2,1,0,1,4,25.0,3,3,1,2,1,4,1,0
Andrea Cistana,ITA,DF,26,Brescia,Serie B,21.7,28,17,18,7,3,12,21,57.1,9,28,20,8,41,69,71,1
Andrea Conti,ITA,DF,29,Sampdoria,Serie B,0.0,0,0,0,0,0,0,0,0.0,0,0,0,0,0,0,0,0
Andrea Danzi,ITA,MF,24,Cittadella,Serie B,5.4,12,7,7,4,1,5,14,35.7,9,4,1,3,7,19,10,0
Andrea Favilli,ITA,FW,26,Ternana,Serie B,11.3,5,4,1,2,2,3,3,100.0,0,6,1,5,1,6,14,0
Andrea Fulignati,ITA,GK,28,Catanzaro,Serie B,37.0,0,0,0,0,0,0,0,0.0,0,0,0,0,0,0,15,4
Andrea Ghion,ITA,MF,23,Catanzaro,Serie B,17.6,20,10,9,9,2,10,21,47.6,11,13,2,11,14,34,21,0
Andrea Giorgini,ITA,DF,21,Südtirol,Serie B,29.4,34,21,19,12,3,19,32,59.4,13,40,15,25,31,65,104,0
Andrea La Mantia,ITA,FW,32,FeralpiSalò,Serie B,21.3,7,3,3,2,2,2,5,40.0,3,9,1,8,1,8,26,0
Andrea Magrassi,ITA,FW,30,Cittadella,Serie B,13.0,6,4,0,3,3,1,5,20.0,4,16,1,15,1,7,10,0
Andrea Masiello,ITA,DF,37,Südtirol,Serie B,33.5,63,39,46,16,1,36,68,52.9,32,35,24,11,42,105,133,1
Andrea Meroni,ITA,DF,26,Cosenza,Serie B,22.2,30,23,20,10,0,13,19,68.4,6,29,21,8,29,59,118,0
Andrea Oliveri,ITA,"DF,MF",20,Catanzaro,Serie B,8.7,15,9,9,5,1,8,11,72.7,3,3,0,3,7,22,18,1
Andrea Papetti,ITA,DF,21,Brescia,Serie B,28.3,54,32,34,19,1,22,42,52.4,20,46,29,17,40,94,98,2
Andrea Rispoli,ITA,DF,34,Cosenza,Serie B,7.6,6,3,3,3,0,5,9,55.6,4,9,1,8,9,15,14,0
Andrea Sala,ITA,GK,29,Catanzaro,Serie B,1.0,0,0,0,0,0,0,0,0.0,0,0,0,0,0,0,1,0
Andrea Seculin,ITA,GK,33,Modena,Serie B,16.5,0,0,0,0,0,0,0,0.0,0,0,0,0,0,0,3,0
Andrea Tessiore,ITA,"MF,DF",23,Cittadella,Serie B,12.5,20,9,9,6,5,9,17,52.9,8,14,1,13,3,23,7,0
Andreas Albers,DEN,"FW,MF",33,St. Pauli,2. Bundesliga,4.8,4,2,0,3,1,3,5,60.0,2,0,0,0,1,5,10,0
Andreas Bouchalakis,GRE,MF,30,Hertha BSC,2. Bundesliga,16.3,21,13,12,8,1,15,32,46.9,17,13,4,9,24,45,18,1
Andreas Bruus,DEN,"MF,FW",24,Troyes,Ligue 2,4.8,2,2,1,1,0,0,3,0.0,3,2,0,2,1,3,6,0
Andreas Hountondji,BEN,FW,21,Rodez Aveyron,Ligue 2,25.0,6,4,0,3,3,3,12,25.0,9,10,2,8,4,10,6,0
Andreas Jungdal,DEN,GK,21,Cremonese,Serie B,18.0,0,0,0,0,0,0,1,0.0,1,0,0,0,0,0,10,2
Andreas Linde,SWE,GK,30,Greuther Fürth,2. Bundesliga,1.0,0,0,0,0,0,0,0,0.0,0,0,0,0,0,0,0,0
Andreas Luthe,GER,GK,36,Kaiserslautern,2. Bundesliga,1.4,0,0,0,0,0,0,1,0.0,1,0,0,0,0,0,2,1
Andreas Maxsø,DEN,DF,28,Rapids,MLS,32.5,13,5,8,5,0,6,12,50.0,6,29,25,4,17,30,122,0
Andreas Voglsammer,GER,"FW,MF",31,Hannover 96,2. Bundesliga,16.0,12,7,3,5,4,4,8,50.0,4,15,2,13,3,15,12,0
Andreas Voglsammer,GER,"DF,FW",31,Millwall,EFL,0.5,1,1,1,0,0,0,0,0.0,0,0,0,0,0,1,2,0
Andreas Weimann,AUT,"FW,MF",31,Bristol City,EFL,9.1,9,7,3,4,2,6,10,60.0,4,10,1,9,3,12,6,0
Andreas Weimann,AUT,"FW,MF",31,West Brom,EFL,4.6,2,2,2,0,0,1,1,100.0,0,3,0,3,0,2,3,0
Andres Jasson,USA,FW,21,NYCFC,MLS,9.0,13,10,4,4,5,7,17,41.2,10,16,0,16,3,16,2,0
Andres Montaño,MEX,MF,21,Mazatlán,Liga MX,21.2,28,16,16,8,4,18,39,46.2,21,20,6,14,15,43,25,0
Andreu Fontàs,ESP,DF,33,Sporting KC,MLS,26.6,55,35,31,20,4,30,56,53.6,26,32,16,16,40,95,76,1
Andrew Brody,USA,DF,27,RSL,MLS,25.2,27,19,16,8,3,14,27,51.9,13,27,13,14,25,52,54,0
Andrew Farrell,USA,DF,30,NE Revolution,MLS,21.5,28,18,20,8,0,17,35,48.6,18,32,23,9,24,52,67,1
Andrew Gutman,USA,DF,26,Atlanta Utd,MLS,15.4,31,18,17,11,3,20,34,58.8,14,20,9,11,13,44,30,0
Andrew Gutman,USA,DF,26,Rapids,MLS,11.2,21,15,12,8,1,16,27,59.3,11,13,3,10,15,36,31,0
Andrew Hughes,WAL,DF,31,Preston,EFL,34.9,62,40,38,16,8,34,59,57.6,25,40,16,24,38,100,114,0
Andrew Jung,FRA,FW,25,Valenciennes,Ligue 2,11.4,7,5,2,1,4,2,7,28.6,5,12,0,12,2,9,12,0
Andrew Moran,IRL,"FW,MF",19,Blackburn,EFL,20.6,45,31,20,17,8,21,62,33.9,41,31,1,30,12,57,13,2
Andrew Omobamidele,IRL,DF,21,Norwich City,EFL,0.2,0,0,0,0,0,0,0,0.0,0,1,1,0,1,1,1,0
Andrew Privett,USA,DF,22,Charlotte,MLS,11.6,16,11,5,9,2,6,15,40.0,9,10,1,9,11,27,23,2
Andrew Tarbell,USA,GK,29,Dynamo FC,MLS,1.0,0,0,0,0,0,0,0,0.0,0,0,0,0,0,0,0,0
Andrija Novakovich,USA,FW,26,Calcio Lecco 1912,Serie B,31.1,16,7,2,8,6,2,4,50.0,2,6,0,6,0,16,27,0
Andrija Vukčević,MNE,"DF,MF",26,FC Juárez,Liga MX,15.5,28,18,17,7,4,13,17,76.5,4,11,2,9,11,39,20,0
András Németh,HUN,"FW,MF",20,Hamburger SV,2. Bundesliga,6.3,9,5,1,4,4,2,6,33.3,4,7,2,5,0,9,2,0
André Green,ENG,FW,25,Rotherham Utd,EFL,7.2,0,0,0,0,0,0,4,0.0,4,7,3,4,7,7,6,0
André Hoffmann,GER,DF,30,Düsseldorf,2. Bundesliga,10.4,12,9,8,4,0,8,14,57.1,6,17,14,3,9,21,31,0
André Vidigal,POR,"FW,MF",24,Stoke City,EFL,18.7,17,9,10,2,5,5,14,35.7,9,17,1,16,9,26,6,0
André-Pierre Gignac,FRA,FW,37,UANL,Liga MX,19.6,6,2,0,3,3,2,7,28.6,5,9,4,5,3,9,18,0
Andrés Colorado,COL,MF,24,Necaxa,Liga MX,7.0,12,7,7,3,2,8,15,53.3,7,3,1,2,12,24,15,1
Andrés Cubas,PAR,MF,26,Vancouver W'caps,MLS,23.8,65,40,27,37,1,27,67,40.3,40,39,8,31,50,115,26,0
Andrés Fernández,ESP,GK,37,Levante,Segunda Division,33.0,1,1,1,0,0,1,2,50.0,1,0,0,0,0,1,11,2
Andrés Ferrari,URU,"FW,MF",21,Villarreal B,Segunda Division,6.9,9,8,5,0,4,4,6,66.7,2,10,1,9,0,9,7,0
Andrés García,ESP,"DF,MF",21,Levante,Segunda Division,16.7,25,18,15,7,3,15,23,65.2,8,21,5,16,12,37,33,1
Andrés Guardado,MEX,"MF,DF",36,León,Liga MX,3.6,9,1,2,5,2,6,8,75.0,2,4,1,3,5,14,7,0
Andrés Gudiño,MEX,GK,26,Cruz Azul,Liga MX,13.5,0,0,0,0,0,0,2,0.0,2,0,0,0,0,0,6,1
Andrés Iniestra,MEX,MF,27,Atlético,Liga MX,0.3,0,0,0,0,0,0,0,0.0,0,0,0,0,1,1,0,0
Andrés Martín,ESP,"FW,MF",24,Racing Sant,Segunda Division,14.5,18,11,6,8,4,6,23,26.1,17,29,3,26,18,36,6,0
Andrés Martín,ESP,DF,22,Zaragoza,Segunda Division,8.4,34,18,23,8,3,15,22,68.2,7,8,1,7,19,53,27,0
Andrés Micolta,ECU,DF,24,Pachuca,Liga MX,6.0,10,5,8,2,0,7,12,58.3,5,3,2,1,12,22,17,0
Andrés Mosquera Guardia,COL,DF,33,Toluca,Liga MX,15.6,22,14,13,8,1,10,17,58.8,7,13,9,4,15,37,63,0
Andrés Perea,USA,MF,22,NYCFC,MLS,8.6,14,12,5,8,1,7,17,41.2,10,9,2,7,8,22,7,0
Andrés Perea,USA,MF,22,Philadelphia,MLS,1.7,3,2,1,2,0,1,4,25.0,3,3,1,2,2,5,7,0
Andrés Reyes,COL,DF,23,NY Red Bulls,MLS,26.5,47,32,30,15,2,24,37,64.9,13,26,11,15,61,108,87,0
Andrés Sánchez,MEX,GK,25,Atlético,Liga MX,24.0,1,0,1,0,0,1,3,33.3,2,1,0,1,1,2,20,1
Andy,ESP,MF,34,Cartagena,Segunda Division,19.8,32,18,8,20,4,9,29,31.0,20,25,6,19,18,50,33,0
Andy,ESP,"MF,DF",34,Burgos,Segunda Division,2.0,2,0,0,1,1,2,5,40.0,3,3,1,2,0,2,17,0
Andy Carroll,ENG,FW,34,Amiens,Ligue 2,16.2,13,8,3,9,1,4,9,44.4,5,10,6,4,4,17,39,0
Andy King,WAL,"MF,DF",34,Bristol City,EFL,4.6,7,7,4,2,1,6,10,60.0,4,5,4,1,4,11,11,0
Andy Najar,HON,DF,29,D.C. United,MLS,12.3,29,20,18,9,2,16,36,44.4,20,14,3,11,17,46,17,0
Andy Pembélé,FRA,"DF,MF",23,Paris FC,Ligue 2,1.3,7,5,2,1,4,2,3,66.7,1,3,0,3,1,8,1,0
Andy Rinomhota,ZIM,MF,26,Rotherham Utd,EFL,12.5,30,18,13,13,4,16,24,66.7,8,16,5,11,10,40,21,0
Andy Rinomhota,ZIM,"MF,FW",26,Cardiff City,EFL,1.4,2,1,2,0,0,1,2,50.0,1,3,0,3,1,3,0,0
Andy Smith,SCO,MF,21,Hull City,EFL,0.0,0,0,0,0,0,0,0,0.0,0,0,0,0,1,1,0,0
Anfernee Dijksteel,SUR,DF,26,Middlesbrough,EFL,8.3,9,6,7,2,0,5,12,41.7,7,14,5,9,13,22,15,0
Ange Ahoussou,CIV,DF,19,Pau FC,Ligue 2,18.7,34,21,26,8,0,20,27,74.1,7,34,29,5,27,61,82,2
Ange-Yoan Bonny,FRA,FW,19,Parma,Serie B,22.1,28,13,7,10,11,12,20,60.0,8,12,0,12,5,33,5,0
Angel Troncho,ESP,"FW,DF",21,Eibar,Segunda Division,1.0,3,1,1,1,1,1,6,16.7,5,2,0,2,1,4,0,0
Angel Troncho,ESP,"MF,FW",21,Amorebieta,Segunda Division,2.2,2,1,0,2,0,1,6,16.7,5,4,0,4,0,2,0,0
Angus Gunn,SCO,GK,27,Norwich City,EFL,39.3,1,1,1,0,0,1,2,50.0,1,1,0,1,4,5,28,0
Anis Mehmeti,ALB,"MF,FW",22,Bristol City,EFL,20.7,36,20,13,16,7,21,45,46.7,24,22,2,20,4,40,10,0
Anssi Tapio Suhonen,FIN,MF,22,Hamburger SV,2. Bundesliga,2.9,9,7,3,6,0,4,8,50.0,4,5,0,5,3,12,1,0
Ante Palaversa,CRO,"MF,FW",23,Troyes,Ligue 2,2.3,3,2,2,1,0,2,3,66.7,1,5,2,3,2,5,2,0
Anthony Briançon,FRA,DF,28,Saint-Étienne,Ligue 2,28.3,27,15,20,7,0,16,32,50.0,16,45,32,13,46,73,145,0
Anthony Fosse,FRA,"FW,MF",18,Ajaccio,Ligue 2,0.8,1,0,0,1,0,1,1,100.0,0,0,0,0,1,2,0,0
Anthony Gonçalves,FRA,"DF,MF",37,Stade Laval,Ligue 2,12.4,26,18,17,6,3,15,30,50.0,15,10,1,9,14,40,25,1
Anthony Khelifa,FRA,DF,17,Ajaccio,Ligue 2,1.3,0,0,0,0,0,0,1,0.0,1,1,1,0,5,5,4,0
Anthony Knockaert,FRA,"MF,FW",31,Valenciennes,Ligue 2,11.2,14,7,7,5,2,5,12,41.7,7,4,0,4,6,20,9,0
Anthony Mandrea,ALG,GK,26,Caen,Ligue 2,34.0,2,1,2,0,0,2,3,66.7,1,2,0,2,2,4,23,4
Anthony Markanich,PHI,DF,23,St. Louis,MLS,7.3,18,10,7,7,4,7,15,46.7,8,11,3,8,14,32,14,0
Anthony Markanich,PHI,DF,23,Rapids,MLS,3.8,13,7,9,4,0,7,14,50.0,7,8,2,6,5,18,17,0
Anthony Musaba,NED,"FW,MF",22,Sheffield Weds,EFL,29.1,37,23,15,16,6,15,41,36.6,26,38,3,35,6,43,6,0
Anthony Partipilo,ITA,FW,28,Parma,Serie B,11.1,11,6,5,3,3,8,20,40.0,12,9,1,8,5,16,9,0
Anthony Patterson,ENG,GK,23,Sunderland,EFL,45.0,0,0,0,0,0,0,1,0.0,1,0,0,0,0,0,13,2
Anthony Roncaglia,FRA,DF,23,Bastia,Ligue 2,24.0,55,35,40,12,3,36,59,61.0,23,29,10,19,31,86,77,2
Anthony Ujah,NGA,FW,32,Braunschweig,2. Bundesliga,10.3,1,1,1,0,0,0,1,0.0,1,1,0,1,0,1,9,0
Antoine Batisse,FRA,DF,28,Pau FC,Ligue 2,5.8,12,7,9,3,0,7,11,63.6,4,13,7,6,12,24,21,1
Antoine Batisse,FRA,DF,28,Quevilly-Rouen,Ligue 2,16.0,27,15,21,6,0,20,27,74.1,7,20,12,8,20,47,51,0
Antoine Gauthier,FRA,FW,19,Saint-Étienne,Ligue 2,0.0,0,0,0,0,0,0,0,0.0,0,0,0,0,0,0,0,0
Antoine Hainaut,FRA,"DF,MF",21,Parma,Serie B,1.3,2,1,0,0,2,2,2,100.0,0,3,1,2,2,4,6,0
Antoine Larose,FRA,"FW,MF",30,Annecy,Ligue 2,16.9,40,28,11,17,12,26,45,57.8,19,38,2,36,10,50,5,0
Antoine Léautey,FRA,"MF,FW",27,Amiens,Ligue 2,33.6,33,19,17,10,6,20,55,36.4,35,35,1,34,17,50,10,0
Antoine Valerio,FRA,MF,23,Rodez Aveyron,Ligue 2,5.2,10,6,7,3,0,5,10,50.0,5,8,2,6,12,22,3,0
Anton Donkor,GER,"DF,FW",25,Braunschweig,2. Bundesliga,28.6,62,36,36,22,4,34,61,55.7,27,48,8,40,42,104,71,2
Antonin Bobichon,FRA,"MF,FW",27,Stade Laval,Ligue 2,15.6,27,15,7,15,5,12,28,42.9,16,17,2,15,2,29,8,0
Antonino La Gumina,ITA,FW,27,Sampdoria,Serie B,4.3,2,1,0,1,1,2,3,66.7,1,3,1,2,1,3,2,0
Antonino La Gumina,ITA,FW,28,CD Mirandés,Segunda Division,10.2,3,1,1,1,1,2,5,40.0,3,9,2,7,1,4,5,0
Antonio Barreca,ITA,"DF,FW",28,Sampdoria,Serie B,14.4,14,8,6,6,2,11,18,61.1,7,16,3,13,6,20,32,0
Antonio Briseño,MEX,DF,29,Guadalajara,Liga MX,18.3,13,8,11,2,0,7,10,70.0,3,19,14,5,24,37,84,1
Antonio Candela,ITA,DF,23,Venezia,Serie B,33.1,56,43,29,15,12,23,40,57.5,17,32,10,22,21,77,47,2
Antonio Caracciolo,ITA,DF,33,Pisa,Serie B,21.7,41,27,23,14,4,26,40,65.0,14,20,6,14,31,72,96,0
Antonio Carlos,BRA,DF,29,Orlando City,MLS,15.7,9,8,7,2,0,5,13,38.5,8,16,13,3,16,25,73,0
Antonio Cristian Glauder García,ESP,DF,28,Albacete,Segunda Division,37.6,72,36,40,31,1,37,50,74.0,13,41,27,14,52,124,157,0
Antonio Espigare,ESP,DF,19,Villarreal B,Segunda Division,26.0,15,8,11,2,2,10,20,50.0,10,19,12,7,15,30,98,2
Antonio Foti,CYP,"MF,FW",19,Hannover 96,2. Bundesliga,0.7,0,0,0,0,0,0,1,0.0,1,1,0,1,1,1,0,0
Antonio Jonjić,GER,"FW,MF",23,Wehen,2. Bundesliga,3.2,6,5,3,1,2,3,5,60.0,2,1,0,1,0,6,6,0
Antonio Leone,MEX,DF,19,Monterrey,Liga MX,1.0,0,0,0,0,0,0,1,0.0,1,2,1,1,1,1,1,0
Antonio Pacheco,ESP,MF,22,Albacete,Segunda Division,6.7,22,15,11,7,4,13,27,48.1,14,4,1,3,8,30,3,0
Antonio Palumbo,ITA,MF,26,Modena,Serie B,30.7,81,48,32,41,8,37,72,51.4,35,40,4,36,28,109,23,0
Antonio Pergreffi,ITA,DF,35,Modena,Serie B,20.4,16,12,7,8,1,9,15,60.0,6,17,13,4,33,49,78,1
Antonio Raimondo,ITA,FW,19,Ternana,Serie B,24.7,19,12,6,7,6,4,18,22.2,14,18,1,17,6,25,14,0
Antonio Vergara,ITA,"MF,FW",20,Reggiana,Serie B,2.2,14,7,7,5,2,4,5,80.0,1,4,0,4,1,15,0,0
Antonio Čolak,CRO,"FW,MF",29,Parma,Serie B,7.4,5,2,2,2,1,2,5,40.0,3,3,1,2,1,6,4,0
Antoniu,ESP,"MF,DF",21,Espanyol,Segunda Division,2.7,9,5,3,2,4,3,6,50.0,3,7,0,7,6,15,4,0
Antony,BRA,"FW,MF",21,Portland Timbers,MLS,2.8,4,3,1,3,0,3,10,30.0,7,4,0,4,3,7,1,0
Antony Curic,CAN,DF,22,Toronto FC,MLS,0.0,0,0,0,0,0,0,0,0.0,0,0,0,0,0,0,0,0
Antony Iannarilli,ITA,GK,32,Ternana,Serie B,32.0,1,0,1,0,0,1,2,50.0,1,0,0,0,1,2,6,1
Anuar,MAR,"MF,FW",29,Valladolid,Segunda Division,10.2,20,11,8,7,5,5,9,55.6,4,11,3,8,6,26,12,0
Aníbal Godoy,PAN,MF,32,Nashville,MLS,18.5,31,16,10,15,6,11,18,61.1,7,19,5,14,20,51,15,0
Ao Tanaka,JPN,MF,24,Düsseldorf,2. Bundesliga,25.1,39,28,24,14,1,21,42,50.0,21,28,5,23,20,59,26,0
Arana,ESP,FW,24,Racing Sant,Segunda Division,27.3,11,5,2,5,4,5,12,41.7,7,20,2,18,2,13,23,0
Arana,ESP,FW,24,Eibar,Segunda Division,0.1,0,0,0,0,0,0,0,0.0,0,0,0,0,0,0,0,0
Arath Moreno,MEX,MF,17,Necaxa,Liga MX,0.4,1,1,1,0,0,0,2,0.0,2,2,0,2,0,1,1,0
Archie Gray,ENG,"DF,MF",17,Leeds United,EFL,40.0,92,59,50,30,12,59,88,67.0,29,37,5,32,30,122,40,0
Arelibetsiel Hernández,MEX,DF,28,Tijuana,Liga MX,0.1,1,0,1,0,0,0,0,0.0,0,0,0,0,0,1,2,0
Aremu Afeez,NGA,"MF,FW",23,Kaiserslautern,2. Bundesliga,0.6,3,0,3,0,0,0,1,0.0,1,0,0,0,1,4,2,0
Ari Contreras,MEX,DF,17,Pachuca,Liga MX,1.6,2,1,1,1,0,2,4,50.0,2,0,0,0,2,4,1,0
Arial Mendy,SEN,DF,28,Grenoble,Ligue 2,14.5,14,8,12,2,0,9,20,45.0,11,10,5,5,30,44,42,0
Ariel Lassiter,CRC,"DF,MF",28,CF Montréal,MLS,17.7,7,7,3,4,0,4,9,44.4,5,9,1,8,13,20,15,0
Ariel Lassiter,CRC,"FW,MF",28,Inter Miami,MLS,1.7,3,2,0,1,2,2,4,50.0,2,2,0,2,1,4,0,0
Aritz Arambarri,ESP,DF,26,Leganés,Segunda Division,17.9,14,8,10,4,0,10,20,50.0,10,14,7,7,24,38,97,1
Arjan Raikhy,ENG,MF,20,Leicester City,EFL,0.0,0,0,0,0,0,0,0,0.0,0,0,0,0,1,1,0,0
Arkadiusz Reca,POL,DF,28,Spezia,Serie B,11.8,17,7,14,3,0,7,14,50.0,7,8,2,6,14,31,24,0
Armand Gnanduillet,CIV,FW,31,Dunkerque,Ligue 2,8.4,11,5,4,1,6,4,6,66.7,2,5,0,5,1,12,10,0
Armando González,MEX,"FW,MF",20,Guadalajara,Liga MX,0.4,2,1,1,1,0,1,1,100.0,0,1,0,1,0,2,1,0
Armindo Sieb,GER,"FW,MF",20,Greuther Fürth,2. Bundesliga,24.5,16,7,5,6,5,8,20,40.0,12,26,1,25,4,20,6,0
Arnau Ortiz,ESP,"MF,FW",22,Eldense,Segunda Division,3.2,3,2,0,1,2,2,9,22.2,7,3,0,3,2,5,2,0
Arnau Ortiz,ESP,"FW,MF",22,Cartagena,Segunda Division,5.5,8,5,3,2,3,6,8,75.0,2,7,0,7,4,12,1,0
Arnau Puigmal,ESP,"MF,DF",23,Elche,Segunda Division,6.6,8,7,4,4,0,3,5,60.0,2,3,0,3,6,14,1,0
Arnau Solà,ESP,DF,21,Cartagena,Segunda Division,9.1,27,16,15,10,2,15,24,62.5,9,9,5,4,12,39,22,0
Arnaud Ake,CIV,FW,25,Tijuana,Liga MX,1.5,1,1,0,0,1,1,1,100.0,0,0,0,0,0,1,1,0
Arnaud Ake,CIV,FW,25,Mazatlán,Liga MX,5.9,4,1,0,2,2,2,5,40.0,3,3,0,3,0,4,6,0
Arnaud Balijon,FRA,GK,40,Dunkerque,Ligue 2,23.2,1,0,0,1,0,1,1,100.0,0,0,0,0,0,1,5,1
Arnaud Souquet,FRA,DF,30,Fire,MLS,20.3,34,24,20,9,5,16,37,43.2,21,20,7,13,22,56,43,0
Arne Sicker,GER,"DF,FW",26,Elversberg,2. Bundesliga,1.8,1,1,1,0,0,0,3,0.0,3,4,0,4,2,3,5,0
Arnór Sigurðsson,ISL,"FW,MF",24,Blackburn,EFL,16.2,16,7,5,8,3,6,19,31.6,13,8,3,5,5,21,14,0
Arquimides Ordonez,GUA,FW,19,FC Cincinnati,MLS,3.1,6,5,1,2,3,1,2,50.0,1,2,1,1,0,6,0,0
Artur,BRA,MF,26,Dynamo FC,MLS,30.3,70,44,35,27,8,27,53,50.9,26,33,11,22,44,114,42,0
Artur Ioniță,MDA,MF,32,Calcio Lecco 1912,Serie B,31.6,47,32,15,28,4,14,41,34.1,27,32,5,27,18,65,29,0
Arturo Calabresi,ITA,DF,27,Pisa,Serie B,16.0,41,32,22,17,2,21,32,65.6,11,14,5,9,11,52,28,1
Arturo Ortiz,MEX,DF,30,FC Juárez,Liga MX,6.5,15,11,11,4,0,7,16,43.8,9,6,3,3,19,34,38,0
Arturo Ortiz,MEX,DF,30,UNAM,Liga MX,5.4,11,8,6,5,0,3,9,33.3,6,7,4,3,8,19,25,0
Arvin Appiah,ENG,"FW,MF",22,Rotherham Utd,EFL,9.3,9,6,3,4,2,4,10,40.0,6,11,0,11,5,14,2,0
Ashley Barnes,ENG,"MF,FW",33,Norwich City,EFL,27.8,15,10,6,6,3,8,18,44.4,10,18,6,12,4,19,29,1
Ashley Fletcher,ENG,"FW,MF",27,Sheffield Weds,EFL,6.8,7,6,0,2,5,2,5,40.0,3,4,0,4,3,10,7,0
Ashley Phillips,WAL,DF,18,Plymouth Argyle,EFL,15.4,20,9,12,8,0,10,13,76.9,3,23,17,6,16,36,73,2
Ashley Westwood,ENG,MF,32,Charlotte,MLS,28.1,15,9,5,8,2,8,23,34.8,15,16,6,10,10,25,18,1
Asier Illarramendi,ESP,MF,32,FC Dallas,MLS,7.7,17,10,11,6,0,8,20,40.0,12,15,3,12,18,35,9,0
Asmir Begović,BIH,GK,36,QPR,EFL,45.0,2,2,2,0,0,1,2,50.0,1,0,0,0,1,3,14,2
Assan Ouedraogo,GER,"MF,FW",17,Schalke 04,2. Bundesliga,9.2,7,5,3,3,1,3,4,75.0,1,12,3,9,3,10,6,0
Assane Dioussé,SEN,MF,25,Auxerre,Ligue 2,18.2,42,24,17,18,7,25,46,54.3,21,29,9,20,27,69,18,0
Augusto Lotti,ITA,FW,27,Cruz Azul,Liga MX,1.5,2,1,0,2,0,2,3,66.7,1,1,0,1,0,2,0,0
Augusto Solari,ARG,"FW,MF",31,Atlas,Liga MX,12.8,33,16,14,17,2,19,52,36.5,33,19,2,17,10,43,10,0
Aurel Badji Wagbe,GER,DF,19,Holstein Kiel,2. Bundesliga,0.0,0,0,0,0,0,0,1,0.0,1,0,0,0,0,0,0,0
Aurélien Scheidler,FRA,FW,26,FC Andorra,Segunda Division,17.0,3,2,0,3,0,2,7,28.6,5,6,0,6,2,5,14,0
Aurélien Scheidler,FRA,FW,25,Bari,Serie B,1.1,0,0,0,0,0,0,1,0.0,1,0,0,0,0,0,1,0
Avilés Hurtado,COL,"FW,MF",36,FC Juárez,Liga MX,19.2,23,16,8,10,5,5,21,23.8,16,23,0,23,11,34,7,1
Axel Kei,USA,FW,15,RSL,MLS,0.1,0,0,0,0,0,0,0,0.0,0,0,0,0,0,0,0,0
Axel Tuanzebe,COD,DF,25,Ipswich Town,EFL,15.3,26,20,13,8,5,17,20,85.0,3,15,5,10,24,50,43,0
Axel Urie,CTA,"MF,FW",24,US Concarneau,Ligue 2,19.2,15,8,6,9,0,8,13,61.5,5,19,1,18,8,23,9,0
Ayman Arguigue,MAR,FW,19,Huesca,Segunda Division,0.0,0,0,0,0,0,0,0,0.0,0,0,0,0,0,0,0,0
Ayman Ben Mohamed,TUN,DF,28,Guingamp,Ligue 2,12.6,40,29,21,17,2,24,41,58.5,17,16,3,13,22,62,32,0
Aymen Barkok,MAR,MF,25,Hertha BSC,2. Bundesliga,9.4,24,20,13,10,1,10,21,47.6,11,9,0,9,13,37,17,0
Aymen Boutoutaou,FRA,"MF,FW",22,Valenciennes,Ligue 2,16.0,43,26,18,17,8,23,47,48.9,24,13,2,11,16,59,10,0
Aynsley Pears,ENG,GK,25,Blackburn,EFL,25.7,2,1,2,0,0,2,3,66.7,1,0,0,0,0,2,17,2
Ayo Akinola,CAN,"FW,MF",23,SJ Earthquakes,MLS,0.6,3,1,3,0,0,1,1,100.0,0,2,1,1,0,3,2,0
Ayo Akinola,CAN,FW,23,Toronto FC,MLS,6.2,1,1,0,1,0,0,2,0.0,2,5,0,5,0,1,3,0
Ayoub Amraoui,MAR,DF,19,Amiens,Ligue 2,7.5,18,12,14,4,0,13,22,59.1,9,3,0,3,2,20,14,1
Ayoub Jabbari,MAR,FW,23,Paris FC,Ligue 2,9.0,5,2,2,1,2,1,5,20.0,4,7,4,3,3,8,9,0
Ayrton Preciado,ECU,"MF,DF",29,Querétaro,Liga MX,0.4,0,0,0,0,0,0,1,0.0,1,1,0,1,0,0,2,0
Aziel Jackson,USA,"MF,FW",21,St. Louis,MLS,12.4,27,15,9,13,5,14,36,38.9,22,17,2,15,5,32,3,0
Aïman Maurer,MAR,"MF,FW",18,Dunkerque,Ligue 2,7.7,16,8,5,9,2,9,21,42.9,12,8,1,7,11,27,5,0
Ba-Muaka Simakala,CGO,"MF,FW",26,Holstein Kiel,2. Bundesliga,3.6,6,4,3,3,0,3,6,50.0,3,6,0,6,1,7,2,0
Ba-Muaka Simakala,CGO,"MF,FW",26,Kaiserslautern,2. Bundesliga,1.3,1,0,0,1,0,1,2,50.0,1,2,0,2,1,2,0,0
Babatunde Akinsola,NGA,"MF,FW",21,Valladolid,Segunda Division,3.2,3,2,2,0,1,2,4,50.0,2,3,0,3,4,7,3,0
Bae Junho,KOR,"FW,MF",19,Stoke City,EFL,26.6,44,27,19,17,8,14,25,56.0,11,42,3,39,16,60,2,0
Bailey-Tye Cadamarteri,JAM,FW,18,Sheffield Weds,EFL,12.2,10,7,2,6,2,4,7,57.1,3,14,0,14,1,11,8,0
Bakaye Dibassy,MLI,DF,33,Minnesota Utd,MLS,5.3,6,3,4,2,0,2,4,50.0,2,6,3,3,3,9,14,0
Bakery Jatta,GAM,"FW,MF",25,Hamburger SV,2. Bundesliga,25.1,66,46,22,23,21,28,60,46.7,32,35,3,32,25,91,41,0
Baldovino Cimino,ITA,DF,19,Cosenza,Serie B,8.8,11,8,6,3,2,5,11,45.5,6,6,1,5,6,17,29,0
Bali Mumba,ENG,"FW,DF",21,Plymouth Argyle,EFL,32.8,65,44,43,15,7,26,53,49.1,27,35,6,29,22,87,49,1
Balthazar Pierret,FRA,"MF,DF",23,Quevilly-Rouen,Ligue 2,27.9,77,50,27,44,6,38,67,56.7,29,22,3,19,40,117,39,2
Bambo Diaby,SEN,DF,25,Sheffield Weds,EFL,25.2,31,21,20,9,2,18,28,64.3,10,34,21,13,24,55,98,1
Baptiste Guillaume,BEL,"FW,MF",28,Guingamp,Ligue 2,27.4,16,11,1,10,5,3,11,27.3,8,19,3,16,5,21,20,1
Baptiste Isola,FRA,MF,22,Grenoble,Ligue 2,0.9,4,1,2,1,1,1,2,50.0,1,2,0,2,1,5,0,0
Baptiste Mouazan,FRA,"MF,FW",21,US Concarneau,Ligue 2,25.6,38,23,13,16,9,14,39,35.9,25,23,2,21,10,48,14,0
Baptiste Roux,FRA,"MF,DF",23,Guingamp,Ligue 2,12.1,25,17,9,14,2,12,26,46.2,14,16,3,13,14,39,28,1
Barbu,ESP,DF,23,CD Mirandés,Segunda Division,14.5,3,3,1,2,0,1,4,25.0,3,20,13,7,15,18,69,1
Barcia,ESP,DF,23,CD Mirandés,Segunda Division,37.0,44,33,32,12,0,15,20,75.0,5,32,26,6,44,88,191,2
Barry Bannan,SCO,MF,33,Sheffield Weds,EFL,38.0,59,41,25,26,8,30,56,53.6,26,50,12,38,42,101,47,0
Bartosz Bereszyński,POL,DF,31,Sampdoria,Serie B,1.0,0,0,0,0,0,0,3,0.0,3,0,0,0,0,0,5,0
Bartosz Białkowski,POL,GK,36,Millwall,EFL,14.0,0,0,0,0,0,0,0,0.0,0,0,0,0,0,0,5,1
Bartłomiej Drągowski,POL,GK,25,Spezia,Serie B,13.0,0,0,0,0,0,0,0,0.0,0,0,0,0,0,0,1,1
Barış Atik,GER,"FW,MF",28,Magdeburg,2. Bundesliga,31.4,24,14,7,11,6,11,26,42.3,15,25,0,25,13,37,9,0
Bashir Humphreys,ENG,DF,20,Swansea City,EFL,21.0,22,17,14,6,2,17,31,54.8,14,28,13,15,21,43,74,0
Bashkim Renneke,KVX,DF,30,Osnabrück,2. Bundesliga,19.7,34,23,21,10,3,20,33,60.6,13,20,5,15,25,59,53,0
Batista Mendy,FRA,MF,23,Angers,Ligue 2,2.2,6,5,4,1,1,5,6,83.3,1,0,0,0,2,8,4,0
Baye Mbaye,SEN,"DF,MF",19,Bastia,Ligue 2,1.7,6,3,3,2,1,5,9,55.6,4,2,1,1,3,9,6,0
Bayiha Biumla,FRA,DF,18,Bordeaux,Ligue 2,5.7,6,5,3,3,0,1,3,33.3,2,10,7,3,4,10,21,2
Ben Bender,USA,"MF,FW",21,Charlotte,MLS,10.1,15,8,4,7,4,9,18,50.0,9,10,0,10,5,20,6,0
Ben Cabango,WAL,DF,23,Swansea City,EFL,32.1,50,31,36,13,1,28,46,60.9,18,33,26,7,39,89,153,3
Ben Cremaschi,USA,"MF,FW",17,Inter Miami,MLS,19.9,44,28,17,19,8,27,77,35.1,50,23,2,21,14,58,14,1
Ben Gibson,ENG,DF,30,Norwich City,EFL,31.9,19,13,13,6,0,7,12,58.3,5,55,40,15,46,65,131,2
Ben Hamed Touré,CIV,"FW,MF",19,Ajaccio,Ligue 2,11.4,8,4,1,5,2,1,8,12.5,7,18,4,14,1,9,6,0
Ben Hamer,ENG,GK,35,Watford,EFL,19.0,0,0,0,0,0,0,1,0.0,1,0,0,0,0,0,11,0
Ben Hatton,ENG,MF,18,Rotherham Utd,EFL,0.1,0,0,0,0,0,0,0,0.0,0,0,0,0,0,0,0,0
Ben Jackson,ENG,"DF,MF",22,Huddersfield,EFL,14.9,40,24,22,15,3,22,45,48.9,23,19,8,11,14,54,51,0
Ben Lhassine Kone,CIV,MF,23,Como,Serie B,8.4,9,6,7,1,1,4,12,33.3,8,10,2,8,12,21,9,0
Ben Pearson,ENG,MF,28,Stoke City,EFL,20.5,36,20,9,22,5,21,50,42.0,29,23,4,19,39,75,31,0
Ben Sheaf,ENG,MF,25,Coventry City,EFL,28.8,106,60,45,56,5,47,84,56.0,37,45,10,35,42,148,23,2
Ben Sweat,USA,DF,31,Sporting KC,MLS,3.5,2,2,1,1,0,0,4,0.0,4,2,0,2,5,7,11,0
Ben Sweat,USA,DF,31,NE Revolution,MLS,3.7,5,5,4,1,0,2,5,40.0,3,4,0,4,4,9,10,0
Ben Waine,NZL,FW,22,Plymouth Argyle,EFL,10.2,3,2,0,2,1,0,5,0.0,5,3,0,3,4,7,8,0
Ben Whiteman,ENG,MF,27,Preston,EFL,25.9,38,19,20,14,4,26,46,56.5,20,24,13,11,42,80,50,0
Ben Wiles,ENG,"FW,MF",24,Rotherham Utd,EFL,2.0,2,1,2,0,0,0,0,0.0,0,2,0,2,0,2,2,0
Ben Wiles,ENG,MF,24,Huddersfield,EFL,20.4,22,16,9,13,0,10,22,45.5,12,14,2,12,19,41,19,0
Ben Wilmot,ENG,DF,23,Stoke City,EFL,22.7,18,11,15,1,2,7,19,36.8,12,26,15,11,31,49,74,0
Ben Wilson,ENG,GK,30,Coventry City,EFL,18.0,0,0,0,0,0,0,1,0.0,1,0,0,0,0,0,4,1
Ben Woodburn,WAL,"MF,FW",23,Preston,EFL,2.8,14,10,5,6,3,5,11,45.5,6,7,0,7,7,21,3,0
Ben Zolinski,GER,"DF,FW",31,Kaiserslautern,2. Bundesliga,2.7,5,3,0,3,2,1,7,14.3,6,6,0,6,4,9,9,0
Bence Dárdai,GER,"MF,FW",17,Hertha BSC,2. Bundesliga,2.2,5,5,2,3,0,3,7,42.9,4,6,0,6,0,5,5,0
Benedikt Pichler,AUT,FW,26,Holstein Kiel,2. Bundesliga,13.1,10,5,3,5,2,3,12,25.0,9,8,1,7,2,12,17,0
Benjaloud Youssouf,COM,"DF,FW",29,Dunkerque,Ligue 2,33.4,36,24,22,9,5,22,33,66.7,11,30,4,26,20,56,52,1
Benjamin Bouchouari,MAR,MF,21,Saint-Étienne,Ligue 2,20.0,47,33,13,28,6,20,50,40.0,30,14,1,13,17,64,3,1
Benjamin Chrisene,ENG,DF,19,Blackburn,EFL,9.1,32,21,13,12,7,20,29,69.0,9,14,3,11,13,45,12,0
Benjamin Goller,GER,"FW,MF",24,Nürnberg,2. Bundesliga,24.5,26,17,15,7,4,12,27,44.4,15,26,4,22,15,41,18,0
Benjamin Kikanovic,USA,"FW,MF",23,SJ Earthquakes,MLS,7.8,9,5,5,0,4,3,11,27.3,8,9,0,9,8,17,9,0
Benjamin Leroy,FRA,GK,34,Quevilly-Rouen,Ligue 2,36.0,3,2,3,0,0,3,5,60.0,2,0,0,0,1,4,28,2
Benjamin Lundt,GER,GK,27,St. Louis,MLS,1.0,0,0,0,0,0,0,0,0.0,0,0,0,0,0,0,0,0
Benjamin Nelson,ENG,DF,19,Leicester City,EFL,2.3,5,5,3,2,0,3,5,60.0,2,1,1,0,5,10,7,0
Benjamin Santelli,FRA,FW,31,Bastia,Ligue 2,21.2,38,34,17,16,5,21,52,40.4,31,29,4,25,9,47,39,0
Benjamin Stitz,USA,FW,22,FC Cincinnati,MLS,0.2,0,0,0,0,0,0,1,0.0,1,1,0,1,0,0,0,0
Benjamín Galdames,MEX,"FW,MF",22,Atlético,Liga MX,6.3,14,12,6,6,2,7,16,43.8,9,8,0,8,3,17,4,0
Benny Díaz,MEX,GK,24,FC Juárez,Liga MX,4.0,0,0,0,0,0,0,0,0.0,0,0,0,0,0,0,2,0
Bernabé Barragán,ESP,GK,31,Albacete,Segunda Division,25.0,0,0,0,0,0,0,0,0.0,0,1,0,1,0,0,15,0
Bernard Kamungo,USA,"FW,MF",21,FC Dallas,MLS,5.6,11,5,4,4,3,4,9,44.4,5,3,0,3,3,14,5,0
Bertin Jacquesson,FRA,"FW,MF",22,RSL,MLS,4.0,2,1,0,0,2,2,3,66.7,1,0,0,0,0,2,0,0
Bevic Moussiti-Oko,CGO,FW,28,US Concarneau,Ligue 2,2.5,3,3,0,3,0,0,0,0.0,0,1,0,1,0,3,1,0
Bilal Brahimi,FRA,"FW,MF",23,Caen,Ligue 2,21.8,29,18,9,16,4,10,19,52.6,9,15,1,14,8,37,7,0
Bilal Hussein,SWE,MF,23,Hertha BSC,2. Bundesliga,5.3,10,8,5,4,1,6,13,46.2,7,10,4,6,1,11,8,0
Bill Tuiloma,NZL,DF,27,Charlotte,MLS,15.0,9,2,5,4,0,5,10,50.0,5,16,9,7,21,30,59,1
Billy Koumetio,FRA,DF,20,Dunkerque,Ligue 2,7.2,7,3,4,3,0,4,6,66.7,2,4,1,3,16,23,22,2
Billy Mitchell,ENG,MF,23,Millwall,EFL,24.6,39,21,16,19,4,19,31,61.3,12,27,7,20,32,71,26,0
Billy Sharp,ENG,"FW,MF",37,Hull City,EFL,3.7,4,2,3,0,1,2,4,50.0,2,5,0,5,0,4,4,0
Billy Sharp,ENG,FW,36,LA Galaxy,MLS,7.9,2,1,0,2,0,0,1,0.0,1,4,3,1,0,2,7,0
Bingourou Kamara,SEN,GK,26,Pau FC,Ligue 2,36.0,2,1,2,0,0,2,10,20.0,8,0,0,0,0,2,21,4
Birk Risa,NOR,DF,24,NYCFC,MLS,9.6,9,4,6,3,0,6,11,54.5,5,4,3,1,8,17,33,0
Birkir Bjarnason,ISL,MF,35,Brescia,Serie B,21.4,19,12,6,12,1,6,19,31.6,13,15,4,11,6,25,18,1
Bjarke Jacobsen,DEN,MF,29,Wehen,2. Bundesliga,14.5,47,30,17,27,3,17,31,54.8,14,26,11,15,14,61,43,0
Bjarki Bjarkason,ISL,"MF,DF",23,Venezia,Serie B,15.4,14,6,6,6,2,7,15,46.7,8,20,2,18,7,21,15,1
Blendi Idrizi,KVX,"MF,FW",25,Schalke 04,2. Bundesliga,7.2,13,8,8,5,0,8,14,57.1,6,10,1,9,4,17,8,0
Bobby Allain,FRA,GK,31,Grenoble,Ligue 2,3.0,0,0,0,0,0,0,0,0.0,0,0,0,0,0,0,0,1
Bobby Thomas,ENG,DF,23,Coventry City,EFL,41.8,63,41,44,17,2,40,63,63.5,23,80,54,26,54,117,190,3
Bobby Wood,USA,FW,30,NE Revolution,MLS,16.5,9,5,1,6,2,5,12,41.7,7,7,3,4,3,12,13,0
Bode Davis,USA,DF,20,RSL,MLS,13.1,22,15,14,6,2,12,22,54.5,10,15,4,11,15,37,25,0
Bojan Radulovic,SRB,FW,23,Huddersfield,EFL,4.2,3,2,0,2,1,1,1,100.0,0,3,0,3,1,4,6,0
Bongokuhle Hlongwane,RSA,FW,22,Minnesota Utd,MLS,27.6,48,35,18,21,9,17,40,42.5,23,54,5,49,26,74,26,0
Boris Tomiak,GER,"DF,MF",24,Kaiserslautern,2. Bundesliga,28.8,45,30,28,14,3,27,50,54.0,23,32,12,20,36,81,114,0
Borja Bastón,ESP,FW,31,Oviedo,Segunda Division,26.7,13,10,5,4,4,5,11,45.5,6,16,1,15,3,16,22,0
Borja Garcés,ESP,FW,24,Elche,Segunda Division,6.8,7,3,3,4,0,2,3,66.7,1,3,1,2,2,9,5,0
Borja González,ESP,DF,28,Burgos,Segunda Division,18.7,46,29,29,12,5,27,47,57.4,20,15,7,8,22,68,55,0
Borja López,ESP,DF,30,Leganés,Segunda Division,0.5,0,0,0,0,0,0,0,0.0,0,1,1,0,0,0,1,0
Borja Sainz,ESP,FW,22,Norwich City,EFL,22.8,63,34,29,28,6,27,67,40.3,40,24,1,23,22,85,10,0
Borja Sánchez Laborde,ESP,"FW,MF",28,Oviedo,Segunda Division,5.2,13,8,4,5,4,3,14,21.4,11,5,0,5,2,15,8,0
Borja Sánchez Laborde,ESP,"MF,DF",27,León,Liga MX,3.9,8,5,6,1,1,3,10,30.0,7,3,0,3,0,8,3,0
Botond Balogh,HUN,DF,21,Parma,Serie B,15.0,26,13,17,8,1,11,17,64.7,6,13,7,6,28,54,59,0
Brad Guzan,USA,GK,38,Atlanta Utd,MLS,27.0,0,0,0,0,0,0,1,0.0,1,0,0,0,0,0,5,2
Brad Potts,ENG,DF,29,Preston,EFL,29.5,80,54,44,27,9,45,87,51.7,42,61,10,51,45,125,48,0
Brad Smith,AUS,"DF,FW",28,Dynamo FC,MLS,5.3,8,5,3,4,1,2,8,25.0,6,5,1,4,2,10,14,0
Brad Stuver,USA,GK,31,Austin,MLS,34.0,2,1,2,0,0,0,0,0.0,0,0,0,0,0,2,12,3
Bradley Collins,ENG,GK,26,Coventry City,EFL,28.0,0,0,0,0,0,0,1,0.0,1,0,0,0,0,0,15,4
Bradley Dack,ENG,"FW,MF",29,Sunderland,EFL,6.5,8,7,2,5,1,3,10,30.0,7,7,1,6,3,11,2,0
Bradley Danger,FRA,DF,25,Rodez Aveyron,Ligue 2,35.2,50,29,37,13,0,29,45,64.4,16,47,21,26,58,108,111,3
Brahim Traoré,FRA,"DF,MF",19,Caen,Ligue 2,34.6,60,36,29,26,5,40,67,59.7,27,46,21,25,39,99,113,2
Brahima Diarra,MLI,"MF,FW",20,Huddersfield,EFL,7.3,20,11,7,7,6,8,20,40.0,12,13,3,10,4,24,4,0
Braian Cufré,ARG,DF,26,NYCFC,MLS,20.7,39,25,18,19,2,18,33,54.5,15,30,4,26,17,56,37,0
Braian Galván,ARG,"FW,DF",22,Rapids,MLS,7.4,6,2,2,3,1,4,8,50.0,4,5,1,4,8,14,3,0
Braian Ojeda,PAR,MF,22,RSL,MLS,24.0,55,32,18,30,7,26,60,43.3,34,27,6,21,41,96,21,0
Braian Romero,ARG,"FW,MF",32,Tijuana,Liga MX,0.6,1,1,0,1,0,1,2,50.0,1,0,0,0,1,2,0,0
Braian Samudio,PAR,"MF,FW",27,Necaxa,Liga MX,8.8,18,13,8,9,1,9,32,28.1,23,5,0,5,6,24,11,0
Brais Martinez,ESP,DF,22,Racing Ferrol,Segunda Division,16.1,59,38,34,22,3,37,62,59.7,25,29,2,27,20,79,48,0
Bram Lagae,BEL,DF,19,Dunkerque,Ligue 2,14.6,22,12,17,3,2,11,14,78.6,3,22,12,10,15,37,55,0
Brandon Bye,USA,DF,27,NE Revolution,MLS,18.5,27,18,13,11,3,14,21,66.7,7,20,9,11,20,47,59,0
Brandon Cambridge,USA,"FW,DF",20,Charlotte,MLS,1.5,0,0,0,0,0,0,1,0.0,1,1,0,1,1,1,3,0
Brandon Khela,ENG,FW,18,Birmingham City,EFL,0.0,0,0,0,0,0,0,0,0.0,0,1,0,1,0,0,0,0
Brandon Servania,USA,"MF,FW",23,Toronto FC,MLS,18.9,52,30,23,23,6,23,57,40.4,34,25,3,22,10,62,17,0
Brandon Soppy,FRA,DF,21,Schalke 04,2. Bundesliga,3.5,7,5,5,1,1,5,9,55.6,4,7,3,4,4,11,10,0
Brandon Thomas-Asante,GHA,FW,24,West Brom,EFL,30.4,16,5,5,6,5,4,15,26.7,11,17,2,15,16,32,6,0
Brandon Vazquez,USA,FW,24,FC Cincinnati,MLS,26.4,12,10,5,4,3,8,30,26.7,22,31,3,28,4,16,14,0
Brandon Vazquez,USA,"FW,MF",24,Monterrey,Liga MX,8.3,5,2,0,2,3,4,12,33.3,8,10,2,8,7,12,13,1
Brandon Williams,ENG,DF,22,Ipswich Town,EFL,8.9,28,21,18,9,1,14,25,56.0,11,7,3,4,14,42,16,2
Brandt Bronico,USA,MF,27,Charlotte,MLS,28.8,48,30,18,22,8,27,65,41.5,38,32,9,23,23,71,36,0
Branimir Hrgota,SWE,"MF,FW",30,Greuther Fürth,2. Bundesliga,32.3,42,28,13,17,12,18,41,43.9,23,27,2,25,11,53,7,1
Brayan Angulo,COL,DF,33,Puebla,Liga MX,31.4,65,39,35,26,4,35,65,53.8,30,16,2,14,35,100,55,0
Brayan Gjyla,ITA,"FW,DF",16,FeralpiSalò,Serie B,0.1,0,0,0,0,0,0,0,0.0,0,0,0,0,0,0,0,0
Brayan Vera,COL,DF,24,RSL,MLS,22.7,41,28,28,10,3,22,41,53.7,19,36,13,23,25,66,79,1
Brayton Vázquez,MEX,"DF,MF",25,Querétaro,Liga MX,0.4,1,1,0,1,0,0,0,0.0,0,0,0,0,0,1,1,0
Brecht Dejaegere,BEL,"FW,MF",31,Charlotte,MLS,5.3,10,6,2,6,2,4,8,50.0,4,10,0,10,5,15,3,0
Brendan Galloway,ZIM,DF,27,Plymouth Argyle,EFL,17.5,38,22,27,10,1,18,25,72.0,7,26,19,7,30,68,81,0
Brendan Hines-Ike,USA,DF,28,D.C. United,MLS,10.4,12,9,9,3,0,5,10,50.0,5,14,11,3,11,23,46,1
Brenner,BRA,FW,23,FC Cincinnati,MLS,5.9,6,5,3,2,1,4,9,44.4,5,6,0,6,2,8,2,0
Brenno,BRA,GK,24,Bari,Serie B,32.7,0,0,0,0,0,0,1,0.0,1,0,0,0,0,0,10,3
Brent Kallman,USA,"DF,FW",32,Minnesota Utd,MLS,2.2,3,2,3,0,0,2,6,33.3,4,4,1,3,0,3,11,0
Bret Halsey,USA,DF,22,FC Cincinnati,MLS,2.6,6,5,4,1,1,4,9,44.4,5,3,1,2,1,7,4,0
Brian Anunga,CMR,MF,26,Nashville,MLS,6.3,14,10,7,6,1,8,17,47.1,9,6,3,3,11,25,4,0
Brian Bayeye,COD,DF,23,Ascoli,Serie B,12.3,22,16,12,8,2,17,25,68.0,8,10,2,8,13,35,22,0
Brian Behrendt,GER,DF,31,Braunschweig,2. Bundesliga,6.0,8,4,5,3,0,6,7,85.7,1,10,5,5,10,18,24,0
Brian Beyer,FRA,"FW,MF",26,Annecy,Ligue 2,4.1,4,2,0,3,1,2,4,50.0,2,4,0,4,2,6,5,0
Brian García,MEX,DF,25,Toluca,Liga MX,29.5,43,28,24,14,5,28,53,52.8,25,42,7,35,33,76,53,0
Brian Gutiérrez,USA,"FW,MF",19,Fire,MLS,26.5,45,22,18,22,5,14,49,28.6,35,29,3,26,8,53,11,1
Brian Lozano,URU,FW,29,Atlas,Liga MX,4.6,11,8,5,4,2,6,10,60.0,4,7,0,7,3,14,1,0
Brian Oliván,ESP,DF,30,Espanyol,Segunda Division,28.1,42,27,23,13,6,18,25,72.0,7,20,11,9,16,58,67,0
Brian Rodríguez,URU,"FW,MF",23,América,Liga MX,14.7,10,8,3,7,0,6,16,37.5,10,11,1,10,4,14,2,0
Brian Rubio,MEX,FW,26,Mazatlán,Liga MX,5.1,10,3,2,5,3,4,7,57.1,3,4,1,3,0,10,8,0
Brian Rubio,MEX,FW,26,León,Liga MX,4.9,4,0,0,1,3,1,4,25.0,3,1,0,1,1,5,9,0
Brian White,USA,FW,26,Vancouver W'caps,MLS,28.2,21,11,1,13,7,5,16,31.3,11,22,4,18,4,25,24,0
Brice Maubleu,FRA,GK,33,Grenoble,Ligue 2,35.0,0,0,0,0,0,0,0,0.0,0,0,0,0,1,1,16,1
Bright Arrey-Mbi,GER,DF,20,Hannover 96,2. Bundesliga,27.3,62,39,38,22,2,34,45,75.6,11,39,16,23,41,103,95,1
Bright Gyamfi,GHA,DF,27,Cosenza,Serie B,10.5,12,9,7,5,0,7,16,43.8,9,9,5,4,8,20,49,0
Brodie Gilmore,NIR,DF,19,Huddersfield,EFL,17.0,45,34,23,15,7,26,37,70.3,11,34,7,27,22,67,48,1
Brooke Norton-Cuffy,ENG,"DF,MF",19,Millwall,EFL,25.3,62,35,33,23,6,42,58,72.4,16,29,5,24,24,86,45,0
Brooklyn Ezeh,GER,DF,22,Hannover 96,2. Bundesliga,3.7,4,3,4,0,0,2,6,33.3,4,3,1,2,1,5,5,1
Brooklyn Raines,USA,"MF,FW",17,Dynamo FC,MLS,2.2,4,4,2,2,0,2,2,100.0,0,3,0,3,4,8,1,0
Brooks Lennon,USA,DF,25,Atlanta Utd,MLS,32.0,37,22,19,15,3,21,37,56.8,16,33,12,21,27,64,80,0
Bruce El-Mesmari,MEX,"FW,DF",21,América,Liga MX,0.2,1,0,0,1,0,0,0,0.0,0,1,0,1,0,1,0,0
Brugui,ESP,"MF,FW",27,Levante,Segunda Division,20.6,32,19,13,13,6,15,41,36.6,26,16,0,16,19,51,16,0
Bruno,BRA,GK,25,Venezia,Serie B,9.0,0,0,0,0,0,0,1,0.0,1,0,0,0,0,0,4,1
Bruno Amione,ARG,DF,21,Santos,Liga MX,9.7,23,14,16,6,1,13,15,86.7,2,13,7,6,7,30,26,0
Bruno Martella,ITA,DF,30,FeralpiSalò,Serie B,26.9,22,15,15,3,4,12,22,54.5,10,32,15,17,34,56,97,1
Bruno Xavier Almeida Costa,POR,MF,26,Valenciennes,Ligue 2,8.3,12,6,5,7,0,7,19,36.8,12,7,2,5,3,15,2,0
Bryan Acosta,HON,MF,29,Rapids,MLS,12.4,22,15,14,7,1,6,16,37.5,10,17,5,12,7,29,14,1
Bryan Acosta,HON,MF,29,Portland Timbers,MLS,5.1,18,12,5,11,2,12,23,52.2,11,4,2,2,8,26,4,0
Bryan Colula,MEX,DF,27,Mazatlán,Liga MX,15.2,44,28,29,8,7,34,51,66.7,17,12,6,6,10,54,47,0
Bryan Gamboa,MEX,"FW,DF",21,Cruz Azul,Liga MX,0.6,1,1,0,1,0,1,1,100.0,0,0,0,0,0,1,1,0
Bryan Garnica,MEX,"MF,DF",27,Necaxa,Liga MX,30.8,42,20,23,14,5,20,49,40.8,29,39,4,35,27,69,35,0
Bryan González,MEX,"DF,MF",20,Pachuca,Liga MX,12.7,19,13,11,3,5,8,19,42.1,11,15,0,15,17,36,18,1
Bryan Lasme,FRA,"FW,MF",24,Schalke 04,2. Bundesliga,13.5,11,5,2,5,4,3,5,60.0,2,4,0,4,1,12,18,0
Bryan Oviedo,CRC,DF,32,RSL,MLS,19.9,40,27,27,8,5,20,38,52.6,18,17,7,10,24,64,49,0
Bryan Teixeira,CPV,"FW,MF",22,Magdeburg,2. Bundesliga,6.0,8,5,1,5,2,3,5,60.0,2,5,0,5,3,11,3,0
Bryce Duke,USA,MF,21,Inter Miami,MLS,4.9,9,3,4,5,0,5,6,83.3,1,3,0,3,7,16,0,0
Bryce Duke,USA,"MF,FW",21,CF Montréal,MLS,16.3,24,13,6,14,4,14,24,58.3,10,13,0,13,15,39,2,0
Buba Sangaré,ESP,DF,16,Levante,Segunda Division,1.0,5,4,3,2,0,3,3,100.0,0,4,0,4,3,8,2,1
Budu Zivzivadze,GEO,FW,29,Karlsruher,2. Bundesliga,14.8,17,12,5,8,4,4,18,22.2,14,16,2,14,6,23,6,0
Byron Castillo,ECU,DF,24,Pachuca,Liga MX,7.3,25,15,14,9,2,9,17,52.9,8,10,2,8,5,30,27,0
C.J. Sapong,USA,FW,34,Nashville,MLS,4.2,5,1,0,2,3,1,1,100.0,0,3,0,3,3,8,4,0
C.J. Sapong,USA,FW,34,Toronto FC,MLS,14.1,8,4,1,5,2,1,5,20.0,4,2,1,1,7,15,16,0
C.J. dos Santos,USA,GK,22,Inter Miami,MLS,1.0,0,0,0,0,0,0,0,0.0,0,0,0,0,0,0,1,0
CJ Fodrey,USA,"DF,FW",18,Austin,MLS,0.4,0,0,0,0,0,0,0,0.0,0,1,0,1,0,0,0,0
Cacho Guzmán,ESP,MF,21,Tenerife,Segunda Division,0.3,0,0,0,0,0,0,0,0.0,0,0,0,0,1,1,0,0
Cade Cowell,USA,FW,19,SJ Earthquakes,MLS,17.1,15,9,5,6,4,9,20,45.0,11,20,2,18,6,21,6,0
Cade Cowell,USA,FW,19,Guadalajara,Liga MX,7.2,6,4,2,1,3,1,8,12.5,7,4,0,4,3,9,1,0
Caden Glover,USA,MF,15,St. Louis,MLS,0.2,0,0,0,0,0,0,0,0.0,0,1,0,1,0,0,0,0
Cafú,POR,MF,30,Rotherham Utd,EFL,20.0,15,10,3,9,3,7,12,58.3,5,11,1,10,15,30,8,0
Caleb Taylor,ENG,DF,20,West Brom,EFL,0.3,1,0,1,0,0,1,2,50.0,1,0,0,0,0,1,0,0
Caleb Wiley,USA,"DF,FW",18,Atlanta Utd,MLS,25.9,41,26,23,10,8,26,49,53.1,23,26,6,20,29,70,35,0
Caleb Zady Sery,CIV,"MF,FW",23,Caen,Ligue 2,4.4,3,2,0,3,0,2,3,66.7,1,2,0,2,2,5,0,0
Callum Brittain,ENG,"DF,MF",25,Blackburn,EFL,40.3,78,54,43,19,16,37,65,56.9,28,67,13,54,39,117,104,1
Callum Doyle,ENG,DF,19,Leicester City,EFL,13.4,41,29,17,21,3,28,39,71.8,11,21,7,14,15,56,37,1
Callum Marshall,NIR,FW,18,West Brom,EFL,0.6,1,0,0,1,0,0,0,0.0,0,1,0,1,0,1,0,0
Callum O'Dowda,IRL,"FW,DF",28,Cardiff City,EFL,6.1,14,7,5,6,3,6,13,46.2,7,12,6,6,3,17,12,1
Callum O'Hare,ENG,"MF,FW",25,Coventry City,EFL,19.6,35,17,11,18,6,13,25,52.0,12,21,2,19,8,43,9,0
Callum Paterson,SCO,"MF,DF",28,Sheffield Weds,EFL,17.9,31,21,15,11,5,19,38,50.0,19,18,6,12,13,44,43,0
Callum Robinson,IRL,"MF,FW",28,Cardiff City,EFL,9.4,4,2,1,2,1,2,7,28.6,5,2,0,2,4,8,4,0
Callum Styles,HUN,"DF,MF",23,Sunderland,EFL,9.0,22,14,9,11,2,13,22,59.1,9,10,4,6,8,30,15,0
Callum Wright,ENG,"MF,FW",23,Plymouth Argyle,EFL,8.9,13,8,5,2,6,7,14,50.0,7,8,0,8,7,20,4,0
Calum Kavanagh,IRL,"FW,DF",19,Middlesbrough,EFL,0.1,0,0,0,0,0,0,0,0.0,0,0,0,0,0,0,0,0
Calvin Brackelmann,GER,DF,23,Paderborn 07,2. Bundesliga,8.2,16,9,13,3,0,9,15,60.0,6,11,2,9,8,24,37,0
Calvin Harris,ENG,FW,22,Rapids,MLS,10.0,12,6,2,9,1,6,8,75.0,2,7,1,6,5,17,9,0
Calvin Ramsay,SCO,DF,20,Preston,EFL,1.5,3,3,1,2,0,3,7,42.9,4,1,0,1,1,4,3,0
Cam Cilley,USA,"FW,MF",22,SJ Earthquakes,MLS,0.0,0,0,0,0,0,0,0,0.0,0,0,0,0,0,0,0,0
Cameron Burgess,AUS,DF,27,Ipswich Town,EFL,38.0,25,16,17,7,1,18,28,64.3,10,51,35,16,49,74,184,1
Cameron Dawson,ENG,GK,28,Sheffield Weds,EFL,18.0,1,1,1,0,0,1,2,50.0,1,0,0,0,0,1,5,1
Cameron Duke,USA,DF,21,Sporting KC,MLS,1.5,5,3,4,1,0,1,4,25.0,3,0,0,0,5,10,3,0
Cameron Dunbar,USA,"MF,FW",20,Minnesota Utd,MLS,1.3,2,0,1,1,0,1,3,33.3,2,0,0,0,2,4,2,0
Cameron Harper,USA,"DF,MF",21,NY Red Bulls,MLS,23.9,40,30,14,17,9,25,63,39.7,38,37,3,34,11,51,27,1
Cameron Humphreys,ENG,DF,24,Rotherham Utd,EFL,22.5,20,11,14,6,0,15,21,71.4,6,26,17,9,32,52,104,1
Cameron Humphreys,ENG,DF,19,Ipswich Town,EFL,1.1,2,1,1,1,0,2,6,33.3,4,5,0,5,2,4,6,0
Cameron Pring,ENG,DF,25,Bristol City,EFL,37.8,85,58,53,25,7,51,92,55.4,41,65,25,40,53,138,99,0
Camilo Cándido,URU,"DF,FW",28,Cruz Azul,Liga MX,7.1,6,3,1,5,0,3,10,30.0,7,8,0,8,8,14,12,0
Camilo Sanvezzo,BRA,"FW,MF",35,Querétaro,Liga MX,6.6,6,3,1,2,3,1,4,25.0,3,2,0,2,1,7,6,0
Camilo Vargas,COL,GK,34,Atlas,Liga MX,34.0,2,1,2,0,0,1,3,33.3,2,0,0,0,1,3,12,1
Can Yılmaz Uzun,TUR,"MF,FW",17,Nürnberg,2. Bundesliga,22.1,20,11,7,10,3,6,22,27.3,16,19,2,17,3,23,6,1
Carl Johansson,SWE,DF,29,Holstein Kiel,2. Bundesliga,7.9,4,3,4,0,0,2,4,50.0,2,13,12,1,18,22,45,0
Carl Klaus,GER,GK,29,Nürnberg,2. Bundesliga,18.2,0,0,0,0,0,0,3,0.0,3,0,0,0,0,0,7,4
Carl Rushworth,ENG,GK,22,Swansea City,EFL,46.0,2,1,2,0,0,2,4,50.0,2,0,0,0,3,5,17,4
Carles Gil,ESP,MF,30,NE Revolution,MLS,29.1,22,19,8,11,3,12,36,33.3,24,12,1,11,14,36,5,0
Carlo,ESP,MF,23,Villarreal B,Segunda Division,32.0,82,50,36,37,9,35,61,57.4,26,45,4,41,49,131,37,1
Carlo Boukhalfa,MAR,"MF,FW",24,St. Pauli,2. Bundesliga,1.1,3,2,2,1,0,2,6,33.3,4,4,1,3,2,5,2,0
Carlo Sickinger,GER,DF,26,Elversberg,2. Bundesliga,22.8,46,35,39,5,2,31,47,66.0,16,23,11,12,48,94,101,1
Carlos Acevedo,MEX,GK,27,Santos,Liga MX,22.3,0,0,0,0,0,0,1,0.0,1,0,0,0,0,0,10,1
Carlos Akapo,EQG,DF,29,SJ Earthquakes,MLS,23.8,61,37,37,13,11,30,56,53.6,26,32,7,25,42,103,79,1
Carlos Alcaraz,ARG,"MF,FW",20,Southampton,EFL,12.2,29,18,6,15,8,15,28,53.6,13,21,2,19,6,35,14,0
Carlos Alonso Vargas,MEX,DF,24,Cruz Azul,Liga MX,0.8,2,2,1,0,1,1,2,50.0,1,1,0,1,1,3,2,0
Carlos Baltazar,MEX,"MF,FW",26,Puebla,Liga MX,6.6,11,8,1,9,1,4,6,66.7,2,6,1,5,3,14,7,0
Carlos Clerc,ESP,DF,32,Elche,Segunda Division,33.5,74,43,34,33,7,40,60,66.7,20,31,8,23,55,129,115,0
Carlos Coronel,PAR,GK,26,NY Red Bulls,MLS,34.0,0,0,0,0,0,0,0,0.0,0,0,0,0,0,0,21,5
Carlos Ernesto Cisneros,MEX,"MF,DF",29,Guadalajara,Liga MX,0.6,0,0,0,0,0,0,0,0.0,0,1,0,1,1,1,0,0
Carlos Espí,ESP,FW,18,Levante,Segunda Division,0.4,1,0,0,0,1,1,2,50.0,1,1,1,0,1,2,1,0
Carlos Felipe Rodríguez,MEX,GK,34,UANL,Liga MX,10.0,0,0,0,0,0,0,1,0.0,1,0,0,0,0,0,1,2
Carlos Galicia,MEX,MF,19,Tijuana,Liga MX,0.2,0,0,0,0,0,0,0,0.0,0,1,0,1,0,0,0,0
Carlos González Espínola,PAR,FW,30,Tijuana,Liga MX,29.9,13,5,1,7,5,4,12,33.3,8,14,4,10,7,20,20,0
Carlos Gruezo,ECU,MF,27,SJ Earthquakes,MLS,23.9,40,25,13,21,6,21,49,42.9,28,31,9,22,25,65,31,0
Carlos Gutiérrez,ESP,DF,32,Huesca,Segunda Division,1.2,4,2,2,2,0,1,2,50.0,1,2,1,1,2,6,15,0
Carlos Gutiérrez,MEX,"DF,MF",24,UNAM,Liga MX,3.1,7,4,4,2,1,5,17,29.4,12,10,0,10,1,8,0,0
Carlos Gómez,COL,"MF,FW",20,RSL,MLS,15.5,27,22,12,9,6,10,32,31.3,22,22,2,20,8,35,3,0
Carlos Hernández,ESP,DF,33,Eldense,Segunda Division,24.8,48,30,32,16,0,24,30,80.0,6,27,19,8,21,69,143,1
Carlos Isaac,ESP,"DF,MF",26,Albacete,Segunda Division,21.5,46,32,22,18,6,23,42,54.8,19,20,3,17,26,72,57,0
Carlos Izquierdoz,ARG,DF,35,Sporting Gijón,Segunda Division,19.4,23,18,18,5,0,14,22,63.6,8,25,15,10,23,46,103,0
Carlos Martín,ESP,"FW,MF",22,CD Mirandés,Segunda Division,31.8,38,19,14,13,11,16,46,34.8,30,44,5,39,19,57,24,0
Carlos Moreno,MEX,GK,25,Pachuca,Liga MX,29.0,1,1,1,0,0,1,3,33.3,2,0,0,0,1,2,9,4
Carlos Nieto,ESP,DF,28,Zaragoza,Segunda Division,4.3,7,3,2,4,1,3,5,60.0,2,3,0,3,6,13,8,0
Carlos Orrantía,MEX,"DF,MF",32,Toluca,Liga MX,12.4,23,14,13,8,2,16,27,59.3,11,7,1,6,21,44,20,0
Carlos Pomares Rayo,ESP,DF,31,Oviedo,Segunda Division,6.3,16,13,11,4,1,9,12,75.0,3,7,1,6,8,24,23,0
Carlos Robles,MEX,DF,23,Atlas,Liga MX,10.8,20,15,13,7,0,7,9,77.8,2,20,13,7,19,39,41,1
Carlos Romero,ESP,"DF,MF",22,Villarreal B,Segunda Division,19.0,32,16,13,16,3,20,44,45.5,24,24,3,21,14,46,28,1
Carlos Rotondi,ARG,"DF,MF",26,Cruz Azul,Liga MX,27.6,71,51,28,35,8,34,67,50.7,33,44,0,44,24,95,58,0
Carlos Salcedo,MEX,DF,29,Cruz Azul,Liga MX,19.8,14,10,11,3,0,10,23,43.5,13,19,14,5,17,31,79,1
Carlos Sanchez,ESP,DF,23,Cartagena,Segunda Division,1.5,7,2,5,2,0,3,4,75.0,1,2,0,2,2,9,4,0
Carlos Sánchez,MEX,DF,21,Pachuca,Liga MX,6.0,20,16,9,7,4,12,19,63.2,7,8,2,6,8,28,5,0
Carlos Terán,COL,DF,22,Fire,MLS,17.5,28,16,22,6,0,14,18,77.8,4,21,11,10,21,49,69,0
Carlos Valenzuela,ARG,"FW,MF",26,Tijuana,Liga MX,0.4,1,1,1,0,0,1,2,50.0,1,0,0,0,0,1,0,0
Carlos Vela,MEX,FW,33,LAFC,MLS,23.0,10,6,1,6,3,6,22,27.3,16,12,0,12,5,15,6,0
Carlos Vicente,ESP,"FW,MF",25,Racing Ferrol,Segunda Division,19.9,17,11,9,4,4,10,24,41.7,14,27,2,25,6,23,10,1
Carlos Álvarez,ESP,MF,20,Levante,Segunda Division,20.9,39,23,20,14,5,13,39,33.3,26,25,2,23,14,53,9,0
Cas Odenthal,NED,DF,22,Como,Serie B,28.3,40,21,30,9,1,27,37,73.0,10,34,16,18,19,59,143,0
Casper de Norre,BEL,MF,26,Millwall,EFL,22.4,52,30,29,23,0,25,41,61.0,16,18,5,13,32,84,33,0
Cassius Mailula,RSA,"FW,MF",21,Toronto FC,MLS,0.8,0,0,0,0,0,0,2,0.0,2,0,0,0,1,1,0,0
Cedric Gondo,CIV,FW,26,Reggiana,Serie B,23.4,21,11,9,9,3,6,11,54.5,5,12,4,8,5,26,18,0
Cedric Omoigui,NGA,FW,29,Racing Sant,Segunda Division,0.2,0,0,0,0,0,0,0,0.0,0,0,0,0,0,0,0,0
Cedric Teuchert,GER,"FW,MF",26,Hannover 96,2. Bundesliga,14.1,7,5,0,3,4,3,12,25.0,9,10,0,10,2,9,5,0
Celso Ortiz,PAR,MF,34,Pachuca,Liga MX,5.6,23,12,8,13,2,10,22,45.5,12,5,2,3,10,33,7,0
Celso Ortiz,PAR,MF,34,Monterrey,Liga MX,2.1,3,0,2,1,0,2,5,40.0,3,1,1,0,8,11,1,0
Cesar Falletti,URU,"MF,FW",30,Ternana,Serie B,17.5,19,11,6,8,5,14,31,45.2,17,7,1,6,3,22,2,0
Cesar Falletti,URU,"MF,FW",30,Cremonese,Serie B,10.1,10,5,3,7,0,7,13,53.8,6,11,0,11,2,12,1,0
Cesare Casadei,ITA,MF,20,Leicester City,EFL,9.8,17,12,9,7,1,8,18,44.4,10,9,2,7,8,25,12,0
Chaka Traorè,CIV,"FW,MF",18,Palermo,Serie B,2.2,3,3,1,1,1,2,5,40.0,3,2,0,2,1,4,1,0
Chapela,ESP,"MF,FW",25,Eldense,Segunda Division,27.2,22,16,12,5,5,11,33,33.3,22,28,6,22,14,36,34,0
Charles Boli,FRA,"MF,DF",24,Pau FC,Ligue 2,13.1,20,13,7,9,4,9,20,45.0,11,10,0,10,16,36,20,0
Charles Pickel,COD,MF,26,Cremonese,Serie B,16.1,26,16,7,16,3,13,26,50.0,13,25,2,23,17,43,15,0
Charles Sagoe Jr,ENG,FW,19,Swansea City,EFL,0.3,0,0,0,0,0,0,1,0.0,1,0,0,0,0,0,0,0
Charles Traore,MLI,DF,31,Bastia,Ligue 2,9.5,11,9,5,5,1,6,9,66.7,3,9,3,6,17,28,19,0
Charlie Cresswell,ENG,DF,20,Leeds United,EFL,1.5,3,3,1,2,0,2,2,100.0,0,3,3,0,3,6,6,0
Charlie Kelman,USA,"MF,FW",21,QPR,EFL,2.7,0,0,0,0,0,0,2,0.0,2,2,0,2,0,0,1,0
Charlie Lennon,ENG,"FW,MF",17,Middlesbrough,EFL,0.2,0,0,0,0,0,0,0,0.0,0,0,0,0,0,0,0,0
Charlie Patino,ENG,MF,19,Swansea City,EFL,14.0,19,7,2,16,1,9,18,50.0,9,16,5,11,17,36,13,2
Charlie Wyke,ENG,FW,30,Rotherham Utd,EFL,5.1,4,4,0,3,1,1,5,20.0,4,3,0,3,0,4,6,0
Charly Rodríguez,MEX,MF,26,Cruz Azul,Liga MX,27.8,46,25,10,32,4,19,58,32.8,39,11,1,10,27,73,12,0
Chase Gasper,USA,DF,27,Dynamo FC,MLS,2.3,2,1,1,0,1,2,5,40.0,3,2,0,2,1,3,8,0
Che Adams,SCO,FW,27,Southampton,EFL,25.4,19,15,3,9,7,8,12,66.7,4,18,7,11,5,24,11,0
Check Keita,FRA,DF,20,Bastia,Ligue 2,25.8,54,37,37,17,0,20,28,71.4,8,25,15,10,15,69,95,1
Ched Evans,WAL,"FW,MF",34,Preston,EFL,8.3,2,2,0,0,2,2,10,20.0,8,4,1,3,4,6,2,0
Cheikh Fall,SEN,MF,19,Saint-Étienne,Ligue 2,0.1,0,0,0,0,0,0,0,0.0,0,0,0,0,0,0,0,0
Chema,ESP,DF,32,Alcorcón,Segunda Division,18.4,22,14,17,4,1,14,14,100.0,0,20,16,4,26,48,93,2
Chiki,ESP,"FW,MF",27,Alcorcón,Segunda Division,29.0,9,7,3,4,2,3,16,18.8,13,23,1,22,11,20,27,0
Chinonso Offor,NGA,FW,22,CF Montréal,MLS,16.8,9,6,2,2,5,2,12,16.7,10,12,2,10,2,11,18,0
Chiquinho,POR,FW,23,Stoke City,EFL,0.7,3,2,0,1,2,0,0,0.0,0,0,0,0,0,3,2,0
Chris Durkin,USA,MF,22,D.C. United,MLS,21.9,46,34,16,22,8,25,47,53.2,22,26,7,19,21,67,27,1
Chris Hegardt,USA,"FW,MF",21,Charlotte,MLS,0.6,2,1,0,2,0,0,0,0.0,0,0,0,0,0,2,0,0
Chris Mavinga,COD,DF,31,LA Galaxy,MLS,12.5,8,4,6,2,0,4,8,50.0,4,16,11,5,10,18,43,2
Chris Maxwell,WAL,GK,33,Huddersfield,EFL,7.7,0,0,0,0,0,0,0,0.0,0,0,0,0,0,0,4,0
Chris Mueller,USA,"FW,MF",26,Fire,MLS,7.9,7,7,2,4,1,5,12,41.7,7,14,1,13,3,10,6,0
Chris Rigg,ENG,"FW,MF",16,Sunderland,EFL,8.9,18,10,7,10,1,10,18,55.6,8,9,2,7,2,20,5,0
Chris Rindov,USA,DF,21,Sporting KC,MLS,0.1,0,0,0,0,0,0,0,0.0,0,1,1,0,0,0,0,0
Chris Willock,ENG,"FW,MF",25,QPR,EFL,25.5,49,29,20,24,5,28,54,51.9,26,35,1,34,15,64,5,0
Christ Tiéhi,CIV,MF,25,Rotherham Utd,EFL,34.0,75,43,34,35,6,29,61,47.5,32,56,19,37,39,114,46,0
Christian Benteke,BEL,FW,32,D.C. United,MLS,31.0,15,6,0,8,7,3,12,25.0,9,15,3,12,4,19,30,0
Christian Conteh,GER,"FW,MF",23,Osnabrück,2. Bundesliga,18.5,6,5,5,1,0,5,14,35.7,9,12,2,10,8,14,10,0
Christian D'Urso,ITA,FW,26,Cosenza,Serie B,1.6,4,1,3,1,0,2,4,50.0,2,2,0,2,0,4,0,0
Christian Dalle Mura,ITA,DF,21,Ternana,Serie B,9.9,15,9,11,4,0,12,19,63.2,7,19,13,6,11,26,40,0
Christian Fassnacht,SUI,"FW,MF",29,Norwich City,EFL,20.2,49,32,25,21,3,23,55,41.8,32,31,2,29,23,72,27,0
Christian Gytkjær,DEN,FW,33,Venezia,Serie B,19.9,11,5,2,8,1,5,17,29.4,12,12,3,9,6,17,15,0
Christian Joel,CUB,GK,24,Sporting Gijón,Segunda Division,4.1,0,0,0,0,0,0,0,0.0,0,0,0,0,0,0,4,0
Christian Kinsombi,GER,MF,23,Hansa Rostock,2. Bundesliga,9.9,17,12,11,5,1,9,14,64.3,5,8,0,8,3,20,10,1
Christian Makoun,VEN,"DF,MF",22,NE Revolution,MLS,5.4,14,6,7,7,0,5,8,62.5,3,6,2,4,6,20,15,0
Christian Mathenia,GER,GK,31,Nürnberg,2. Bundesliga,14.7,0,0,0,0,0,0,0,0.0,0,0,0,0,0,0,13,1
Christian Oliva,URU,MF,27,FC Juárez,Liga MX,5.6,11,6,4,6,1,6,13,46.2,7,4,1,3,2,13,6,0
Christian Ramirez,USA,"FW,MF",31,Crew,MLS,17.9,1,0,0,1,0,0,5,0.0,5,8,1,7,2,3,15,0
Christian Rivera,COL,MF,27,Tijuana,Liga MX,31.3,137,91,51,80,6,47,91,51.6,44,33,12,21,42,179,33,0
Christian Tabó,URU,"FW,MF",29,Cruz Azul,Liga MX,2.4,5,4,2,1,2,1,3,33.3,2,3,1,2,2,7,1,0
Christian Tabó,URU,"MF,FW",29,UNAM,Liga MX,3.2,3,2,1,1,1,1,4,25.0,3,3,0,3,2,5,3,0
Christian Walton,ENG,GK,27,Ipswich Town,EFL,0.0,0,0,0,0,0,0,0,0.0,0,0,0,0,0,0,0,0
Christoph Daferner,GER,FW,25,Düsseldorf,2. Bundesliga,5.4,6,4,2,3,1,2,5,40.0,3,2,0,2,1,7,6,0
Christoph Daferner,GER,FW,25,Nürnberg,2. Bundesliga,2.1,1,0,1,0,0,1,1,100.0,0,0,0,0,0,1,1,0
Christoph Kobald,AUT,DF,25,Karlsruher,2. Bundesliga,5.8,9,7,7,2,0,7,11,63.6,4,5,5,0,8,17,30,0
Christophe Vincent,FRA,"MF,FW",30,Bastia,Ligue 2,25.9,41,27,18,16,7,24,62,38.7,38,31,1,30,16,57,6,1
Christopher Attys,HAI,"MF,DF",22,FeralpiSalò,Serie B,0.2,1,1,0,1,0,0,0,0.0,0,1,0,1,0,1,0,0
Christopher Brady,USA,GK,18,Fire,MLS,29.3,0,0,0,0,0,0,2,0.0,2,0,0,0,1,1,20,3
Christopher Donovan,USA,FW,22,Philadelphia,MLS,4.3,5,4,0,4,1,4,12,33.3,8,5,1,4,2,7,2,0
Christopher Ibayi,CGO,FW,28,Ajaccio,Ligue 2,14.3,10,7,2,4,4,3,7,42.9,4,5,2,3,3,13,9,0
Christopher McVey,SWE,DF,25,Inter Miami,MLS,13.5,21,9,11,8,2,9,20,45.0,11,14,8,6,23,44,34,0
Christopher Scott,GER,"MF,DF",21,Hannover 96,2. Bundesliga,0.6,0,0,0,0,0,0,0,0.0,0,0,0,0,1,1,1,0
Christopher Trejo,MEX,"FW,MF",23,Atlas,Liga MX,4.5,2,1,0,1,1,1,3,33.3,2,1,0,1,2,4,1,0
Christos Almpanis,GRE,"FW,MF",29,FC Andorra,Segunda Division,0.5,2,1,2,0,0,1,1,100.0,0,0,0,0,0,2,0,0
Christos Kourfalidis,GRE,MF,20,FeralpiSalò,Serie B,24.8,41,25,15,19,7,15,43,34.9,28,48,11,37,25,66,34,0
Christos Tzolis,GRE,"FW,MF",21,Düsseldorf,2. Bundesliga,26.3,25,15,9,13,3,13,26,50.0,13,28,1,27,8,33,16,1
Chuca,ESP,"MF,FW",27,Racing Ferrol,Segunda Division,4.8,7,4,4,3,0,5,12,41.7,7,4,1,3,2,9,2,0
Churripi,ESP,GK,30,Burgos,Segunda Division,41.0,2,2,2,0,0,1,1,100.0,0,0,0,0,0,2,15,3
Cian Ashford,WAL,FW,18,Cardiff City,EFL,3.5,7,3,6,1,0,3,8,37.5,5,3,0,3,1,8,3,0
Ciaran Clark,IRL,DF,33,Stoke City,EFL,3.0,3,0,3,0,0,0,1,0.0,1,3,2,1,7,10,21,1
Ciaran McGuckin,NIR,"FW,MF",19,Rotherham Utd,EFL,0.7,5,5,1,3,1,0,2,0.0,2,1,0,1,1,6,0,0
Claud Adjapong,ITA,DF,25,Ascoli,Serie B,8.3,15,6,12,3,0,4,8,50.0,4,10,5,5,2,17,19,0
Claudio Baeza,CHI,MF,29,Toluca,Liga MX,23.6,74,45,34,36,4,35,74,47.3,39,20,6,14,22,96,30,0
Claudio Bravo,ARG,DF,25,Portland Timbers,MLS,25.9,68,39,45,21,2,36,92,39.1,56,51,7,44,39,107,62,0
Claudio Cassano,ITA,"MF,FW",20,Cittadella,Serie B,18.8,24,14,3,14,7,10,34,29.4,24,20,0,20,1,25,4,1
Claudio Gomes,FRA,MF,23,Palermo,Serie B,29.3,34,23,13,15,6,15,21,71.4,6,15,7,8,17,51,45,0
Clint Irwin,USA,GK,33,Minnesota Utd,MLS,4.0,0,0,0,0,0,0,0,0.0,0,0,0,0,0,0,4,0
Clément Akpa,CIV,DF,21,Auxerre,Ligue 2,15.2,27,19,12,12,3,18,26,69.2,8,17,5,12,24,51,35,0
Clément Billemaz,FRA,"MF,FW",24,Annecy,Ligue 2,18.2,22,12,4,13,5,11,38,28.9,27,33,5,28,18,40,18,1
Clément Depres,FRA,FW,28,Rodez Aveyron,Ligue 2,6.7,4,1,1,2,1,1,5,20.0,4,6,3,3,3,7,6,0
Clément Diop,SEN,GK,29,Atlanta Utd,MLS,1.5,0,0,0,0,0,0,0,0.0,0,0,0,0,0,0,0,0
Clément Grenier,FRA,"MF,FW",33,Racing Sant,Segunda Division,8.7,23,15,12,7,4,12,24,50.0,12,12,2,10,12,35,11,0
Clément Michelin,FRA,DF,26,Bordeaux,Ligue 2,24.6,40,25,24,11,5,21,30,70.0,9,26,9,17,35,75,49,0
Clément Rodrigues,FRA,"FW,MF",22,US Concarneau,Ligue 2,10.4,8,3,2,3,3,1,7,14.3,6,6,0,6,2,10,2,0
Clément Vidal,FRA,DF,23,Ajaccio,Ligue 2,23.4,23,13,18,5,0,17,25,68.0,8,20,13,7,28,51,102,2
Cody Baker,USA,DF,19,Seattle,MLS,7.6,18,13,11,6,1,11,17,64.7,6,7,3,4,4,22,20,0
Cody Drameh,ENG,DF,21,Birmingham City,EFL,25.1,80,55,50,23,7,45,68,66.2,23,49,8,41,24,104,92,4
Cody Drameh,ENG,DF,21,Leeds United,EFL,0.2,1,0,1,0,0,1,1,100.0,0,1,1,0,1,2,0,1
Cohen Bramall,ENG,DF,27,Rotherham Utd,EFL,32.7,40,25,25,13,2,24,46,52.2,22,38,16,22,30,70,83,0
Cole Bassett,USA,"MF,FW",21,Rapids,MLS,21.1,37,23,21,10,6,11,34,32.4,23,15,2,13,8,45,15,0
Colin Dagba,FRA,DF,24,Auxerre,Ligue 2,5.9,14,9,6,4,4,10,20,50.0,10,4,0,4,8,22,7,0
Colin Kleine-Bekel,GER,DF,20,Holstein Kiel,2. Bundesliga,23.5,29,17,23,5,1,15,29,51.7,14,24,16,8,31,60,124,0
Collin Smith,USA,"DF,MF",19,FC Dallas,MLS,1.2,0,0,0,0,0,0,2,0.0,2,0,0,0,1,1,2,0
Connor Krempicki,GER,MF,28,Magdeburg,2. Bundesliga,11.5,13,7,2,7,4,5,10,50.0,5,10,2,8,2,15,13,1
Connor Metcalfe,AUS,"FW,MF",23,St. Pauli,2. Bundesliga,20.5,29,14,8,18,3,17,35,48.6,18,25,4,21,9,38,25,0
Connor O'Riordan,IRL,DF,20,Blackburn,EFL,0.5,0,0,0,0,0,0,0,0.0,0,0,0,0,1,1,1,0
Connor Roberts,WAL,"DF,FW",27,Leeds United,EFL,3.5,5,3,4,1,0,4,5,80.0,1,2,0,2,1,6,8,0
Connor Ronan,IRL,MF,24,Rapids,MLS,31.6,32,20,18,12,2,20,60,33.3,40,22,5,17,20,52,26,2
Conor Chaplin,ENG,MF,26,Ipswich Town,EFL,37.1,37,22,12,20,5,17,51,33.3,34,24,0,24,27,64,35,0
Conor Coady,ENG,DF,30,Leicester City,EFL,7.8,6,3,2,4,0,3,4,75.0,1,7,6,1,7,13,25,1
Conor Hazard,NIR,GK,25,Plymouth Argyle,EFL,27.0,0,0,0,0,0,0,0,0.0,0,0,0,0,0,0,13,0
Conor Townsend,ENG,DF,30,West Brom,EFL,34.7,56,41,31,19,6,28,48,58.3,20,30,7,23,29,85,98,2
Corentin Jean,FRA,"FW,MF",27,Inter Miami,MLS,9.2,18,12,6,9,3,11,17,64.7,6,4,1,3,3,21,7,0
Corey Baird,USA,FW,27,Dynamo FC,MLS,25.9,23,17,7,12,4,14,47,29.8,33,15,0,15,8,31,14,0
Corry Evans,NIR,MF,33,Sunderland,EFL,0.8,1,1,1,0,0,1,1,100.0,0,0,0,0,1,2,1,0
Cory Burke,JAM,FW,31,NY Red Bulls,MLS,10.8,26,18,4,14,8,7,21,33.3,14,11,1,10,4,30,5,0
Cosimo Marco Da Graca,ITA,"FW,MF",22,Amorebieta,Segunda Division,4.9,1,1,0,1,0,0,0,0.0,0,4,0,4,1,2,6,0
Costantino Favasuli,ITA,"DF,MF",19,Ternana,Serie B,12.5,41,27,24,13,4,17,34,50.0,17,27,4,23,22,63,23,1
Cris Montes,ESP,MF,26,Eldense,Segunda Division,12.1,17,9,11,5,1,5,26,19.2,21,20,1,19,8,25,5,1
Cristhian Paredes,PAR,MF,24,Portland Timbers,MLS,21.2,73,38,26,35,12,32,62,51.6,30,27,5,22,18,91,19,0
Cristian Ansaldi,ARG,DF,36,Parma,Serie B,5.5,7,4,2,3,2,4,6,66.7,2,4,2,2,0,7,14,0
Cristian Arango,COL,FW,27,RSL,MLS,8.4,11,8,2,3,6,5,8,62.5,3,7,1,6,2,13,8,0
Cristian Buonaiuto,ITA,"MF,FW",30,Cremonese,Serie B,8.4,18,11,9,7,2,10,17,58.8,7,5,0,5,5,23,0,0
Cristian Calderón,MEX,DF,26,América,Liga MX,10.7,25,16,16,7,2,14,23,60.9,9,10,5,5,8,33,12,0
Cristian Calderón,MEX,DF,26,Guadalajara,Liga MX,11.2,26,18,16,8,2,21,30,70.0,9,8,3,5,7,33,18,0
Cristian Cauz,ITA,DF,26,Modena,Serie B,16.6,21,12,11,10,0,10,20,50.0,10,15,10,5,24,45,77,1
Cristian Cásseres Jr.,VEN,MF,23,NY Red Bulls,MLS,16.0,41,24,15,20,6,15,40,37.5,25,19,2,17,19,60,12,0
Cristian Espinoza,ARG,"FW,MF",27,SJ Earthquakes,MLS,33.7,47,33,22,11,14,22,84,26.2,62,37,2,35,21,68,23,0
Cristian González Bautista,MEX,"DF,MF",25,Necaxa,Liga MX,4.4,5,3,4,1,0,5,10,50.0,5,6,1,5,1,6,4,0
Cristian Gutierrez,ESP,DF,23,Eibar,Segunda Division,22.8,60,42,31,17,12,36,58,62.1,22,29,3,26,26,86,48,1
Cristian Jiménez,MEX,"DF,MF",21,Cruz Azul,Liga MX,1.0,3,2,2,1,0,3,4,75.0,1,0,0,0,3,6,0,0
Cristian Olivera,URU,FW,20,LAFC,MLS,6.7,14,8,4,5,5,7,14,50.0,7,7,0,7,2,16,2,0
Cristian Rivera,ESP,MF,26,Sporting Gijón,Segunda Division,15.5,45,23,21,18,6,15,28,53.6,13,16,5,11,23,68,24,2
Cristian Roldan,USA,"FW,DF",27,Seattle,MLS,13.9,22,14,10,9,3,10,21,47.6,11,14,0,14,9,31,14,0
Cristian Salvador,ESP,"MF,DF",29,Elche,Segunda Division,5.0,15,9,5,10,0,5,13,38.5,8,6,0,6,8,23,16,0
Cristian Álvarez,ARG,GK,38,Zaragoza,Segunda Division,12.7,0,0,0,0,0,0,0,0.0,0,0,0,0,0,0,2,0
Cristiano Piccini,ITA,DF,30,Magdeburg,2. Bundesliga,10.9,24,18,17,7,0,15,20,75.0,5,16,9,7,20,44,18,0
Cristiano Piccini,ITA,DF,30,Sampdoria,Serie B,7.2,13,10,9,1,3,5,8,62.5,3,7,7,0,6,19,22,0
Cristián Dajome,COL,"FW,DF",29,D.C. United,MLS,8.7,14,10,6,7,1,4,19,21.1,15,5,1,4,4,18,5,0
Cristián Dajome,COL,"MF,FW",29,Vancouver W'caps,MLS,3.3,6,3,4,0,2,3,7,42.9,4,2,0,2,4,10,1,0
Cristián Gutiérrez,CHI,DF,25,Toronto FC,MLS,2.7,2,0,1,1,0,2,4,50.0,2,4,0,4,5,7,2,0
Crysencio Summerville,NED,FW,21,Leeds United,EFL,38.9,61,39,17,25,19,28,52,53.8,24,34,1,33,22,83,23,0
Cucho,COL,FW,23,Crew,MLS,26.3,24,11,6,10,8,11,28,39.3,17,20,1,19,10,34,7,0
Cuenca,ESP,"FW,DF",21,Zaragoza,Segunda Division,0.1,0,0,0,0,0,0,0,0.0,0,0,0,0,0,0,1,0
Curro,ESP,"FW,MF",28,Burgos,Segunda Division,39.3,40,26,15,17,8,15,34,44.1,19,33,0,33,4,44,14,0
Cyril Mandouki,MTQ,MF,31,Paris FC,Ligue 2,33.9,41,24,17,21,3,21,67,31.3,46,32,6,26,41,82,53,2
Cyrille Bayala,BFA,"MF,FW",27,Ajaccio,Ligue 2,4.6,6,5,1,3,2,3,7,42.9,4,2,0,2,4,10,3,0
Cyrus Christie,IRL,"DF,MF",30,Hull City,EFL,14.4,19,9,8,7,4,9,23,39.1,14,23,8,15,12,31,40,0
Cédric Avinel,GLP,DF,36,Ajaccio,Ligue 2,28.8,26,17,19,6,1,12,17,70.6,5,30,20,10,32,58,81,0
Cédric Brunner,SUI,DF,29,Schalke 04,2. Bundesliga,12.8,28,17,11,13,4,16,21,76.2,5,12,2,10,10,38,27,0
Cédric Hountondji,BEN,DF,29,Angers,Ligue 2,30.4,39,22,23,16,0,19,27,70.4,8,35,18,17,45,84,116,0
Cédric Kipré,CIV,DF,26,West Brom,EFL,42.5,53,33,36,16,1,35,55,63.6,20,67,44,23,65,118,167,1
Célio Pompeu,BRA,"FW,MF",23,St. Louis,MLS,10.8,36,26,14,15,7,18,41,43.9,23,28,1,27,7,43,6,0
César Araujo,URU,MF,21,Orlando City,MLS,30.3,51,31,20,23,8,29,91,31.9,62,40,7,33,23,74,31,0
César Bustos,MEX,DF,17,Monterrey,Liga MX,3.6,10,6,6,4,0,5,9,55.6,4,4,0,4,2,12,5,0
César Garza,MEX,"MF,FW",18,Monterrey,Liga MX,2.8,5,2,0,5,0,1,2,50.0,1,2,0,2,2,7,4,0
César Huerta,MEX,"FW,MF",22,UNAM,Liga MX,27.3,64,41,18,40,6,33,65,50.8,32,29,0,29,10,74,6,0
César López,MEX,FW,21,Necaxa,Liga MX,0.3,1,0,0,1,0,1,1,100.0,0,0,0,0,0,1,1,0
César Sosa,MEX,MF,19,FC Juárez,Liga MX,1.2,2,1,0,2,0,2,4,50.0,2,2,1,1,0,2,2,0
César Tárrega,ESP,DF,22,Valladolid,Segunda Division,14.5,30,19,19,11,0,11,21,52.4,10,18,14,4,23,53,53,0
César de la Hoz,ESP,"MF,DF",32,Valladolid,Segunda Division,10.7,28,20,12,13,3,9,22,40.9,13,9,2,7,13,41,19,0
D.J. Taylor,USA,DF,25,Minnesota Utd,MLS,27.9,66,46,40,21,5,38,63,60.3,25,25,13,12,31,97,86,0
Dael Fry,ENG,DF,25,Middlesbrough,EFL,28.0,21,14,15,6,0,10,14,71.4,4,25,16,9,35,56,123,1
Dagur Dan Þórhallsson,ISL,"DF,MF",22,Orlando City,MLS,13.4,11,9,7,4,0,4,14,28.6,10,12,2,10,9,20,20,0
Daichi Hayashi,JPN,FW,26,Nürnberg,2. Bundesliga,7.0,4,2,2,1,1,2,6,33.3,4,3,1,2,4,8,7,0
Dairon Asprilla,COL,"FW,MF",30,Portland Timbers,MLS,16.1,23,14,9,8,6,8,26,30.8,18,18,0,18,10,33,13,0
Damian Michalski,POL,DF,25,Greuther Fürth,2. Bundesliga,22.9,17,12,15,2,0,12,22,54.5,10,27,18,9,24,41,114,0
Damian Roßbach,GER,DF,30,Hansa Rostock,2. Bundesliga,30.6,53,33,36,13,4,33,55,60.0,22,47,23,24,25,78,154,2
Damien Rivera,CRC,"FW,MF",20,NE Revolution,MLS,2.0,1,1,1,0,0,1,2,50.0,1,2,0,2,1,2,3,0
Damion Lowe,JAM,DF,29,Philadelphia,MLS,13.7,31,19,23,7,1,16,32,50.0,16,15,8,7,35,66,68,0
Damir Kreilach,CRO,"FW,MF",33,RSL,MLS,14.6,2,1,1,0,1,1,9,11.1,8,4,1,3,2,4,15,0
Damián Musto,ARG,MF,37,Cartagena,Segunda Division,30.1,62,40,28,31,3,24,40,60.0,16,25,11,14,46,108,87,2
Dan McNamara,IRL,"DF,MF",24,Millwall,EFL,23.0,50,32,25,22,3,28,50,56.0,22,19,9,10,35,85,84,2
Dan Scarr,ENG,DF,28,Plymouth Argyle,EFL,24.7,21,15,10,11,0,10,20,50.0,10,42,33,9,23,44,131,0
Dane Scarlett,ENG,FW,19,Ipswich Town,EFL,1.8,5,4,1,2,2,2,4,50.0,2,2,0,2,0,5,3,0
Danel Sinani,LUX,"FW,MF",26,St. Pauli,2. Bundesliga,1.5,1,0,0,1,0,0,0,0.0,0,2,0,2,1,2,2,1
Dani Calvo,ESP,DF,30,Oviedo,Segunda Division,39.0,38,26,24,13,1,13,19,68.4,6,40,34,6,31,69,166,1
Dani Escriche,ESP,"FW,MF",26,Huesca,Segunda Division,0.9,0,0,0,0,0,0,0,0.0,0,0,0,0,1,1,0,0
Dani Escriche,ESP,FW,26,Albacete,Segunda Division,20.9,21,7,4,11,6,3,9,33.3,6,17,1,16,12,33,18,0
Dani Fernandez,ESP,DF,27,Racing Sant,Segunda Division,17.9,29,21,14,10,5,16,25,64.0,9,17,10,7,8,37,48,0
Dani Gómez,ESP,FW,25,Levante,Segunda Division,22.6,9,6,1,6,2,2,12,16.7,10,16,0,16,5,14,8,0
Dani Jiménez,ESP,GK,34,Leganés,Segunda Division,2.9,0,0,0,0,0,0,1,0.0,1,0,0,0,0,0,1,0
Dani Ojeda,ESP,"MF,FW",29,Burgos,Segunda Division,23.0,23,16,12,11,0,15,46,32.6,31,31,1,30,13,36,6,0
Dani Queipo,ESP,"MF,DF",22,Sporting Gijón,Segunda Division,7.1,22,11,13,8,1,13,22,59.1,9,11,1,10,3,25,7,1
Dani Raba,ESP,"MF,FW",28,Leganés,Segunda Division,23.9,44,31,14,15,15,24,56,42.9,32,32,6,26,16,60,7,0
Dani Tasende,ESP,DF,23,Villarreal B,Segunda Division,30.6,42,27,26,14,2,27,48,56.3,21,37,13,24,61,103,104,1
Daniel,BRA,GK,28,SJ Earthquakes,MLS,21.6,0,0,0,0,0,0,0,0.0,0,0,0,0,0,0,10,0
Daniel Aceves,MEX,DF,21,Fire,MLS,9.5,29,20,22,7,0,11,24,45.8,13,21,8,13,15,44,34,0
Daniel Aceves,MEX,DF,22,Pachuca,Liga MX,3.4,7,4,3,4,0,2,4,50.0,2,3,2,1,5,12,10,0
Daniel Aguilar,MEX,"DF,FW",25,Puebla,Liga MX,2.6,7,2,4,2,1,1,4,25.0,3,5,1,4,3,10,8,0
Daniel Aguirre,USA,"MF,FW",23,LA Galaxy,MLS,6.4,8,2,5,3,0,5,8,62.5,3,10,2,8,6,14,6,0
Daniel Alexis Parra,MEX,DF,24,Monterrey,Liga MX,1.0,0,0,0,0,0,0,2,0.0,2,0,0,0,2,2,2,0
Daniel Armando Ríos,MEX,"FW,DF",28,Guadalajara,Liga MX,0.8,0,0,0,0,0,0,1,0.0,1,0,0,0,1,1,0,0
Daniel Ayala,ESP,DF,32,Rotherham Utd,EFL,3.9,9,5,5,4,0,2,5,40.0,3,6,4,2,15,24,14,0
Daniel Bachmann,AUT,GK,29,Watford,EFL,27.0,2,2,2,0,0,1,2,50.0,1,0,0,0,1,3,12,2
Daniel Ballard,NIR,DF,23,Sunderland,EFL,42.6,50,34,34,16,0,25,38,65.8,13,58,40,18,35,85,182,1
Daniel Barlaser,TUR,MF,26,Middlesbrough,EFL,25.9,31,21,10,17,4,17,35,48.6,18,16,7,9,21,52,26,3
Daniel Brosinski,GER,"DF,MF",35,Karlsruher,2. Bundesliga,4.7,5,3,4,1,0,2,5,40.0,3,2,1,1,3,8,14,0
Daniel Bunk,GER,MF,19,Düsseldorf,2. Bundesliga,0.0,0,0,0,0,0,0,0,0.0,0,0,0,0,0,0,0,0
Daniel Ciofani,ITA,"FW,DF",38,Cremonese,Serie B,2.6,0,0,0,0,0,0,2,0.0,2,1,0,1,0,0,1,0
Daniel Crisostomo,USA,MF,26,LAFC,MLS,3.1,5,5,2,2,1,0,6,0.0,6,1,1,0,5,10,3,0
Daniel Edelman,USA,MF,19,NY Red Bulls,MLS,20.6,46,24,11,27,8,27,59,45.8,32,32,2,30,27,73,22,0
Daniel Elfadli,LBY,"DF,MF",26,Magdeburg,2. Bundesliga,24.8,67,39,42,23,2,24,40,60.0,16,42,13,29,62,129,84,1
Daniel Fernández,ESP,FW,16,Tenerife,Segunda Division,0.2,1,0,1,0,0,0,0,0.0,0,0,0,0,0,1,0,0
Daniel Ginczek,GER,FW,32,Düsseldorf,2. Bundesliga,4.1,1,0,1,0,0,0,3,0.0,3,1,0,1,0,1,8,0
Daniel Hanslik,GER,"FW,MF",26,Kaiserslautern,2. Bundesliga,9.0,23,14,9,9,5,7,15,46.7,8,11,3,8,3,26,15,0
Daniel Heber,GER,DF,29,Magdeburg,2. Bundesliga,32.2,57,32,35,18,4,31,43,72.1,12,44,23,21,51,108,100,4
Daniel Heuer Fernandes,POR,GK,30,Hamburger SV,2. Bundesliga,20.0,0,0,0,0,0,0,0,0.0,0,1,0,1,1,1,4,1
Daniel Iversen,DEN,GK,26,Stoke City,EFL,18.0,0,0,0,0,0,0,2,0.0,2,0,0,0,0,0,12,0
Daniel James,WAL,FW,25,Leeds United,EFL,27.6,31,16,15,8,8,13,34,38.2,21,31,2,29,8,39,11,0
Daniel Johnson,JAM,"MF,FW",30,Stoke City,EFL,18.1,27,17,7,15,5,12,25,48.0,13,9,2,7,16,43,5,1
Daniel Lasure,ESP,"DF,MF",30,Amorebieta,Segunda Division,24.2,39,23,16,17,6,22,34,64.7,12,23,5,18,23,62,59,0
Daniel Lovitz,USA,DF,31,Nashville,MLS,31.6,55,33,26,15,14,32,54,59.3,22,35,10,25,28,83,73,0
Daniel Luna,COL,"MF,FW",21,CD Mirandés,Segunda Division,1.3,4,4,3,0,1,1,1,100.0,0,2,0,2,0,4,2,0
Daniel Mantilla,COL,"MF,FW",26,Necaxa,Liga MX,3.0,1,0,1,0,0,1,6,16.7,5,3,1,2,1,2,3,0
Daniel Martín,ESP,GK,25,FC Andorra,Segunda Division,16.0,0,0,0,0,0,0,0,0.0,0,2,0,2,0,0,5,4
Daniel Munie,USA,DF,22,SJ Earthquakes,MLS,1.2,0,0,0,0,0,0,1,0.0,1,4,4,0,1,1,12,0
Daniel Musovski,USA,FW,27,RSL,MLS,13.4,15,11,4,10,1,3,19,15.8,16,10,1,9,1,16,9,0
Daniel Neil,ENG,MF,22,Sunderland,EFL,41.0,74,48,33,37,4,34,70,48.6,36,50,6,44,39,113,34,1
Daniel Pereira,VEN,MF,22,Austin,MLS,28.1,39,23,19,16,4,13,73,17.8,60,35,8,27,32,71,25,2
Daniel Requena,ESP,"MF,FW",20,Villarreal B,Segunda Division,15.2,43,24,10,22,11,17,36,47.2,19,19,2,17,20,63,14,0
Daniel Rosero,COL,DF,29,Sporting KC,MLS,25.1,28,13,19,8,1,17,34,50.0,17,34,23,11,34,62,103,2
Daniel Steres,USA,DF,32,Dynamo FC,MLS,20.7,38,26,24,14,0,20,31,64.5,11,30,9,21,17,55,59,0
Daniel Vázquez,MEX,FW,20,Tijuana,Liga MX,0.8,1,1,0,1,0,0,0,0.0,0,0,0,0,0,1,1,0
Daniel Álvarez López,MEX,"MF,FW",29,Puebla,Liga MX,14.8,17,13,3,11,3,10,27,37.0,17,14,4,10,9,26,15,0
Daniele Baselli,ITA,"MF,FW",31,Como,Serie B,9.1,23,17,10,12,1,11,20,55.0,9,6,1,5,16,39,22,0
Daniele Casiraghi,ITA,MF,30,Südtirol,Serie B,32.2,36,19,14,16,6,11,35,31.4,24,30,6,24,18,54,27,0
Daniele Ghilardi,ITA,DF,20,Sampdoria,Serie B,35.4,53,40,35,18,0,29,44,65.9,15,31,12,19,36,89,140,0
Daniele Verde,ITA,"MF,FW",27,Spezia,Serie B,21.9,3,3,2,1,0,1,6,16.7,5,8,0,8,11,14,7,0
Danilo Quaranta,ITA,DF,26,Ascoli,Serie B,21.1,33,20,18,13,2,24,31,77.4,7,16,7,9,19,52,93,1
Danilo Wiebe,GER,"DF,MF",29,Braunschweig,2. Bundesliga,7.9,26,19,15,9,2,11,25,44.0,14,22,4,18,14,40,18,1
Danny Batth,ENG,DF,32,Norwich City,EFL,6.5,5,4,1,4,0,1,4,25.0,3,4,4,0,4,9,40,0
Danny Flores,USA,MF,20,Sporting KC,MLS,0.1,0,0,0,0,0,0,0,0.0,0,0,0,0,0,0,0,0
Danny Latza,GER,MF,33,Schalke 04,2. Bundesliga,3.1,1,1,0,1,0,1,4,25.0,3,5,2,3,5,6,9,0
Danny Leyva,USA,"MF,FW",19,Seattle,MLS,0.2,0,0,0,0,0,0,1,0.0,1,1,0,1,2,2,1,0
Danny Leyva,USA,MF,19,Rapids,MLS,7.1,7,4,4,3,0,3,14,21.4,11,7,3,4,11,18,6,0
Danny Ward,ENG,FW,31,Huddersfield,EFL,12.7,4,3,1,1,2,2,7,28.6,5,5,0,5,0,4,10,0
Danny Wilson,SCO,DF,31,Rapids,MLS,25.7,24,9,14,9,1,8,25,32.0,17,42,26,16,21,45,107,1
Dante Rigo,BEL,MF,24,Grenoble,Ligue 2,32.8,71,43,29,37,5,26,64,40.6,38,55,16,39,54,125,54,1
Dante Sealy,USA,"MF,DF",19,FC Dallas,MLS,3.2,7,5,1,5,1,3,8,37.5,5,6,3,3,1,8,7,0
Dante Vanzeir,BEL,"FW,MF",24,NY Red Bulls,MLS,8.3,5,3,0,2,3,2,11,18.2,9,3,1,2,3,8,5,0
Danylo Ihnatenko,UKR,MF,26,Bordeaux,Ligue 2,25.9,58,35,31,22,5,29,65,44.6,36,28,11,17,47,105,83,2
Daouda Peeters,BEL,MF,24,Südtirol,Serie B,10.7,29,15,9,16,4,11,26,42.3,15,11,6,5,23,52,23,0
Dario Đumić,BIH,DF,32,Eldense,Segunda Division,28.1,20,10,9,9,2,6,12,50.0,6,22,18,4,16,36,121,0
Dario Šarić,BIH,MF,26,Palermo,Serie B,0.1,0,0,0,0,0,0,0,0.0,0,0,0,0,0,0,0,0
Dario Župarić,BIH,DF,30,Portland Timbers,MLS,31.0,34,24,25,6,3,20,32,62.5,12,35,17,18,41,75,104,0
Darko Brašanac,SRB,"MF,FW",32,Leganés,Segunda Division,7.3,14,10,8,4,2,6,13,46.2,7,7,2,5,7,21,9,0
Darko Churlinov,MKD,"MF,FW",23,Schalke 04,2. Bundesliga,3.6,0,0,0,0,0,0,3,0.0,3,5,0,5,0,0,6,0
Darko Gyabi,ENG,"MF,FW",19,Plymouth Argyle,EFL,8.6,19,11,11,7,1,10,18,55.6,8,12,2,10,11,30,12,0
Darko Gyabi,ENG,MF,19,Leeds United,EFL,0.0,0,0,0,0,0,0,0,0.0,0,0,0,0,0,0,0,0
Darling Bladi,FRA,MF,19,Saint-Étienne,Ligue 2,0.1,0,0,0,0,0,0,1,0.0,1,0,0,0,0,0,2,0
Darlington Nagbe,USA,MF,32,Crew,MLS,31.0,29,15,9,13,7,14,32,43.8,18,23,5,18,21,50,20,0
Darnell Furlong,ENG,DF,27,West Brom,EFL,43.7,50,36,22,19,9,27,50,54.0,23,55,27,28,60,110,109,0
Darragh Lenihan,IRL,DF,29,Middlesbrough,EFL,8.0,9,5,4,5,0,4,4,100.0,0,11,9,2,8,17,32,0
Darren Yapi,USA,"FW,MF",18,Rapids,MLS,9.9,11,10,3,6,2,3,11,27.3,8,4,1,3,2,13,11,0
Daryl Dike,USA,FW,23,West Brom,EFL,0.6,2,0,0,2,0,1,1,100.0,0,1,0,1,1,3,1,0
Darío Poveda,ESP,FW,27,Leganés,Segunda Division,0.7,1,1,0,0,1,1,1,100.0,0,0,0,0,1,2,1,0
Darío Poveda,ESP,FW,27,Cartagena,Segunda Division,10.6,1,0,0,1,0,1,4,25.0,3,5,0,5,1,2,4,0
Dauda Mohammed,GHA,"MF,FW",26,Tenerife,Segunda Division,4.0,7,5,3,3,1,3,6,50.0,3,4,0,4,1,8,3,0
Dauda Mohammed,GHA,"FW,MF",26,Eldense,Segunda Division,5.2,3,1,0,1,2,3,7,42.9,4,7,3,4,3,6,0,0
Dave Gnaase,GER,MF,26,Osnabrück,2. Bundesliga,28.1,59,29,28,26,5,24,48,50.0,24,42,11,31,32,91,85,1
David Ayala,ARG,MF,20,Portland Timbers,MLS,1.8,8,5,2,5,1,2,6,33.3,4,4,0,4,4,12,3,0
David Bingham,USA,GK,33,Portland Timbers,MLS,19.0,0,0,0,0,0,0,1,0.0,1,1,0,1,3,3,13,1
David Brooks,WAL,"FW,MF",26,Southampton,EFL,9.9,15,6,6,7,2,7,16,43.8,9,13,2,11,3,18,3,0
David Castro,ESP,DF,28,Racing Ferrol,Segunda Division,29.0,50,30,39,11,0,20,28,71.4,8,19,13,6,29,79,152,0
David Cornell,WAL,GK,32,Preston,EFL,2.0,0,0,0,0,0,0,0,0.0,0,1,0,1,0,0,1,0
David Costas,ESP,DF,29,Oviedo,Segunda Division,17.8,28,17,24,3,1,8,8,100.0,0,15,8,7,34,62,78,1
David Ferreiro,ESP,"MF,FW",36,Cartagena,Segunda Division,3.3,8,4,5,3,0,5,10,50.0,5,2,0,2,3,11,0,0
David Goldar,ESP,DF,29,Burgos,Segunda Division,1.0,1,0,1,0,0,0,2,0.0,2,1,0,1,1,2,4,0
David Herold,GER,DF,20,Karlsruher,2. Bundesliga,12.0,29,20,20,7,2,12,19,63.2,7,13,4,9,13,42,35,0
David Kasumu,ENG,"MF,DF",23,Huddersfield,EFL,26.1,48,25,19,26,3,22,56,39.3,34,40,6,34,22,70,25,0
David Kinsombi,COD,"MF,DF",27,Paderborn 07,2. Bundesliga,19.9,32,22,21,11,0,14,27,51.9,13,21,6,15,20,52,25,1
David Kjær Kruse,DEN,MF,21,Valenciennes,Ligue 2,15.6,23,15,6,12,5,14,37,37.8,23,16,3,13,12,35,9,0
David López,ESP,"DF,MF",21,Elche,Segunda Division,0.0,0,0,0,0,0,0,0,0.0,0,0,0,0,0,0,0,0
David Morillas,ESP,DF,37,Alcorcón,Segunda Division,14.1,24,9,17,5,2,13,20,65.0,7,12,7,5,12,36,49,0
David Nemeth,AUT,DF,22,St. Pauli,2. Bundesliga,4.7,10,5,6,4,0,6,10,60.0,4,6,3,3,4,14,6,1
David Okereke,NGA,"FW,MF",25,Cremonese,Serie B,6.3,7,4,3,3,1,0,5,0.0,5,6,2,4,2,9,0,0
David Rodriguez,USA,"MF,FW",21,Atlético,Liga MX,2.3,6,4,2,2,2,3,3,100.0,0,0,0,0,1,7,2,0
David Romney,USA,DF,29,NE Revolution,MLS,34.0,23,14,15,7,1,19,34,55.9,15,50,31,19,37,60,162,2
David Ruiz,HON,MF,18,Inter Miami,MLS,13.2,31,22,13,11,7,12,32,37.5,20,13,2,11,13,44,2,0
David Tebili,FRA,"FW,MF",18,Bordeaux,Ligue 2,0.3,0,0,0,0,0,0,0,0.0,0,0,0,0,1,1,0,0
David Terans,URU,"MF,FW",28,Pachuca,Liga MX,6.1,4,3,1,2,1,1,5,20.0,4,4,0,4,0,4,1,0
David Timor,ESP,MF,34,Eldense,Segunda Division,33.4,44,30,19,17,8,27,45,60.0,18,42,27,15,39,83,94,1
David Torres,ESP,DF,21,Valladolid,Segunda Division,20.5,26,13,19,6,1,12,16,75.0,4,24,10,14,10,36,56,0
David Turnbull,SCO,"MF,FW",24,Cardiff City,EFL,9.6,11,6,3,7,1,6,11,54.5,5,9,1,8,3,14,7,0
David Vicente,ESP,"MF,DF",25,CD Mirandés,Segunda Division,1.7,2,1,1,1,0,2,4,50.0,2,2,1,1,1,3,5,0
Davide Adorni,ITA,DF,30,Brescia,Serie B,21.5,30,21,18,11,1,18,25,72.0,7,22,14,8,24,54,75,0
Davide Balestrero,ITA,"DF,MF",27,FeralpiSalò,Serie B,27.9,48,31,20,26,2,23,40,57.5,17,52,14,38,33,81,94,1
Davide Barosi,ITA,GK,23,Ascoli,Serie B,2.3,0,0,0,0,0,0,0,0.0,0,0,0,0,0,0,3,0
Davide Di Molfetta,ITA,"MF,FW",27,FeralpiSalò,Serie B,17.6,12,7,4,6,2,7,24,29.2,17,19,3,16,11,23,20,0
Davide Diaw,ITA,"FW,MF",31,Bari,Serie B,6.5,5,4,2,1,2,1,4,25.0,3,10,0,10,1,6,4,0
Davide Guglielmotti,ITA,DF,29,Calcio Lecco 1912,Serie B,11.0,27,17,14,9,4,13,21,61.9,8,8,3,5,11,38,16,0
Davide Guglielmotti,ITA,DF,29,Reggiana,Serie B,0.1,0,0,0,0,0,0,0,0.0,0,0,0,0,0,0,0,0
Davide Veroli,ITA,DF,20,Catanzaro,Serie B,23.4,17,6,12,5,0,11,13,84.6,2,20,8,12,23,40,91,0
Dax McCarty,USA,MF,35,Nashville,MLS,21.0,48,28,23,20,5,26,52,50.0,26,26,12,14,20,68,36,0
Daylam Meddah,FRA,"DF,MF",20,Caen,Ligue 2,4.9,18,13,10,4,4,12,20,60.0,8,5,3,2,8,26,15,0
Dayne St. Clair,CAN,GK,25,Minnesota Utd,MLS,30.0,0,0,0,0,0,0,2,0.0,2,0,0,0,0,0,14,0
DeAndre Yedlin,USA,DF,29,Inter Miami,MLS,25.8,40,22,21,14,5,22,47,46.8,25,34,8,26,31,71,50,0
DeJuan Jones,USA,DF,25,NE Revolution,MLS,24.1,40,23,18,18,4,20,46,43.5,26,40,11,29,31,71,63,0
Deandre Kerr,CAN,"FW,MF",20,Toronto FC,MLS,13.5,11,8,3,7,1,5,12,41.7,7,8,1,7,4,15,4,0
Deiber Caicedo,COL,"MF,FW",22,Vancouver W'caps,MLS,2.2,4,3,1,1,2,2,2,100.0,0,2,0,2,3,7,1,0
Dejan Joveljić,SRB,FW,23,LA Galaxy,MLS,18.1,8,6,0,2,6,1,12,8.3,11,9,3,6,3,11,5,0
Delano Burgzorg,NED,FW,24,Huddersfield,EFL,24.5,13,7,5,6,2,5,13,38.5,8,14,1,13,8,21,7,0
Demba Thiam,FRA,"DF,MF",33,Dunkerque,Ligue 2,9.7,12,9,9,2,1,8,8,100.0,0,5,4,1,6,18,27,0
Dembo Sylla,GUI,"FW,DF",20,Rodez Aveyron,Ligue 2,10.4,27,16,16,6,5,9,11,81.8,2,9,0,9,9,36,16,0
Denil Maldonado,HON,DF,24,LAFC,MLS,18.6,21,14,12,9,0,12,27,44.4,15,19,13,6,23,44,65,0
Denis Bouanga,GAB,FW,28,LAFC,MLS,28.1,31,22,8,18,5,14,44,31.8,30,18,2,16,4,35,18,0
Denis Cheryshev,RUS,"FW,MF",32,Venezia,Serie B,1.9,2,0,1,1,0,0,2,0.0,2,2,0,2,0,2,0,0
Denis Hergheligiu,ITA,MF,23,FeralpiSalò,Serie B,6.1,4,0,3,1,0,2,6,33.3,4,2,1,1,4,8,3,0
Denis Pfaffenrot,GER,MF,18,Greuther Fürth,2. Bundesliga,0.5,0,0,0,0,0,0,2,0.0,2,0,0,0,0,0,0,0
Denis-Will Poha,FRA,MF,26,Quevilly-Rouen,Ligue 2,6.5,14,10,5,9,0,9,14,64.3,5,10,2,8,10,24,7,0
Dennis Appiah,FRA,DF,31,Saint-Étienne,Ligue 2,28.8,88,60,47,35,6,48,80,60.0,32,33,8,25,37,125,69,0
Dennis Cirkin,ENG,DF,21,Sunderland,EFL,5.6,10,8,5,4,1,7,11,63.6,4,11,6,5,4,14,10,0
Dennis Dressel,GER,MF,24,Hansa Rostock,2. Bundesliga,31.6,73,38,32,30,11,39,74,52.7,35,44,5,39,28,101,53,0
Dennis Hadzikadunic,BIH,DF,25,Hamburger SV,2. Bundesliga,21.5,19,12,15,4,0,11,16,68.8,5,24,14,10,15,34,96,4
Dennis Jastrzembski,POL,"FW,DF",23,Düsseldorf,2. Bundesliga,6.4,7,3,4,3,0,2,7,28.6,5,7,1,6,0,7,2,0
Dennis Johnsen,NOR,"FW,MF",25,Venezia,Serie B,15.2,6,4,4,2,0,2,14,14.3,12,11,0,11,4,10,6,0
Dennis Johnsen,NOR,"MF,FW",25,Cremonese,Serie B,9.5,11,6,3,4,4,5,12,41.7,7,7,1,6,1,12,1,0
Dennis Man,ROU,FW,24,Parma,Serie B,26.0,23,12,6,10,7,10,26,38.5,16,18,0,18,17,40,13,0
Dennis Praet,BEL,MF,29,Leicester City,EFL,6.9,3,1,1,1,1,2,3,66.7,1,3,0,3,5,8,12,0
Dennis Srbeny,GER,"FW,MF",29,Greuther Fürth,2. Bundesliga,11.1,6,3,1,2,3,1,9,11.1,8,10,3,7,4,10,3,0
Denzell García,MEX,MF,19,FC Juárez,Liga MX,17.5,31,18,10,16,5,21,51,41.2,30,25,6,19,13,44,28,0
Derek Mazou-Sacko,FRA,"MF,DF",18,Troyes,Ligue 2,4.5,10,4,3,5,2,5,9,55.6,4,5,0,5,4,14,9,0
Derick,BRA,"DF,MF",30,Eldense,Segunda Division,14.8,32,19,17,13,2,11,19,57.9,8,23,8,15,19,51,43,0
Derrick Etienne,HAI,"FW,MF",26,Atlanta Utd,MLS,11.6,10,8,2,5,3,6,21,28.6,15,6,0,6,5,15,2,0
Derrick Jones,USA,"MF,DF",25,Charlotte,MLS,20.5,33,24,18,13,2,12,29,41.4,17,18,7,11,27,60,31,0
Derrick Köhn,GER,"DF,MF",24,Hannover 96,2. Bundesliga,19.5,17,14,7,8,2,9,11,81.8,2,26,3,23,15,32,36,0
Derrick Williams,IRL,DF,30,D.C. United,MLS,20.5,20,11,13,6,1,12,21,57.1,9,23,16,7,25,45,74,1
Derry Murkin,ENG,"DF,FW",24,Schalke 04,2. Bundesliga,20.4,36,23,19,13,4,23,31,74.2,8,24,4,20,30,66,66,0
Derry Scherhant,GER,FW,20,Hertha BSC,2. Bundesliga,8.8,15,9,6,6,3,8,19,42.1,11,11,1,10,6,21,10,0
Devin Padelford,USA,DF,20,Minnesota Utd,MLS,1.7,3,2,2,1,0,1,2,50.0,1,1,0,1,1,4,3,0
Devis Vásquez,COL,GK,25,Sheffield Weds,EFL,9.0,0,0,0,0,0,0,1,0.0,1,0,0,0,0,0,5,0
Devis Vásquez,COL,GK,25,Ascoli,Serie B,9.2,0,0,0,0,0,0,0,0.0,0,0,0,0,0,0,6,1
Dexter Lembikisa,JAM,DF,19,Rotherham Utd,EFL,22.3,56,37,37,13,6,28,45,62.2,17,34,2,32,24,80,56,0
Deyovaisio Zeefuik,NED,"DF,MF",25,Hertha BSC,2. Bundesliga,14.8,30,19,18,9,3,17,22,77.3,5,24,6,18,29,59,55,2
Di'Shon Bernard,JAM,DF,22,Sheffield Weds,EFL,30.3,48,34,32,14,2,20,31,64.5,11,49,24,25,34,82,98,2
Diabé Bolumbu,FRA,DF,19,Caen,Ligue 2,3.8,5,3,3,2,0,4,8,50.0,4,4,2,2,8,13,8,0
Diber Cambindo,COL,"FW,MF",27,Cruz Azul,Liga MX,9.2,4,1,1,1,2,2,5,40.0,3,9,2,7,1,5,9,0
Diber Cambindo,COL,FW,27,Necaxa,Liga MX,11.7,4,2,1,1,2,1,6,16.7,5,5,0,5,1,5,4,0
Dickson Abiama,NGA,FW,24,Greuther Fürth,2. Bundesliga,5.9,3,1,0,1,2,2,5,40.0,3,6,1,5,4,7,2,0
Dickson Abiama,NGA,"FW,MF",24,Kaiserslautern,2. Bundesliga,2.7,5,2,3,1,1,2,4,50.0,2,8,0,8,2,7,2,0
Didi Gaucho,CIV,"MF,DF",22,Caen,Ligue 2,13.7,52,39,31,18,3,23,33,69.7,10,26,9,17,20,72,36,0
Diego,ESP,FW,24,Leganés,Segunda Division,31.1,10,5,1,5,4,4,15,26.7,11,14,1,13,2,12,18,0
Diego Abitia,MEX,FW,20,Atlético,Liga MX,0.0,0,0,0,0,0,0,0,0.0,0,0,0,0,0,0,0,0
Diego Alende,ESP,DF,26,FC Andorra,Segunda Division,7.6,9,6,5,3,1,5,10,50.0,5,4,2,2,12,21,29,0
Diego Aznar,ESP,"FW,MF",20,Huesca,Segunda Division,0.3,0,0,0,0,0,0,0,0.0,0,0,0,0,0,0,1,1
Diego Barbosa,MEX,DF,26,Tijuana,Liga MX,24.4,106,68,62,35,9,55,92,59.8,37,26,5,21,27,133,48,1
Diego Campillo,MEX,"MF,DF",21,FC Juárez,Liga MX,10.4,21,13,10,9,2,11,22,50.0,11,10,4,6,17,38,36,1
Diego Campo,ESP,MF,22,Racing Sant,Segunda Division,0.1,0,0,0,0,0,0,0,0.0,0,0,0,0,0,0,0,0
Diego Chará,COL,MF,36,Portland Timbers,MLS,28.5,65,40,37,25,3,26,58,44.8,32,24,9,15,30,95,32,1
Diego Chávez Collins,MEX,"FW,MF",28,FC Juárez,Liga MX,12.0,29,19,12,13,4,7,25,28.0,18,22,1,21,11,40,22,0
Diego Collado,ESP,"FW,MF",23,Villarreal B,Segunda Division,15.1,29,18,11,14,4,12,31,38.7,19,11,0,11,4,33,7,0
Diego Conde,ESP,GK,25,Leganés,Segunda Division,39.1,0,0,0,0,0,0,0,0.0,0,0,0,0,0,0,16,1
Diego De Buen,MEX,"MF,DF",32,Puebla,Liga MX,33.7,55,36,29,23,3,26,61,42.6,35,27,15,12,40,95,91,1
Diego Fagúndez,URU,"FW,MF",27,LA Galaxy,MLS,6.4,12,7,5,4,3,5,9,55.6,4,8,3,5,1,13,5,0
Diego Fagúndez,URU,"FW,MF",27,Austin,MLS,11.4,12,7,5,6,1,3,14,21.4,11,9,0,9,3,15,11,0
Diego Falcinelli,ITA,"FW,MF",32,Modena,Serie B,8.7,2,2,0,0,2,1,5,20.0,4,3,1,2,2,4,9,0
Diego Falcinelli,ITA,FW,32,Spezia,Serie B,10.5,9,5,1,3,5,2,6,33.3,4,7,0,7,2,11,7,0
Diego González,ESP,DF,25,FC Andorra,Segunda Division,20.1,38,23,22,13,3,18,28,64.3,10,21,11,10,33,71,64,2
Diego González,ESP,DF,29,Elche,Segunda Division,4.6,4,3,3,1,0,4,4,100.0,0,5,3,2,3,7,18,0
Diego Gutierrez,USA,"FW,MF",23,Portland Timbers,MLS,2.7,2,1,2,0,0,1,3,33.3,2,0,0,0,3,5,2,0
Diego Gómez,MEX,MF,19,Necaxa,Liga MX,15.9,43,30,25,14,4,20,47,42.6,27,15,2,13,18,61,20,0
Diego Gómez,PAR,"MF,FW",19,Inter Miami,MLS,4.6,13,6,4,5,4,7,14,50.0,7,7,1,6,5,18,1,0
Diego Lainez,MEX,"FW,MF",23,UANL,Liga MX,18.3,36,23,12,16,8,21,34,61.8,13,18,1,17,13,49,11,0
Diego Luna,USA,"MF,FW",19,RSL,MLS,13.3,11,8,5,5,1,5,16,31.3,11,20,2,18,15,26,6,1
Diego Medina,MEX,"FW,MF",22,Santos,Liga MX,17.0,33,21,14,11,8,16,40,40.0,24,20,4,16,9,42,6,1
Diego Moreno,ESP,DF,22,Cartagena,Segunda Division,5.8,10,7,5,5,0,7,12,58.3,5,5,3,2,2,12,23,1
Diego Moreno,ESP,DF,22,CD Mirandés,Segunda Division,6.0,4,2,1,2,1,2,7,28.6,5,3,1,2,2,6,21,0
Diego Palacios,ECU,DF,23,LAFC,MLS,27.0,89,47,48,32,9,45,70,64.3,25,45,6,39,55,144,57,0
Diego Pampín,ESP,DF,24,FC Andorra,Segunda Division,30.3,33,25,22,9,2,24,43,55.8,19,24,7,17,22,55,61,3
Diego Reyes,MEX,DF,30,UANL,Liga MX,15.6,17,11,6,11,0,5,11,45.5,6,25,20,5,30,47,49,0
Diego Rosales,ESP,DF,21,CD Mirandés,Segunda Division,0.0,0,0,0,0,0,0,0,0.0,0,0,0,0,0,0,0,0
Diego Rossi,URU,"MF,FW",24,Crew,MLS,8.6,4,3,3,1,0,1,3,33.3,2,8,0,8,3,7,3,0
Diego Rubio,CHI,"MF,FW",29,Rapids,MLS,11.9,17,12,5,10,2,5,13,38.5,8,8,1,7,6,23,18,0
Diego Sánchez,ESP,DF,20,Sporting Gijón,Segunda Division,13.3,16,10,12,4,0,10,18,55.6,8,14,7,7,10,26,46,0
Diego Sánchez,MEX,FW,18,UANL,Liga MX,0.1,0,0,0,0,0,0,0,0.0,0,0,0,0,0,0,0,0
Diego Urtiaga,MEX,GK,24,Atlético,Liga MX,10.0,0,0,0,0,0,0,1,0.0,1,0,0,0,0,0,3,2
Diego Valdés,CHI,"MF,FW",29,América,Liga MX,19.3,10,5,3,5,2,1,13,7.7,12,6,1,5,11,21,9,1
Diego Valoyes,COL,MF,26,FC Juárez,Liga MX,2.4,5,2,2,3,0,2,6,33.3,4,5,0,5,1,6,1,0
Diego Zago,MEX,MF,21,Puebla,Liga MX,1.0,3,3,1,2,0,2,6,33.3,4,0,0,0,1,4,5,0
Dieter Villalpando,MEX,MF,31,FC Juárez,Liga MX,13.1,12,5,4,6,2,2,19,10.5,17,9,1,8,4,16,6,0
Dieter Villalpando,MEX,"MF,FW",31,Atlético,Liga MX,15.7,29,17,15,7,7,9,29,31.0,20,5,0,5,6,35,2,0
Dilan Markanday,ENG,"FW,MF",21,Blackburn,EFL,8.5,22,13,11,7,4,13,23,56.5,10,18,1,17,6,28,4,0
Dillon Phillips,ENG,GK,28,Rotherham Utd,EFL,2.0,0,0,0,0,0,0,1,0.0,1,0,0,0,0,0,3,0
Dimitri Bisoli,ITA,MF,29,Brescia,Serie B,30.7,70,42,41,22,7,27,57,47.4,30,64,19,45,38,108,82,0
Dimitri Colau,FRA,DF,17,Paris FC,Ligue 2,0.5,1,1,0,0,1,1,1,100.0,0,0,0,0,1,2,1,0
Dimitri Liénard,FRA,"MF,DF",35,Bastia,Ligue 2,11.6,20,10,12,6,2,12,30,40.0,18,11,2,9,15,35,11,0
Dimitris Giannoulis,GRE,DF,27,Norwich City,EFL,27.9,69,44,39,24,6,35,59,59.3,24,38,9,29,34,103,77,2
Dimitris Goutas,GRE,DF,29,Cardiff City,EFL,45.8,53,34,33,18,2,20,40,50.0,20,64,51,13,79,132,225,0
Dimitris Nikolaou,GRE,DF,24,Spezia,Serie B,32.8,48,34,28,16,4,25,34,73.5,9,35,9,26,26,74,111,0
Dimitris Sounas,GRE,MF,28,Catanzaro,Serie B,21.2,36,20,16,15,5,17,41,41.5,24,30,6,24,3,39,25,0
Dimo Krastev,BUL,DF,20,Catanzaro,Serie B,0.9,1,1,0,1,0,0,0,0.0,0,0,0,0,1,2,2,0
Dimo Krastev,BUL,DF,20,FeralpiSalò,Serie B,0.9,1,0,0,1,0,0,1,0.0,1,0,0,0,1,2,2,0
Diogo Verdasca,POR,DF,27,CD Mirandés,Segunda Division,0.3,0,0,0,0,0,0,0,0.0,0,0,0,0,0,0,6,0
Dion Sanderson,ENG,DF,23,Birmingham City,EFL,36.7,36,24,25,9,2,17,23,73.9,6,43,27,16,50,86,126,1
Dire Mebude,SCO,FW,19,Bristol City,EFL,0.5,1,0,0,0,1,0,1,0.0,1,0,0,0,1,2,0,0
Dixon Arroyo,ECU,MF,30,Inter Miami,MLS,19.9,41,32,19,19,3,20,62,32.3,42,29,8,21,27,68,24,0
Diyaeddine Abzi,CAN,"DF,MF",25,Leganés,Segunda Division,0.4,0,0,0,0,0,0,1,0.0,1,1,0,1,0,0,2,0
Djakaría Barro,CIV,MF,22,Cartagena,Segunda Division,0.2,2,1,2,0,0,1,1,100.0,0,0,0,0,1,3,1,0
Djed Spence,ENG,DF,22,Leeds United,EFL,4.3,17,11,10,5,2,5,8,62.5,3,10,4,6,8,25,11,0
Djeidi Gassama,FRA,"FW,MF",19,Sheffield Weds,EFL,16.4,38,24,14,14,10,14,39,35.9,25,10,1,9,8,46,13,0
Djibril Diani,FRA,MF,25,Caen,Ligue 2,0.8,5,3,2,3,0,2,5,40.0,3,0,0,0,5,10,2,0
Djibrill Diagouraga,FRA,FW,18,Paris FC,Ligue 2,0.2,0,0,0,0,0,0,1,0.0,1,2,0,2,0,0,0,0
Domen Črnigoj,SVN,MF,27,Reggiana,Serie B,7.2,13,10,5,8,0,9,19,47.4,10,3,0,3,8,21,16,0
Domenico Frare,ITA,DF,27,Cittadella,Serie B,16.2,20,12,13,6,1,12,19,63.2,7,23,15,8,21,41,45,0
Domingo Blanco,ARG,"MF,FW",28,Tijuana,Liga MX,21.4,56,32,19,21,16,16,27,59.3,11,16,1,15,15,71,7,0
Dominic Ball,ENG,"MF,DF",27,Ipswich Town,EFL,1.6,3,2,1,1,1,2,5,40.0,3,0,0,0,2,5,4,0
Dominic Hyam,SCO,DF,27,Blackburn,EFL,33.5,39,25,26,11,2,22,45,48.9,23,48,25,23,40,79,138,4
Dominic Iorfa,ENG,DF,28,Sheffield Weds,EFL,19.9,61,38,41,18,2,30,39,76.9,9,27,13,14,15,76,75,2
Dominick Drexler,GER,"MF,FW",33,Schalke 04,2. Bundesliga,5.9,4,4,2,0,2,3,5,60.0,2,2,0,2,3,7,4,0
Dominik Martinović,GER,"FW,MF",26,Elversberg,2. Bundesliga,5.2,5,5,0,3,2,3,6,50.0,3,7,0,7,1,6,6,0
Dominik Reimann,GER,GK,26,Magdeburg,2. Bundesliga,34.0,1,0,1,0,0,0,1,0.0,1,2,0,2,1,2,14,6
Dominique Badji,SEN,FW,30,FC Cincinnati,MLS,10.2,12,7,3,4,5,5,12,41.7,7,7,0,7,1,13,8,0
Donacien Gomis,FRA,DF,28,Guingamp,Ligue 2,28.0,36,26,24,12,0,21,36,58.3,15,32,18,14,37,73,115,1
Donovan Léon,GUF,GK,30,Auxerre,Ligue 2,37.0,4,4,4,0,0,4,4,100.0,0,0,0,0,0,4,18,4
Donovan Pines,USA,DF,24,D.C. United,MLS,20.5,36,27,22,13,1,20,27,74.1,7,22,15,7,45,81,88,1
Doudou Mangni,ITA,FW,30,Calcio Lecco 1912,Serie B,0.3,0,0,0,0,0,0,1,0.0,1,0,0,0,1,1,3,0
Douglas Costa,BRA,"FW,MF",32,LA Galaxy,MLS,13.5,9,6,3,4,2,4,18,22.2,14,13,0,13,8,17,5,0
Doğan Alemdar,TUR,GK,20,Troyes,Ligue 2,34.5,0,0,0,0,0,0,2,0.0,2,0,0,0,0,0,20,7
Doğukan Sınık,TUR,FW,24,Hull City,EFL,0.3,1,0,1,0,0,0,0,0.0,0,0,0,0,1,2,0,0
Drake Callender,USA,GK,25,Inter Miami,MLS,33.0,1,0,1,0,0,1,2,50.0,1,0,0,0,0,1,11,3
Driss Trichard,FRA,"MF,DF",28,Dunkerque,Ligue 2,4.8,16,11,8,8,0,5,13,38.5,8,3,0,3,5,21,5,0
Drissa Camara,CIV,"FW,MF",21,Parma,Serie B,5.1,12,9,0,5,7,5,7,71.4,2,7,0,7,4,16,1,0
Dru Yearwood,ENG,MF,22,NY Red Bulls,MLS,9.2,20,13,8,9,3,5,13,38.5,8,8,1,7,17,37,3,1
Duane Holmes,USA,"MF,FW",28,Preston,EFL,23.4,47,24,18,23,6,24,45,53.3,21,21,3,18,9,56,23,1
Duccio Degl'Innocenti,ITA,MF,20,Calcio Lecco 1912,Serie B,17.6,45,25,24,16,5,26,39,66.7,13,22,6,16,24,69,33,3
Duncan McGuire,USA,FW,21,Orlando City,MLS,15.4,5,3,0,2,3,1,5,20.0,4,13,1,12,2,7,17,0
Duncan Watmore,ENG,"MF,FW",29,Millwall,EFL,18.8,29,18,10,14,5,15,37,40.5,22,17,1,16,4,33,8,0
Duván Vergara,COL,"FW,MF",26,Santos,Liga MX,14.3,15,8,7,7,1,3,15,20.0,12,9,0,9,11,26,5,0
Dwight Gayle,ENG,FW,32,Stoke City,EFL,3.5,2,1,1,0,1,2,4,50.0,2,4,1,3,0,2,1,0
Dyego Sousa,POR,FW,34,Alcorcón,Segunda Division,11.0,11,6,0,6,5,4,11,36.4,7,7,0,7,3,14,13,0
Dylan,ESP,FW,18,Tenerife,Segunda Division,0.4,0,0,0,0,0,0,1,0.0,1,0,0,0,0,0,1,0
Dylan Batubinsika,COD,DF,27,Saint-Étienne,Ligue 2,22.4,38,27,30,8,0,21,32,65.6,11,25,18,7,34,72,92,1
Dylan Borrero,COL,"FW,MF",21,NE Revolution,MLS,5.7,7,4,3,2,2,5,9,55.6,4,6,0,6,3,10,1,0
Dylan Chambost,FRA,"MF,FW",25,Saint-Étienne,Ligue 2,26.4,32,17,8,16,8,10,31,32.3,21,20,3,17,17,49,34,1
Dylan Louiserre,FRA,MF,28,Guingamp,Ligue 2,31.7,63,36,20,35,8,34,70,48.6,36,34,7,27,38,101,42,0
Dylan Nealis,USA,DF,24,NY Red Bulls,MLS,11.5,32,19,16,12,4,20,34,58.8,14,17,1,16,16,48,28,0
Dylan Tavares,CPV,"DF,MF",26,Bastia,Ligue 2,21.3,44,27,22,15,7,21,42,50.0,21,24,6,18,23,67,31,0
Dylan Teves,USA,FW,22,Seattle,MLS,4.3,3,3,1,0,2,1,7,14.3,6,5,1,4,1,4,0,0
Dániel Gazdag,HUN,MF,26,Philadelphia,MLS,30.3,30,13,10,15,5,16,45,35.6,29,17,2,15,9,39,7,0
Dániel Sallói,HUN,FW,26,Sporting KC,MLS,31.9,18,16,6,7,5,8,20,40.0,12,24,5,19,16,34,21,0
Dávid Ďuriš,SVK,"FW,MF",24,Ascoli,Serie B,5.1,5,3,0,3,2,0,3,0.0,3,5,0,5,1,6,7,0
Dória,BRA,DF,28,Santos,Liga MX,23.1,23,14,14,8,1,14,22,63.6,8,28,22,6,32,55,86,0
Dženis Burnić,BIH,"MF,FW",25,Karlsruher,2. Bundesliga,14.1,33,21,18,9,6,8,30,26.7,22,12,2,10,11,44,19,0
Earl Edwards Jr.,USA,GK,31,NE Revolution,MLS,10.0,0,0,0,0,0,0,1,0.0,1,0,0,0,0,0,4,1
Ebou Adams,GAM,"MF,DF",27,Cardiff City,EFL,3.4,16,12,11,4,1,9,11,81.8,2,3,0,3,5,21,18,0
Ebrima Darboe,GAM,MF,22,Sampdoria,Serie B,10.4,29,16,14,11,4,10,25,40.0,15,13,3,10,9,38,5,1
Eddie Salcedo,ITA,"FW,MF",22,Eldense,Segunda Division,3.1,3,2,2,1,0,0,3,0.0,3,3,0,3,3,6,3,0
Eddie Salcedo,ITA,FW,21,Calcio Lecco 1912,Serie B,3.1,6,2,3,1,2,2,5,40.0,3,2,1,1,0,6,0,0
Eddy Gnahoré,FRA,MF,29,Ascoli,Serie B,8.3,10,5,3,6,1,3,7,42.9,4,10,6,4,16,26,10,0
Eddy Sylvestre,FRA,"MF,FW",23,Grenoble,Ligue 2,17.5,16,7,6,8,2,5,12,41.7,7,9,1,8,10,26,6,0
Edgar Alcañiz,ESP,"FW,MF",19,Levante,Segunda Division,0.1,0,0,0,0,0,0,0,0.0,0,1,1,0,0,0,0,0
Edgar Guerra,COL,"MF,FW",22,León,Liga MX,9.2,13,6,2,8,3,6,15,40.0,9,11,2,9,5,18,9,0
Edgar López,MEX,"FW,MF",24,Toluca,Liga MX,19.1,13,9,2,7,4,4,10,40.0,6,15,1,14,6,19,11,0
Edgar Zaldívar,MEX,MF,26,Atlas,Liga MX,10.1,21,11,8,12,1,9,26,34.6,17,9,1,8,9,30,10,0
Edgaras Dubickas,LTU,FW,25,FeralpiSalò,Serie B,7.3,6,4,1,5,0,3,5,60.0,2,6,2,4,6,12,7,0
Edison Azcona,DOM,"MF,DF",19,Inter Miami,MLS,0.6,3,1,0,2,1,0,3,0.0,3,1,0,1,0,3,0,0
Edo Kayembe,COD,MF,25,Watford,EFL,27.2,42,21,17,22,3,16,32,50.0,16,22,7,15,18,60,33,0
Edoardo Corvi,ITA,GK,22,Parma,Serie B,1.9,0,0,0,0,0,0,1,0.0,1,0,0,0,0,0,0,0
Edoardo Duca,ITA,MF,26,Modena,Serie B,12.5,35,23,12,21,2,15,22,68.2,7,22,3,19,8,43,14,0
Edoardo Goldaniga,ITA,DF,29,Como,Serie B,16.0,15,9,9,6,0,7,9,77.8,2,11,9,2,14,29,59,0
Edoardo Pieragnolo,ITA,DF,20,Reggiana,Serie B,28.8,50,28,26,19,5,20,45,44.4,25,19,4,15,28,78,60,0
Edoardo Soleri,ITA,FW,25,Palermo,Serie B,8.6,13,4,2,6,5,3,11,27.3,8,9,3,6,1,14,9,0
Edoardo Sottini,ITA,DF,20,Cittadella,Serie B,4.8,5,1,2,2,1,3,7,42.9,4,9,5,4,5,10,15,0
Edson,BRA,"DF,MF",25,FC Juárez,Liga MX,8.7,26,16,13,10,3,11,28,39.3,17,9,3,6,13,39,23,0
Edson Gutiérrez,MEX,DF,27,Monterrey,Liga MX,4.6,11,6,5,5,1,7,9,77.8,2,9,7,2,7,18,23,0
Edson Mata,MEX,DF,20,Mazatlán,Liga MX,0.3,2,1,2,0,0,1,1,100.0,0,0,0,0,0,2,2,0
Edson Seidou,CIV,DF,31,Stade Laval,Ligue 2,0.5,3,1,0,3,0,3,3,100.0,0,0,0,0,1,4,0,0
Edu Expósito,ESP,MF,27,Espanyol,Segunda Division,12.6,26,15,10,11,5,15,25,60.0,10,14,2,12,13,39,15,0
Eduard Bello,VEN,"FW,MF",27,Mazatlán,Liga MX,11.4,19,10,8,10,1,9,21,42.9,12,14,3,11,12,31,23,0
Eduard Löwen,GER,MF,26,St. Louis,MLS,25.6,64,42,27,27,10,33,76,43.4,43,41,11,30,16,80,29,0
Eduardo Aguirre,MEX,"FW,MF",24,Atlas,Liga MX,17.8,9,4,0,6,3,0,12,0.0,12,27,2,25,7,16,23,0
Eduardo Armenta,MEX,"MF,FW",21,Tijuana,Liga MX,9.4,27,17,9,14,4,9,20,45.0,11,14,1,13,5,32,7,1
Eduardo Espiau,ESP,FW,29,Burgos,Segunda Division,16.8,5,2,2,3,0,2,14,14.3,12,12,1,11,9,14,8,0
Eduardo Salvio,ARG,"FW,MF",33,UNAM,Liga MX,28.8,30,18,7,18,5,13,38,34.2,25,23,2,21,10,40,12,0
Eduardo Tercero,MEX,DF,27,UANL,Liga MX,3.1,13,6,5,8,0,7,10,70.0,3,5,2,3,4,17,7,0
Eduardo Águila,MEX,"DF,FW",21,Atlético,Liga MX,2.2,6,4,6,0,0,4,5,80.0,1,3,1,2,3,9,12,0
Edwin Cerrillo,USA,MF,22,FC Dallas,MLS,15.1,24,15,11,10,3,12,35,34.3,23,23,6,17,14,38,15,0
Edwin Cerrillo,USA,MF,22,LA Galaxy,MLS,9.0,10,9,6,4,0,8,15,53.3,7,8,1,7,6,16,6,1
Edwin Mosquera,COL,"FW,MF",21,Atlanta Utd,MLS,4.9,7,6,1,4,2,2,5,40.0,3,3,2,1,4,11,2,0
Efe Sarikaya,TUR,DF,17,Grenoble,Ligue 2,0.9,1,1,1,0,0,1,1,100.0,0,1,1,0,0,1,2,0
Efrain Alvarez,MEX,"MF,FW",21,Tijuana,Liga MX,10.5,8,8,4,3,1,3,8,37.5,5,9,0,9,4,12,0,0
Efrain Alvarez,MEX,"MF,FW",20,LA Galaxy,MLS,4.2,1,0,0,1,0,0,5,0.0,5,3,0,3,3,4,0,0
Efraín Orona,MEX,DF,24,Puebla,Liga MX,7.4,14,9,11,3,0,10,14,71.4,4,9,6,3,12,26,42,0
Ekain Zenitagoia,ESP,FW,30,Racing Sant,Segunda Division,11.0,5,4,0,3,2,3,6,50.0,3,8,4,4,1,6,17,0
Ekhiotz Orobio,ESP,FW,22,CD Mirandés,Segunda Division,0.0,0,0,0,0,0,0,0,0.0,0,0,0,0,0,0,0,0
Elady Zorrilla,ESP,"FW,MF",33,Huesca,Segunda Division,13.5,10,7,5,3,2,4,11,36.4,7,10,4,6,3,13,13,0
Elady Zorrilla,ESP,"MF,FW",33,Tenerife,Segunda Division,5.7,5,3,2,1,2,1,8,12.5,7,9,1,8,3,8,5,0
Eldin Dzogovic,LUX,MF,20,Magdeburg,2. Bundesliga,0.3,0,0,0,0,0,0,0,0.0,0,0,0,0,0,0,0,0
Eldin Jakupović,SUI,GK,38,LAFC,MLS,2.0,0,0,0,0,0,0,0,0.0,0,0,0,0,0,0,0,0
Elhadj Abdourahamane Bah,GUI,"MF,FW",21,Dunkerque,Ligue 2,6.9,11,7,5,5,1,6,13,46.2,7,14,0,14,3,14,9,0
Elhadji Pape Diaw,SEN,DF,28,Stade Laval,Ligue 2,30.8,57,37,44,12,1,31,57,54.4,26,26,12,14,44,101,123,1
Elhan Kastrati,ALB,GK,26,Cittadella,Serie B,35.0,2,0,2,0,0,1,3,33.3,2,0,0,0,1,3,14,1
Elias Manoel,BRA,FW,21,NY Red Bulls,MLS,18.4,11,5,4,2,5,4,12,33.3,8,24,0,24,4,15,5,0
Elias Montiel,MEX,MF,17,Pachuca,Liga MX,15.3,33,18,7,18,8,10,34,29.4,24,13,4,9,16,49,10,0
Elias Saad,TUN,"FW,MF",23,St. Pauli,2. Bundesliga,22.9,36,19,10,13,13,16,32,50.0,16,41,3,38,6,42,7,0
Eliezer Mayenda,ESP,"FW,MF",18,Sunderland,EFL,2.1,2,1,1,0,1,1,1,100.0,0,1,0,1,0,2,0,0
Elija Krahn,GER,MF,19,Hamburger SV,2. Bundesliga,0.0,0,0,0,0,0,0,0,0.0,0,1,1,0,0,0,0,0
Elijah Dixon-Bonner,ENG,MF,22,QPR,EFL,10.0,10,4,5,3,2,4,11,36.4,7,18,5,13,5,15,10,0
Elijah Morrison,ENG,MF,17,Bristol City,EFL,0.1,0,0,0,0,0,0,0,0.0,0,0,0,0,0,0,0,0
Elio Capradossi,UGA,DF,27,Calcio Lecco 1912,Serie B,6.0,5,4,2,3,0,2,4,50.0,2,6,4,2,15,20,22,0
Elisha Owusu,GHA,MF,25,Auxerre,Ligue 2,28.0,62,36,12,43,7,23,48,47.9,25,34,8,26,37,99,22,0
Elliot Panicco,USA,GK,26,Nashville,MLS,2.0,0,0,0,0,0,0,0,0.0,0,0,0,0,0,0,0,0
Ellis Simms,ENG,FW,22,Coventry City,EFL,30.3,12,7,2,4,6,4,11,36.4,7,9,2,7,2,14,20,0
Eloy Room,CUW,GK,33,Crew,MLS,3.0,0,0,0,0,0,0,0,0.0,0,0,0,0,0,0,2,0
Elvis Kabashi,ALB,MF,29,Reggiana,Serie B,22.6,59,36,26,25,8,25,51,49.0,26,24,10,14,32,91,53,1
Elías Hernández,MEX,"MF,FW",35,León,Liga MX,14.5,21,15,8,8,5,13,24,54.2,11,6,2,4,6,27,7,0
Ema Twumasi,GHA,DF,25,FC Dallas,MLS,17.5,21,12,8,12,1,8,20,40.0,12,18,3,15,11,32,38,0
Emanuel Aiwum,AUT,DF,22,Birmingham City,EFL,21.6,45,27,26,17,2,28,34,82.4,6,44,27,17,20,65,85,2
Emanuel Gularte,URU,DF,25,Querétaro,Liga MX,32.1,51,33,38,12,1,19,32,59.4,13,32,23,9,37,88,158,1
Emanuel Montejano Arroyo,MEX,FW,22,UNAM,Liga MX,0.6,1,0,0,0,1,0,0,0.0,0,0,0,0,0,1,0,0
Emanuel Reynoso,ARG,MF,27,Minnesota Utd,MLS,15.2,21,11,4,8,9,9,21,42.9,12,14,0,14,5,26,0,0
Emanuel Taffertshofer,GER,MF,28,Wehen,2. Bundesliga,1.4,5,4,1,4,0,5,7,71.4,2,1,0,1,3,8,4,0
Emanuel Vignato,ITA,"MF,FW",22,Pisa,Serie B,5.6,4,1,2,2,0,3,7,42.9,4,7,1,6,1,5,5,0
Emanuele Ndoj,ALB,MF,26,Brescia,Serie B,1.2,1,1,0,0,1,0,0,0.0,0,3,1,2,1,2,3,0
Emanuele Pecorino,ITA,FW,22,Südtirol,Serie B,10.9,16,10,7,4,5,3,6,50.0,3,13,1,12,3,19,11,0
Emeka Eneli,USA,"DF,MF",23,RSL,MLS,14.7,24,12,10,8,6,13,28,46.4,15,22,6,16,13,37,17,0
Emerson Rodríguez,COL,"FW,MF",22,Santos,Liga MX,13.6,23,15,8,10,5,9,24,37.5,15,19,2,17,3,26,7,0
Emil Kornvig,DEN,MF,23,Cittadella,Serie B,2.5,6,3,3,2,1,2,9,22.2,7,4,0,4,1,7,4,0
Emil Riis Jakobsen,DEN,FW,25,Preston,EFL,14.3,6,4,1,3,2,3,9,33.3,6,8,0,8,1,7,4,0
Emile Dorval,FRA,DF,22,Bari,Serie B,30.9,52,33,36,14,2,23,40,57.5,17,27,7,20,31,83,60,1
Emiliano García,MEX,"MF,DF",19,Puebla,Liga MX,0.1,0,0,0,0,0,0,0,0.0,0,0,0,0,0,0,0,0
Emiliano Rigoni,ARG,"FW,MF",29,Austin,MLS,24.3,22,16,9,9,4,10,25,40.0,15,23,4,19,5,27,35,0
Emiliano Viviano,ITA,GK,37,Ascoli,Serie B,26.5,2,1,2,0,0,2,3,66.7,1,0,0,0,0,2,7,0
Emilio Lara,MEX,DF,21,América,Liga MX,4.6,7,6,5,2,0,4,8,50.0,4,4,2,2,11,18,21,1
Emilio Martínez González,MEX,DF,20,Necaxa,Liga MX,16.3,40,24,25,12,3,28,61,45.9,33,21,6,15,22,62,49,0
Emilio Santillán,MEX,DF,19,Santos,Liga MX,0.1,0,0,0,0,0,0,0,0.0,0,0,0,0,0,0,0,0
Emir Kuhinja,GER,"FW,MF",21,Magdeburg,2. Bundesliga,0.2,3,3,2,1,0,1,2,50.0,1,0,0,0,0,3,0,0
Emmanouil Siopis,GRE,MF,29,Cardiff City,EFL,36.5,71,44,28,39,4,36,89,40.4,53,29,5,24,54,125,42,3
Emmanuel Addai,GHA,"FW,MF",22,Alcorcón,Segunda Division,23.1,30,16,13,8,9,15,44,34.1,29,29,2,27,15,45,11,0
Emmanuel Boateng,GHA,"FW,MF",29,NE Revolution,MLS,16.0,14,7,7,5,2,2,11,18.2,9,14,4,10,10,24,12,0
Emmanuel Dennis,NGA,"FW,MF",25,Watford,EFL,9.5,18,10,9,6,3,2,12,16.7,10,11,0,11,8,26,2,0
Emmanuel Echeverría,MEX,"DF,MF",19,Santos,Liga MX,9.3,18,13,9,6,3,14,26,53.8,12,15,3,12,8,26,20,1
Emmanuel Iwe,USA,FW,22,Minnesota Utd,MLS,0.6,0,0,0,0,0,0,1,0.0,1,0,0,0,0,0,0,0
Emmanuel Iyoha,GER,"DF,FW",25,Düsseldorf,2. Bundesliga,20.9,30,17,21,8,1,22,39,56.4,17,28,5,23,25,55,64,1
Emmanuel Latte Lath,CIV,FW,24,Middlesbrough,EFL,23.2,22,15,7,9,6,6,13,46.2,7,24,2,22,7,29,21,0
Emmanuel Longelo,ENG,DF,22,Birmingham City,EFL,11.3,26,17,17,6,3,13,21,61.9,8,20,3,17,12,38,32,1
Emmanuel Ntim,GHA,DF,27,Caen,Ligue 2,11.5,17,10,11,5,1,6,9,66.7,3,14,10,4,15,32,45,0
Emmanuel Ntim,GHA,DF,27,Troyes,Ligue 2,8.9,9,7,5,3,1,8,15,53.3,7,10,5,5,18,27,35,0
Emmanuele Matino,ITA,DF,24,Bari,Serie B,11.3,21,13,14,6,1,12,16,75.0,4,9,6,3,11,32,38,0
Enda Stevens,IRL,DF,33,Stoke City,EFL,17.1,34,20,22,11,1,23,37,62.2,14,22,8,14,21,55,46,0
Eneko Jauregi,ESP,FW,27,Amorebieta,Segunda Division,25.2,6,2,2,3,1,1,3,33.3,2,13,2,11,6,12,21,0
Enol Coto,ESP,DF,23,Sporting Gijón,Segunda Division,1.4,2,0,1,1,0,2,2,100.0,0,0,0,0,0,2,2,0
Enol Rodríguez,ESP,FW,22,Oviedo,Segunda Division,0.1,0,0,0,0,0,0,0,0.0,0,0,0,0,0,0,0,0
Enric Franquesa,ESP,DF,27,Leganés,Segunda Division,40.5,73,46,43,27,3,39,57,68.4,18,40,8,32,30,103,71,0
Enric Gallego,ESP,FW,37,Tenerife,Segunda Division,26.7,27,17,8,11,8,10,30,33.3,20,27,4,23,8,35,37,0
Enrico Baldini,ITA,"MF,FW",26,Cittadella,Serie B,3.8,0,0,0,0,0,0,1,0.0,1,3,1,2,2,2,1,0
Enrico Brignola,ITA,"MF,FW",24,Catanzaro,Serie B,5.8,10,6,6,3,1,5,10,50.0,5,3,0,3,1,11,10,0
Enrico Del Prato,ITA,DF,23,Parma,Serie B,32.8,37,23,22,10,5,21,28,75.0,7,38,19,19,41,78,95,0
Enrico Valentini,ITA,DF,34,Nürnberg,2. Bundesliga,9.2,15,6,13,2,0,8,14,57.1,6,9,2,7,13,28,52,0
Enrique Clemente,ESP,DF,25,Racing Ferrol,Segunda Division,16.3,19,14,13,5,1,12,15,80.0,3,19,15,4,31,50,75,1
Enzo Bardeli,FRA,"MF,FW",22,Dunkerque,Ligue 2,33.3,42,25,17,17,8,18,56,32.1,38,33,4,29,31,73,6,0
Enzo Basilio,FRA,GK,28,Guingamp,Ligue 2,38.0,1,0,1,0,0,1,2,50.0,1,0,0,0,0,1,24,3
Enzo Boyomo,CMR,DF,22,Valladolid,Segunda Division,33.1,65,42,41,22,2,29,37,78.4,8,33,15,18,34,99,88,1
Enzo Copetti,ARG,FW,27,Charlotte,MLS,22.0,8,3,1,3,4,1,20,5.0,19,14,2,12,5,13,20,0
Enzo Crombez,FRA,GK,20,Rodez Aveyron,Ligue 2,1.3,0,0,0,0,0,0,0,0.0,0,0,0,0,0,0,2,0
Enzo Grothe,FRA,"DF,MF",18,Bordeaux,Ligue 2,0.3,2,2,1,0,1,2,2,100.0,0,0,0,0,0,2,0,0
Enzo Leopold,GER,MF,23,Hannover 96,2. Bundesliga,28.3,78,51,28,33,17,34,74,45.9,40,42,6,36,26,104,32,1
Enzo Lombardo,FRA,"MF,FW",27,Huesca,Segunda Division,6.3,4,4,2,1,1,1,6,16.7,5,1,0,1,6,10,1,0
Ephraim Yeboah,GHA,"FW,MF",17,Bristol City,EFL,2.3,5,3,3,0,2,2,6,33.3,4,3,0,3,1,6,1,0
Ercan Kara,AUT,FW,27,Orlando City,MLS,9.4,3,2,1,0,2,1,8,12.5,7,3,2,1,2,5,10,0
Erdis Kraja,ALB,"MF,DF",23,Ascoli,Serie B,1.5,1,1,1,0,0,0,2,0.0,2,3,0,3,2,3,2,0
Eren Öztürk,TUR,MF,19,Karlsruher,2. Bundesliga,0.0,0,0,0,0,0,0,0,0.0,0,0,0,0,0,0,0,0
Eric Botteghin,BRA,DF,35,Ascoli,Serie B,23.2,40,24,30,5,5,24,37,64.9,13,31,16,15,33,73,105,1
Eric Callís,ESP,DF,22,Alcorcón,Segunda Division,1.3,4,3,2,2,0,3,3,100.0,0,3,1,2,2,6,0,0
Eric Lanini,ITA,"FW,MF",29,Reggiana,Serie B,3.7,3,2,1,1,1,0,3,0.0,3,3,0,3,1,4,2,0
Eric Miller,USA,DF,30,Portland Timbers,MLS,13.4,16,12,9,4,3,12,21,57.1,9,9,6,3,7,23,45,1
Eric N'Jo,FRA,"FW,MF",19,Troyes,Ligue 2,0.1,0,0,0,0,0,0,0,0.0,0,2,2,0,0,0,0,0
Eric Smith,SWE,"DF,MF",26,St. Pauli,2. Bundesliga,24.9,28,17,13,13,2,11,24,45.8,13,23,9,14,20,48,58,2
Eric da Silva Moreira,GER,MF,17,St. Pauli,2. Bundesliga,0.0,0,0,0,0,0,0,0,0.0,0,0,0,0,0,0,0,0
Erick Davis,PAN,DF,31,D.C. United,MLS,6.0,8,5,3,5,0,6,11,54.5,5,10,2,8,9,17,12,0
Erick Gutiérrez,MEX,MF,28,Guadalajara,Liga MX,21.9,74,47,22,49,3,34,53,64.2,19,18,6,12,19,93,33,0
Erick Sánchez,MEX,MF,23,Pachuca,Liga MX,25.8,51,35,15,26,10,21,58,36.2,37,44,8,36,27,78,27,0
Erick Torres,MEX,"MF,FW",19,León,Liga MX,0.1,1,0,1,0,0,0,0,0.0,0,1,1,0,0,1,0,0
Erik Duenas,USA,"MF,DF",18,LAFC,MLS,8.4,29,14,10,15,4,19,40,47.5,21,13,1,12,13,42,6,0
Erik Durm,GER,"DF,MF",31,Kaiserslautern,2. Bundesliga,2.8,8,5,5,2,1,7,9,77.8,2,8,1,7,2,10,7,0
Erik Engelhardt,GER,FW,25,Osnabrück,2. Bundesliga,29.5,28,15,2,22,4,6,12,50.0,6,18,5,13,5,33,33,0
Erik Holt,USA,DF,26,RSL,MLS,0.6,1,1,1,0,0,0,1,0.0,1,0,0,0,2,3,3,0
Erik Hurtado,USA,"FW,MF",32,D.C. United,MLS,3.0,1,1,0,0,1,1,2,50.0,1,2,0,2,0,1,1,0
Erik Lira,MEX,"MF,DF",23,Cruz Azul,Liga MX,24.6,46,29,24,19,3,28,57,49.1,29,19,2,17,19,65,37,1
Erik López,PAR,"FW,MF",21,Atlanta Utd,MLS,0.3,0,0,0,0,0,0,1,0.0,1,1,0,1,0,0,0,0
Erik Morán,ESP,MF,33,Amorebieta,Segunda Division,19.2,27,20,8,15,4,15,40,37.5,25,17,4,13,19,46,17,0
Erik Pieters,NED,DF,34,West Brom,EFL,17.5,27,14,18,8,1,10,17,58.8,7,17,8,9,19,46,53,2
Erik Sviatchenko,DEN,DF,31,Dynamo FC,MLS,15.0,9,5,8,1,0,6,12,50.0,6,17,8,9,11,20,58,0
Erik Thommy,GER,"MF,FW",28,Sporting KC,MLS,28.7,44,27,13,20,11,21,50,42.0,29,43,6,37,24,68,11,1
Erik Wekesser,GER,"MF,FW",26,Nürnberg,2. Bundesliga,8.2,8,2,5,2,1,5,10,50.0,5,8,2,6,2,10,10,1
Eriq Zavaleta,SLV,DF,30,LA Galaxy,MLS,5.4,4,4,3,1,0,3,8,37.5,5,2,2,0,5,9,16,0
Ermin Bičakčić,BIH,DF,33,Braunschweig,2. Bundesliga,20.8,15,11,12,3,0,8,17,47.1,9,28,22,6,34,49,114,1
Ernesto Torregrossa,VEN,"FW,MF",31,Pisa,Serie B,7.7,7,5,1,3,3,6,9,66.7,3,2,1,1,0,7,5,0
Eros Maddy,NED,"FW,MF",22,Auxerre,Ligue 2,1.5,1,1,0,0,1,1,2,50.0,1,1,0,1,2,3,0,0
Eryk Williamson,USA,MF,25,Portland Timbers,MLS,5.9,11,7,4,7,0,2,7,28.6,5,8,0,8,4,15,2,0
Esmir Bajraktarevic,USA,"FW,MF",17,NE Revolution,MLS,5.5,7,6,3,2,2,3,5,60.0,2,0,0,0,1,8,0,0
Estanis,ESP,FW,19,Sampdoria,Serie B,9.0,8,4,6,1,1,5,14,35.7,9,8,1,7,2,10,3,0
Esteban Andrada,ARG,GK,32,Monterrey,Liga MX,32.0,1,1,1,0,0,0,1,0.0,1,2,0,2,0,1,15,2
Esteban Lepaul,FRA,"MF,FW",23,Angers,Ligue 2,7.8,5,3,0,3,2,1,6,16.7,5,9,0,9,5,10,2,0
Esteban Lozano,MEX,"FW,MF",21,Sporting Gijón,Segunda Division,1.3,1,1,0,1,0,0,0,0.0,0,0,0,0,2,3,2,0
Esteban Salles,FRA,GK,29,US Concarneau,Ligue 2,38.0,0,0,0,0,0,0,4,0.0,4,1,0,1,3,3,14,2
Esteban Saveljich,MNE,DF,33,Burgos,Segunda Division,6.3,4,2,3,1,0,2,6,33.3,4,9,8,1,5,9,23,0
Ethan Ampadu,WAL,"MF,DF",22,Leeds United,EFL,46.0,70,42,34,32,4,29,44,65.9,15,64,36,28,64,134,111,0
Ethan Bartlow,USA,DF,22,Dynamo FC,MLS,22.1,14,10,9,4,1,5,13,38.5,8,22,17,5,13,27,102,1
Ethan Bristow,SKN,DF,21,Minnesota Utd,MLS,6.0,11,7,8,3,0,6,10,60.0,4,5,3,2,2,13,15,1
Ethan Dobbelaere,USA,FW,20,Seattle,MLS,1.1,0,0,0,0,0,0,3,0.0,3,0,0,0,0,0,0,0
Ethan Finlay,USA,"FW,MF",32,Austin,MLS,18.8,26,14,13,10,3,11,26,42.3,15,22,2,20,7,33,12,0
Ethan Horvath,USA,GK,28,Cardiff City,EFL,16.0,2,0,2,0,0,0,0,0.0,0,0,0,0,0,2,4,1
Ethan Laird,ENG,DF,22,Birmingham City,EFL,22.2,68,41,36,22,10,35,47,74.5,12,35,13,22,40,108,56,2
Ethan Zubak,USA,FW,24,Nashville,MLS,1.6,2,1,1,1,0,2,2,100.0,0,0,0,0,0,2,5,0
Etienne Amenyido,TOG,"FW,MF",25,St. Pauli,2. Bundesliga,2.2,5,2,0,3,2,4,4,100.0,0,3,0,3,1,6,2,0
Etienne Green,ENG,GK,23,Saint-Étienne,Ligue 2,6.0,0,0,0,0,0,0,1,0.0,1,0,0,0,0,0,0,0
Ettore Gliozzi,ITA,FW,27,Pisa,Serie B,1.5,1,1,1,0,0,1,2,50.0,1,1,0,1,1,2,1,0
Ettore Gliozzi,ITA,FW,27,Modena,Serie B,12.4,7,3,2,4,1,2,6,33.3,4,7,1,6,2,9,9,0
Ettson Ayon,MEX,FW,22,Querétaro,Liga MX,11.4,3,0,1,1,1,1,8,12.5,7,6,3,3,1,4,10,1
Etyan,ESP,"FW,MF",22,Tenerife,Segunda Division,0.3,0,0,0,0,0,0,0,0.0,0,1,0,1,0,0,1,0
Eugene Ansah,GHA,FW,28,FC Dallas,MLS,2.0,2,2,1,1,0,0,1,0.0,1,4,0,4,1,3,1,0
Eugenio Lamanna,ITA,GK,33,Calcio Lecco 1912,Serie B,3.0,0,0,0,0,0,0,0,0.0,0,0,0,0,0,0,3,0
Eugenio Pizzuto,MEX,MF,21,UANL,Liga MX,0.3,0,0,0,0,0,0,0,0.0,0,1,0,1,0,0,0,0
Evander,BRA,"MF,FW",24,Portland Timbers,MLS,24.5,22,11,9,8,5,14,53,26.4,39,20,2,18,14,36,5,0
Everardo Del Villar,MEX,DF,18,Toluca,Liga MX,1.2,5,3,2,3,0,2,3,66.7,1,2,0,2,3,8,3,0
Everson Junior,FRA,"MF,FW",19,Ajaccio,Ligue 2,3.1,10,9,8,1,1,2,7,28.6,5,3,1,2,3,13,2,0
Ewen Jaouen,FRA,GK,17,Rodez Aveyron,Ligue 2,6.0,1,1,1,0,0,1,2,50.0,1,0,0,0,0,1,3,1
Ezequiel Unsain,ARG,GK,28,Necaxa,Liga MX,24.5,1,1,1,0,0,1,1,100.0,0,0,0,0,0,1,7,1
Fabian Herbers,GER,"MF,FW",29,Fire,MLS,21.9,42,31,15,24,3,18,39,46.2,21,24,6,18,18,60,20,0
Fabian Kunze,GER,MF,25,Hannover 96,2. Bundesliga,27.9,58,32,16,36,6,33,64,51.6,31,39,3,36,42,100,59,1
Fabian Reese,GER,FW,25,Hertha BSC,2. Bundesliga,29.2,31,18,11,15,5,9,31,29.0,22,26,1,25,24,55,25,0
Fabian Schleusener,GER,FW,31,Karlsruher,2. Bundesliga,15.8,8,6,2,2,4,1,8,12.5,7,9,0,9,3,11,10,0
Fabian Tait,ITA,MF,30,Südtirol,Serie B,32.3,58,35,27,23,8,21,64,32.8,43,34,16,18,27,85,38,0
Fabio Abiuso,GRE,"FW,MF",20,Modena,Serie B,13.7,19,13,4,6,9,7,19,36.8,12,18,2,16,6,25,5,0
Fabio Blanco,ESP,"MF,DF",20,Villarreal B,Segunda Division,0.2,0,0,0,0,0,0,0,0.0,0,0,0,0,0,0,0,0
Fabio Borini,ITA,"FW,MF",32,Sampdoria,Serie B,16.3,12,7,5,2,5,3,8,37.5,5,12,2,10,13,25,16,0
Fabio Carvalho,POR,"FW,MF",20,Hull City,EFL,19.1,27,13,6,15,6,6,25,24.0,19,31,3,28,13,40,5,0
Fabio Depaoli,ITA,"DF,MF",26,Sampdoria,Serie B,26.4,47,32,26,13,8,23,35,65.7,12,35,12,23,28,75,52,0
Fabio Gerli,ITA,MF,26,Modena,Serie B,22.4,30,15,14,15,1,14,27,51.9,13,25,6,19,23,53,19,1
Fabio Kaufmann,GER,"MF,FW",30,Braunschweig,2. Bundesliga,24.7,37,20,15,15,7,19,32,59.4,13,27,5,22,15,52,16,0
Fabio Lucioni,ITA,DF,35,Palermo,Serie B,23.0,31,17,18,12,1,11,19,57.9,8,29,25,4,30,61,102,1
Fabio Ponsi,ITA,DF,22,Modena,Serie B,20.8,37,20,15,19,3,24,40,60.0,16,29,6,23,28,65,56,0
Fabio Rispoli,ITA,"FW,MF",16,Como,Serie B,0.2,1,1,0,0,1,1,1,100.0,0,0,0,0,0,1,0,0
Fabio Tavares,ENG,"FW,DF",22,Coventry City,EFL,2.0,3,2,1,2,0,1,5,20.0,4,5,0,5,0,3,0,0
Fabricio Formiliano,URU,DF,30,Necaxa,Liga MX,2.8,0,0,0,0,0,0,3,0.0,3,2,2,0,7,7,17,0
Fabrizio Caligara,ITA,MF,23,Ascoli,Serie B,16.0,37,26,11,18,8,16,38,42.1,22,29,1,28,11,48,19,0
Fabrizio Paghera,ITA,MF,31,Brescia,Serie B,14.4,40,25,15,22,3,22,51,43.1,29,24,6,18,22,62,31,1
Fabrizio Paghera,ITA,DF,31,Ternana,Serie B,0.3,3,2,1,2,0,0,2,0.0,2,0,0,0,0,3,0,0
Fabrício,BRA,"FW,MF",23,Levante,Segunda Division,15.1,18,8,5,6,7,10,17,58.8,7,15,1,14,7,25,1,0
Facinet Conte,GUI,"FW,MF",18,Bastia,Ligue 2,9.9,10,8,2,4,4,3,6,50.0,3,3,0,3,2,12,2,0
Facundo Almada,ARG,DF,25,Mazatlán,Liga MX,34.0,40,31,29,11,0,18,35,51.4,17,45,32,13,36,76,120,0
Facundo Batista,URU,FW,24,Querétaro,Liga MX,12.5,8,5,3,3,2,2,8,25.0,6,7,0,7,1,9,14,0
Facundo Batista,URU,FW,24,Necaxa,Liga MX,12.3,5,1,2,1,2,1,9,11.1,8,19,5,14,0,5,22,0
Facundo Farías,ARG,"FW,MF",20,Inter Miami,MLS,9.3,5,4,1,2,2,3,7,42.9,4,3,0,3,0,5,0,0
Facundo González,URU,DF,20,Sampdoria,Serie B,25.7,34,24,15,17,2,20,31,64.5,11,26,15,11,22,56,70,0
Facundo Quignon,ARG,MF,29,FC Dallas,MLS,21.3,52,27,26,22,4,24,54,44.4,30,25,4,21,30,82,43,0
Facundo Torres,URU,"FW,MF",22,Orlando City,MLS,26.3,15,10,6,4,5,7,27,25.9,20,14,0,14,9,24,5,1
Facundo Waller,URU,MF,26,Puebla,Liga MX,0.9,2,2,2,0,0,1,1,100.0,0,0,0,0,0,2,2,0
Fafà Picault,HAI,"FW,MF",31,Nashville,MLS,18.0,21,16,9,9,3,4,15,26.7,11,24,4,20,15,36,13,0
Fahd El Khoumisti,MAR,FW,30,US Concarneau,Ligue 2,0.9,2,1,1,1,0,1,3,33.3,2,1,0,1,1,3,1,0
Famara Diedhiou,SEN,FW,30,Cardiff City,EFL,6.4,5,5,1,3,1,2,6,33.3,4,5,2,3,2,7,5,0
Farid El Melali,ALG,"FW,MF",26,Angers,Ligue 2,23.2,38,28,15,14,9,22,45,48.9,23,45,0,45,18,56,8,0
Favian Loyola,USA,MF,17,Orlando City,MLS,0.0,0,0,0,0,0,0,0,0.0,0,0,0,0,0,0,0,0
Fawaz Al-Sqoor,SEN,FW,27,Grenoble,Ligue 2,22.8,6,5,4,2,0,2,10,20.0,8,8,2,6,8,14,26,0
Fede Vico,ESP,"MF,FW",29,Alcorcón,Segunda Division,7.7,20,11,11,8,1,10,13,76.9,3,10,2,8,3,23,8,0
Federico Barba,ITA,DF,29,Como,Serie B,29.0,27,19,16,10,1,10,17,58.8,7,19,11,8,32,59,109,1
Federico Bergonzi,ITA,DF,22,FeralpiSalò,Serie B,30.0,44,25,33,10,1,18,26,69.2,8,34,11,23,40,84,80,0
Federico Bernardeschi,ITA,"FW,MF",28,Toronto FC,MLS,28.9,16,11,4,6,6,7,25,28.0,18,16,0,16,12,28,2,2
Federico Carraro,ITA,MF,31,FeralpiSalò,Serie B,3.4,4,2,3,0,1,3,8,37.5,5,3,0,3,7,11,3,0
Federico Di Francesco,ITA,"FW,MF",29,Palermo,Serie B,25.8,28,19,15,9,4,11,25,44.0,14,20,2,18,13,41,28,0
Federico Dionisi,ITA,"FW,MF",36,Ternana,Serie B,5.1,8,4,1,3,4,3,6,50.0,3,6,0,6,2,10,1,0
Federico Dionisi,ITA,MF,36,Ascoli,Serie B,0.1,0,0,0,0,0,0,0,0.0,0,0,0,0,0,0,0,0
Federico Giraudo,ITA,DF,24,Cittadella,Serie B,13.0,25,13,12,11,2,16,32,50.0,16,10,0,10,23,48,23,1
Federico Lértora,ARG,MF,33,Querétaro,Liga MX,31.0,72,37,35,30,7,30,81,37.0,51,58,26,32,32,104,51,1
Federico Mancuello,ARG,MF,34,Puebla,Liga MX,3.0,4,2,1,3,0,1,4,25.0,3,3,1,2,3,7,5,0
Federico Navarro,ARG,MF,22,Fire,MLS,12.2,35,24,16,18,1,13,34,38.2,21,14,7,7,17,52,14,1
Federico Pereira,URU,DF,23,Toluca,Liga MX,17.0,29,17,20,7,2,14,22,63.6,8,21,10,11,27,56,43,0
Federico Viviani,ITA,"MF,FW",31,Ternana,Serie B,1.1,3,2,2,1,0,3,4,75.0,1,1,1,0,5,8,4,0
Federico Viñas,URU,FW,25,León,Liga MX,25.0,29,19,5,13,11,8,12,66.7,4,21,5,16,6,35,27,0
Federico Zuccon,ITA,MF,20,Cosenza,Serie B,20.9,67,37,26,31,10,22,46,47.8,24,36,6,30,15,82,28,0
Felipe,BRA,MF,32,Orlando City,MLS,6.3,9,6,1,8,0,4,14,28.6,10,3,2,1,8,17,7,0
Felipe Gutiérrez,CHI,MF,32,Sporting KC,MLS,3.3,8,5,2,6,0,2,6,33.3,4,1,0,1,3,11,3,0
Felipe Hernandez,USA,MF,24,Sporting KC,MLS,3.6,11,6,2,8,1,7,14,50.0,7,5,0,5,4,15,1,0
Felipe Mora,CHI,FW,29,Portland Timbers,MLS,9.1,4,2,0,3,1,0,4,0.0,4,1,1,0,0,4,3,0
Felix Afena-Gyan,GHA,"FW,MF",20,Cremonese,Serie B,2.6,6,4,2,1,3,2,3,66.7,1,3,0,3,3,9,1,0
Felix Garreta,ESP,DF,20,Amorebieta,Segunda Division,27.6,46,29,35,7,4,27,44,61.4,17,33,17,16,43,89,146,0
Felix Klaus,GER,"FW,MF",30,Düsseldorf,2. Bundesliga,23.3,41,24,20,15,6,21,37,56.8,16,22,3,19,10,51,24,0
Felix Lohkemper,GER,FW,28,Nürnberg,2. Bundesliga,6.0,1,1,0,1,0,0,2,0.0,2,6,2,4,3,4,7,0
Felix Platte,GER,"FW,MF",27,Paderborn 07,2. Bundesliga,7.8,6,3,2,2,2,3,3,100.0,0,4,3,1,0,6,5,0
Felix Ruschke,GER,DF,20,Hansa Rostock,2. Bundesliga,2.3,5,4,4,0,1,4,11,36.4,7,7,3,4,1,6,5,0
Femi Seriki,ENG,"DF,FW",21,Rotherham Utd,EFL,2.8,7,4,1,4,2,4,7,57.1,3,3,0,3,7,14,3,0
Fernand Mayembo,CGO,DF,27,Ajaccio,Ligue 2,1.0,1,1,1,0,0,1,1,100.0,0,0,0,0,2,3,2,0
Fernando Arce Jr.,USA,MF,26,Necaxa,Liga MX,24.4,72,41,40,28,4,32,62,51.6,30,43,10,33,46,118,39,0
Fernando Arce Jr.,USA,"MF,DF",26,Puebla,Liga MX,0.7,2,2,1,1,0,0,0,0.0,0,1,0,1,0,2,1,0
Fernando Beltrán,MEX,MF,25,Guadalajara,Liga MX,31.2,77,48,20,48,9,36,65,55.4,29,23,2,21,25,102,8,0
Fernando Calero,ESP,DF,28,Espanyol,Segunda Division,19.9,48,36,35,10,3,31,40,77.5,9,18,10,8,39,87,70,0
Fernando González,MEX,"FW,MF",22,UANL,Liga MX,0.4,0,0,0,0,0,0,1,0.0,1,2,0,2,0,0,0,0
Fernando Gorriarán,URU,MF,28,UANL,Liga MX,25.8,40,25,13,22,5,20,39,51.3,19,38,6,32,10,50,17,0
Fernando Madrigal,MEX,MF,31,Tijuana,Liga MX,17.3,23,14,7,13,3,11,29,37.9,18,13,2,11,11,34,10,0
Fernando Medrano,ESP,DF,24,Tenerife,Segunda Division,17.1,25,14,16,6,3,12,21,57.1,9,22,5,17,23,48,44,0
Fernando Navarro Morán,MEX,MF,34,Puebla,Liga MX,7.4,20,9,7,12,1,9,22,40.9,13,5,1,4,10,30,7,1
Fernando Navarro Morán,MEX,MF,34,Toluca,Liga MX,1.0,4,3,0,3,1,2,4,50.0,2,3,1,2,1,5,2,0
Fernando Niño,ESP,FW,23,Burgos,Segunda Division,29.3,34,20,8,16,10,13,29,44.8,16,29,2,27,9,43,18,0
Fernando Ordóñez,MEX,DF,22,UANL,Liga MX,1.7,2,1,1,1,0,0,1,0.0,1,4,1,3,4,6,3,0
Fernando Ovelar,PAR,"MF,FW",19,Pachuca,Liga MX,0.4,0,0,0,0,0,0,1,0.0,1,0,0,0,0,0,0,0
Fernando Pacheco,ESP,GK,32,Espanyol,Segunda Division,28.0,1,0,1,0,0,1,1,100.0,0,0,0,0,1,2,5,2
Fernando Rubén González,MEX,MF,29,Guadalajara,Liga MX,16.2,43,26,25,15,3,13,38,34.2,25,20,5,15,27,70,33,0
Fernando Tapia,MEX,GK,22,Querétaro,Liga MX,14.2,0,0,0,0,0,0,3,0.0,3,0,0,0,0,0,8,0
Fernando Álvarez,COL,DF,19,CF Montréal,MLS,2.8,3,2,1,2,0,1,2,50.0,1,5,2,3,7,10,11,0
Fidel,ESP,"MF,FW",34,Albacete,Segunda Division,8.3,10,6,5,5,0,4,12,33.3,8,6,1,5,2,12,2,1
Fidel,ESP,"MF,FW",34,Elche,Segunda Division,10.4,8,3,3,4,1,5,17,29.4,12,6,2,4,4,12,3,0
Fidel Ambríz,MEX,MF,20,León,Liga MX,15.8,36,20,16,16,4,17,44,38.6,27,19,4,15,12,48,15,0
Filip Bilbija,GER,"MF,FW",23,Paderborn 07,2. Bundesliga,22.4,21,17,4,14,3,9,23,39.1,14,31,4,27,8,29,8,1
Filip Jagiełło,POL,"MF,FW",25,Spezia,Serie B,5.9,12,7,4,5,3,3,11,27.3,8,5,0,5,0,12,5,0
Filip Kaloč,CZE,MF,23,Kaiserslautern,2. Bundesliga,15.0,21,15,7,10,4,8,14,57.1,6,7,0,7,16,37,15,1
Filip Krastev,BUL,MF,21,LAFC,MLS,1.8,6,3,3,2,1,1,7,14.3,6,8,0,8,1,7,1,0
Filip Stankovic,SRB,GK,21,Sampdoria,Serie B,37.0,1,0,1,0,0,1,2,50.0,1,0,0,0,0,1,6,2
Filip Stojilković,SUI,"FW,MF",23,Kaiserslautern,2. Bundesliga,1.7,0,0,0,0,0,0,2,0.0,2,2,0,2,0,0,3,0
Filippo Bandinelli,ITA,MF,28,Spezia,Serie B,21.7,40,22,12,20,8,16,39,41.0,23,29,4,25,20,60,29,0
Filippo Damian,ITA,MF,27,Ternana,Serie B,0.5,1,1,1,0,0,0,0,0.0,0,0,0,0,0,1,0,0
Filippo Distefano,ITA,"FW,DF",19,Ternana,Serie B,14.6,12,9,3,6,3,3,7,42.9,4,9,1,8,6,18,5,0
Filippo Faggi,ITA,MF,20,Bari,Serie B,0.2,1,0,0,1,0,0,1,0.0,1,0,0,0,1,2,1,0
Filippo Melegoni,ITA,"MF,FW",24,Reggiana,Serie B,15.1,32,18,17,10,5,13,30,43.3,17,26,4,22,16,48,13,0
Filippo Nardi,ITA,"MF,DF",25,Reggiana,Serie B,5.3,10,5,6,2,2,5,14,35.7,9,6,2,4,5,15,7,0
Filippo Pittarello,ITA,FW,26,Cittadella,Serie B,27.1,6,3,1,1,4,0,7,0.0,7,13,4,9,1,7,22,0
Filippo Ranocchia,ITA,MF,22,Palermo,Serie B,8.5,16,12,3,11,2,8,17,47.1,9,8,3,5,5,21,10,0
Filippo Romagna,ITA,DF,26,Reggiana,Serie B,11.5,9,3,9,0,0,4,9,44.4,5,12,9,3,14,23,60,0
Filippo Scaglia,ITA,DF,31,Südtirol,Serie B,14.9,20,9,11,8,1,7,16,43.8,9,14,9,5,16,36,86,0
Filippo Sgarbi,ITA,DF,25,Ternana,Serie B,8.1,9,8,5,3,1,3,5,60.0,2,12,8,4,10,19,30,0
Filippo Sgarbi,ITA,DF,25,Cosenza,Serie B,4.9,3,2,2,1,0,1,3,33.3,2,8,6,2,5,8,15,0
Filippo Vandelli,ITA,GK,22,Modena,Serie B,0.1,0,0,0,0,0,0,0,0.0,0,0,0,0,0,0,1,0
Finley Welch,ENG,FW,18,Norwich City,EFL,0.0,0,0,0,0,0,0,0,0.0,0,0,0,0,0,0,0,0
Finn Azaz,IRL,"MF,FW",22,Middlesbrough,EFL,15.1,17,11,3,9,5,7,20,35.0,13,18,2,16,8,25,5,0
Finn Azaz,IRL,"MF,FW",22,Plymouth Argyle,EFL,19.6,17,14,6,10,1,8,26,30.8,18,13,2,11,18,35,15,0
Finn Jeltsch,GER,DF,17,Nürnberg,2. Bundesliga,12.5,18,12,15,3,0,12,19,63.2,7,22,15,7,13,31,67,0
Finn Porath,GER,"MF,DF",26,Holstein Kiel,2. Bundesliga,18.3,45,25,15,21,9,16,39,41.0,23,27,10,17,20,65,37,0
Flamarion,BRA,"MF,FW",27,Valenciennes,Ligue 2,13.2,5,7,2,2,1,3,8,37.5,5,14,0,14,7,12,3,0
Flavio Junior Bianchi,ITA,"FW,MF",23,Brescia,Serie B,24.8,19,13,5,10,4,7,30,23.3,23,25,0,25,7,26,18,0
Florent Hanin,ALG,DF,33,Angers,Ligue 2,16.3,27,23,13,11,3,17,25,68.0,8,15,5,10,25,52,43,0
Florent Muslija,KVX,"MF,DF",25,Paderborn 07,2. Bundesliga,13.9,19,12,9,6,4,12,27,44.4,15,9,0,9,2,21,7,0
Florian Ayé,FRA,FW,26,Auxerre,Ligue 2,24.2,11,4,1,4,6,2,9,22.2,7,20,1,19,8,19,19,0
Florian Bianchini,FRA,"FW,MF",22,Bastia,Ligue 2,14.3,19,14,7,8,4,11,26,42.3,15,13,0,13,11,30,13,0
Florian Bohnert,LUX,DF,25,Bastia,Ligue 2,31.3,71,43,46,21,4,44,87,50.6,43,31,7,24,44,115,64,0
Florian Bähr,GER,"DF,MF",20,Osnabrück,2. Bundesliga,0.5,3,3,3,0,0,1,1,100.0,0,2,0,2,0,3,0,0
Florian Carstens,GER,DF,24,Wehen,2. Bundesliga,12.0,24,14,18,6,0,16,33,48.5,17,25,14,11,21,45,63,0
Florian Escales,FRA,GK,27,Annecy,Ligue 2,33.5,0,0,0,0,0,0,3,0.0,3,0,0,0,0,0,24,3
Florian Flick,GER,MF,23,Nürnberg,2. Bundesliga,25.5,59,29,36,22,1,33,60,55.0,27,53,30,23,34,93,79,1
Florian Hübner,GER,DF,32,Nürnberg,2. Bundesliga,6.3,13,8,12,1,0,5,10,50.0,5,5,4,1,6,19,29,0
Florian Kastenmeier,GER,GK,26,Düsseldorf,2. Bundesliga,33.0,1,1,1,0,0,0,2,0.0,2,0,0,0,0,1,21,3
Florian Kleinhansl,GER,DF,22,Osnabrück,2. Bundesliga,32.6,71,52,39,21,11,43,77,55.8,34,51,13,38,39,110,86,0
Florian Krüger,GER,FW,24,Braunschweig,2. Bundesliga,11.0,9,6,5,4,0,7,16,43.8,9,14,1,13,6,15,8,0
Florian Le Joncour,FRA,DF,28,Elversberg,2. Bundesliga,13.8,19,10,15,2,2,13,20,65.0,7,18,11,7,17,36,72,0
Florian Niederlechner,GER,"MF,FW",32,Hertha BSC,2. Bundesliga,11.4,16,11,4,9,3,11,15,73.3,4,27,9,18,2,18,8,0
Florian Pannafit,FRA,"FW,MF",21,Paris FC,Ligue 2,0.4,2,0,0,1,1,0,1,0.0,1,0,0,0,1,3,0,0
Florian Stritzel,GER,GK,29,Wehen,2. Bundesliga,34.0,0,0,0,0,0,0,1,0.0,1,0,0,0,0,0,21,0
Florian Tardieu,FRA,FW,31,Troyes,Ligue 2,0.1,0,0,0,0,0,0,0,0.0,0,0,0,0,0,0,0,0
Florian Tardieu,FRA,MF,31,Saint-Étienne,Ligue 2,24.9,68,46,31,32,5,34,73,46.6,39,29,10,19,33,101,36,0
Florin Andone,ROU,FW,31,Eldense,Segunda Division,15.7,14,7,1,8,5,3,10,30.0,7,11,2,9,3,17,10,0
Flynn Downes,ENG,MF,24,Southampton,EFL,28.3,60,39,17,32,11,22,38,57.9,16,31,10,21,47,107,22,0
Fran Gámez,ESP,DF,32,Zaragoza,Segunda Division,25.4,72,40,37,26,9,45,69,65.2,24,32,8,24,33,105,45,0
Fran Manzanara,ESP,MF,27,Racing Ferrol,Segunda Division,11.5,17,9,2,15,0,12,30,40.0,18,7,3,4,18,35,26,1
Fran Villalba,ESP,"MF,FW",26,Sporting Gijón,Segunda Division,15.2,14,8,7,5,2,5,19,26.3,14,8,0,8,8,22,12,0
Francesco Amatucci,ITA,MF,22,Cittadella,Serie B,21.1,60,41,25,27,8,30,61,49.2,31,45,11,34,25,85,29,0
Francesco Bardi,ITA,GK,31,Reggiana,Serie B,29.2,0,0,0,0,0,0,0,0.0,0,1,0,1,0,0,15,0
Francesco Cassata,ITA,"MF,DF",26,Spezia,Serie B,20.2,52,27,28,15,9,27,50,54.0,23,24,6,18,13,65,21,0
Francesco Conti,ITA,MF,18,Sampdoria,Serie B,0.1,0,0,0,0,0,0,0,0.0,0,0,0,0,0,0,0,0
Francesco Di Mariano,ITA,"FW,DF",27,Palermo,Serie B,17.6,17,13,8,7,2,7,26,26.9,19,14,2,12,11,28,19,0
Francesco Di Tacchio,ITA,MF,33,Ascoli,Serie B,29.8,55,37,25,26,4,24,56,42.9,32,44,23,21,32,87,59,0
Francesco Donati,ITA,DF,22,Calcio Lecco 1912,Serie B,0.2,2,1,1,1,0,2,2,100.0,0,1,1,0,0,2,3,0
Francesco Esposito,ITA,FW,18,Spezia,Serie B,19.8,8,2,0,3,5,3,15,20.0,12,13,2,11,5,13,10,0
Francesco Forte,ITA,MF,30,Ascoli,Serie B,0.5,1,1,0,0,1,0,0,0.0,0,0,0,0,0,1,0,0
Francesco Forte,ITA,"FW,MF",30,Cosenza,Serie B,18.4,16,10,2,9,5,5,14,35.7,9,9,2,7,6,22,19,0
Francesco Vicari,ITA,DF,28,Bari,Serie B,36.9,40,26,32,8,0,31,38,81.6,7,45,35,10,35,75,128,0
Francesco Zampano,ITA,DF,29,Venezia,Serie B,27.9,41,26,32,7,2,23,44,52.3,21,35,9,26,19,60,42,1
Francho Serrano,ESP,MF,22,Zaragoza,Segunda Division,18.9,37,20,10,18,9,23,39,59.0,16,20,5,15,8,45,22,0
Francisco Antonio Figueroa,MEX,"MF,FW",24,Pachuca,Liga MX,2.2,2,2,1,1,0,1,9,11.1,8,6,0,6,2,4,0,0
Francisco Antonio Figueroa,MEX,FW,24,Toluca,Liga MX,0.1,0,0,0,0,0,0,1,0.0,1,0,0,0,0,0,0,0
Francisco Calvo,CRC,DF,31,FC Juárez,Liga MX,14.0,25,17,13,12,0,14,27,51.9,13,20,11,9,29,54,72,2
Francisco Contreras,MEX,DF,24,Tijuana,Liga MX,23.1,43,28,18,20,5,18,30,60.0,12,20,4,16,28,71,49,0
Francisco Eduardo Venegas,MEX,DF,25,Querétaro,Liga MX,10.3,26,16,21,5,0,14,22,63.6,8,16,6,10,18,44,32,0
Francisco Eduardo Venegas,MEX,DF,25,Mazatlán,Liga MX,4.5,15,8,7,5,3,7,9,77.8,2,3,0,3,6,21,8,0
Francisco Nevarez,MEX,"DF,MF",22,FC Juárez,Liga MX,0.7,0,0,0,0,0,0,4,0.0,4,1,1,0,0,0,3,0
Francisco Portillo,ESP,"MF,FW",34,Leganés,Segunda Division,27.4,25,14,10,12,3,11,42,26.2,31,19,4,15,12,37,19,0
Francisco Sebastián Córdova,MEX,"MF,FW",26,UANL,Liga MX,16.5,24,15,8,10,6,8,22,36.4,14,14,3,11,4,28,6,0
Francisco Sierralta,CHI,"DF,MF",26,Watford,EFL,21.9,25,13,18,6,1,18,38,47.4,20,28,18,10,15,40,90,2
Franck Boli,CIV,FW,29,Atlético,Liga MX,7.7,4,3,0,3,1,0,0,0.0,0,1,0,1,1,5,2,0
Franck Boli,CIV,FW,29,Portland Timbers,MLS,16.2,11,5,1,5,5,1,7,14.3,6,6,0,6,0,11,3,0
Franco Carboni,ITA,"DF,FW",20,Ternana,Serie B,15.7,40,23,22,14,4,23,32,71.9,9,29,5,24,14,54,49,0
Franco Escobar,ARG,DF,27,Dynamo FC,MLS,24.7,72,49,43,22,7,42,62,67.7,20,31,8,23,35,107,37,0
Franco Fagúndez,URU,"MF,FW",23,Santos,Liga MX,5.6,9,6,1,5,3,3,6,50.0,3,3,0,3,1,10,6,0
Franco Fragapane,ARG,"MF,FW",29,Minnesota Utd,MLS,14.8,21,12,10,7,4,13,27,48.1,14,13,0,13,11,32,3,0
Franco Ibarra,ARG,MF,21,Toronto FC,MLS,4.9,11,7,4,7,0,4,15,26.7,11,7,3,4,8,19,9,0
Franco Ibarra,ARG,MF,21,Atlanta Utd,MLS,14.2,61,33,25,31,5,33,62,53.2,29,31,1,30,14,75,31,1
Franco Lepore,ITA,"DF,FW",37,Calcio Lecco 1912,Serie B,30.7,50,27,27,17,6,30,50,60.0,20,24,5,19,27,77,64,1
Franco Negri,ARG,DF,27,Inter Miami,MLS,14.8,35,21,14,19,2,18,33,54.5,15,25,3,22,26,61,27,0
Franco Vázquez,ARG,"FW,MF",34,Cremonese,Serie B,27.8,51,32,17,25,9,22,43,51.2,21,29,2,27,7,58,14,0
Frank Boya,CMR,MF,27,Amiens,Ligue 2,21.6,49,30,21,25,3,33,67,49.3,34,47,15,32,34,83,69,1
Frank Ronstadt,GER,DF,26,Kaiserslautern,2. Bundesliga,3.2,7,4,5,2,0,4,5,80.0,1,4,0,4,2,9,1,0
Frank Tsadjout,ITA,"FW,MF",24,Cremonese,Serie B,8.9,6,5,3,3,0,0,4,0.0,4,4,0,4,3,9,12,0
Frankie Amaya,USA,MF,22,NY Red Bulls,MLS,21.3,43,23,15,21,7,24,50,48.0,26,23,3,20,27,70,29,0
Franko Kovačević,CRO,"FW,MF",23,Wehen,2. Bundesliga,11.7,7,5,4,1,2,2,9,22.2,7,2,0,2,3,10,9,0
François Lajugie,FRA,DF,27,Annecy,Ligue 2,31.1,42,26,21,16,5,28,59,47.5,31,29,9,20,28,70,73,2
François Mughe,CMR,"FW,MF",19,Dunkerque,Ligue 2,1.4,1,0,0,1,0,0,1,0.0,1,2,0,2,1,2,1,0
François-Joseph Sollacaro,FRA,GK,29,Ajaccio,Ligue 2,17.0,0,0,0,0,0,0,1,0.0,1,0,0,0,0,0,13,0
Fred Onyedinma,ENG,"FW,MF",26,Rotherham Utd,EFL,13.8,15,12,6,9,0,5,8,62.5,3,10,1,9,7,22,14,0
Freddie Ladapo,ENG,FW,30,Ipswich Town,EFL,3.9,5,2,0,1,4,0,3,0.0,3,2,1,1,0,5,1,0
Freddie Woodman,ENG,GK,26,Preston,EFL,44.0,0,0,0,0,0,0,2,0.0,2,0,0,0,1,1,18,4
Freddy Mbemba,FRA,"MF,FW",20,Dunkerque,Ligue 2,0.4,0,0,0,0,0,0,1,0.0,1,2,0,2,0,0,0,0
Frederico Venâncio,POR,DF,31,Eibar,Segunda Division,11.2,10,6,7,2,1,3,6,50.0,3,10,8,2,7,17,59,1
Frederik Jäkel,GER,DF,22,Elversberg,2. Bundesliga,15.2,16,11,9,7,0,9,12,75.0,3,26,19,7,17,33,72,0
Frederik Sørensen,DEN,DF,31,Ternana,Serie B,9.7,16,11,9,7,0,2,14,14.3,12,16,9,7,18,34,74,2
Fredy Montero,COL,"FW,MF",35,Seattle,MLS,4.8,7,6,2,3,2,2,7,28.6,5,1,0,1,0,7,0,0
Félix Tomi,FRA,"MF,FW",22,Bastia,Ligue 2,3.4,12,5,5,4,3,4,5,80.0,1,2,0,2,2,14,1,0
Félix Torres Caicedo,ECU,DF,26,Santos,Liga MX,15.1,16,12,15,1,0,6,9,66.7,3,20,14,6,39,55,77,0
Gabe Segal,USA,FW,21,NYCFC,MLS,4.6,8,7,1,3,4,4,6,66.7,2,3,0,3,1,9,2,0
Gabin Blancquart,FRA,DF,19,Valenciennes,Ligue 2,4.0,6,1,5,1,0,4,6,66.7,2,6,5,1,9,15,24,0
Gabri Martínez,ESP,"FW,MF",21,CD Mirandés,Segunda Division,36.4,38,20,18,11,9,21,47,44.7,26,42,6,36,16,54,23,0
Gabriel,BRA,"MF,FW",24,Norwich City,EFL,45.6,93,54,37,44,12,40,87,46.0,47,45,8,37,33,126,83,0
Gabriel Bares,SUI,MF,22,US Concarneau,Ligue 2,18.7,31,16,17,13,1,22,38,57.9,16,20,5,15,17,48,23,0
Gabriel Carabajal,ARG,"MF,FW",31,Puebla,Liga MX,5.5,8,8,1,4,3,1,6,16.7,5,5,0,5,2,10,5,0
Gabriel Charpentier,CGO,"FW,MF",24,Parma,Serie B,7.2,7,7,1,2,4,2,5,40.0,3,13,2,11,4,11,7,0
Gabriel Fernández,URU,FW,29,UNAM,Liga MX,12.7,12,9,2,6,4,1,9,11.1,8,9,1,8,1,13,17,0
Gabriel Fernández,URU,FW,29,Cruz Azul,Liga MX,4.3,1,1,0,0,1,0,4,0.0,4,1,0,1,2,3,1,0
Gabriel Jimeno,ESP,MF,20,Eldense,Segunda Division,0.1,0,0,0,0,0,0,0,0.0,0,0,0,0,0,0,0,0
Gabriel Lunetta,ITA,"FW,MF",26,Calcio Lecco 1912,Serie B,2.0,7,5,4,2,1,4,8,50.0,4,2,0,2,0,7,2,0
Gabriel Lunetta,ITA,"MF,FW",26,Südtirol,Serie B,5.4,15,8,5,5,5,4,11,36.4,7,6,0,6,3,18,5,0
Gabriel Oualengbe,CTA,MF,19,Paris FC,Ligue 2,0.0,0,0,0,0,0,0,0,0.0,0,0,0,0,0,0,0,0
Gabriel Pereira,BRA,"FW,MF",21,NYCFC,MLS,17.1,14,11,5,7,2,4,14,28.6,10,12,0,12,9,23,7,0
Gabriel Pirani,BRA,MF,20,D.C. United,MLS,9.2,12,8,4,7,1,2,7,28.6,5,7,0,7,2,14,1,0
Gabriel Strefezza,BRA,"FW,MF",26,Como,Serie B,13.0,22,13,2,14,6,10,17,58.8,7,21,2,19,5,27,3,0
Gabriele Alesi,ITA,MF,19,Sampdoria,Serie B,0.0,0,0,0,0,0,0,0,0.0,0,0,0,0,0,0,0,0
Gabriele Boloca,ROU,DF,22,Ternana,Serie B,3.3,11,7,6,4,1,4,7,57.1,3,3,2,1,5,16,15,0
Gabriele Corbo,ITA,DF,23,CF Montréal,MLS,25.4,31,18,19,11,1,23,49,46.9,26,26,15,11,32,63,86,2
Gabriele Ferrarini,ITA,DF,23,FeralpiSalò,Serie B,1.9,2,1,1,1,0,1,2,50.0,1,2,2,0,2,4,4,0
Gabriele Moncini,ITA,FW,27,Brescia,Serie B,21.5,4,1,1,3,0,3,7,42.9,4,10,3,7,3,7,17,0
Gabriele Piccinini,ITA,"MF,FW",22,Pisa,Serie B,12.0,16,9,8,6,2,2,8,25.0,6,10,3,7,6,22,15,0
Gaby Jean,FRA,DF,23,Annecy,Ligue 2,38.0,25,15,13,11,1,15,26,57.7,11,38,15,23,32,57,151,1
Gaddi Aguirre,MEX,DF,27,Atlas,Liga MX,16.2,24,17,13,8,3,13,21,61.9,8,24,17,7,23,47,45,0
Gael García,MEX,"MF,FW",15,Guadalajara,Liga MX,0.2,1,0,1,0,0,1,2,50.0,1,2,0,2,0,1,2,0
Gaetano Letizia,ITA,"DF,FW",33,FeralpiSalò,Serie B,16.3,37,24,19,18,0,20,33,60.6,13,16,4,12,24,61,17,0
Gaetano Masucci,ITA,"FW,MF",38,Pisa,Serie B,1.6,6,4,3,2,1,1,3,33.3,2,4,0,4,1,7,1,0
Gaoussou Samaké,CIV,"MF,DF",25,D.C. United,MLS,4.0,7,4,4,0,3,4,12,33.3,8,4,1,3,8,15,4,0
Garland Gbelle,FRA,MF,30,Quevilly-Rouen,Ligue 2,19.5,36,25,8,17,11,20,47,42.6,27,35,2,33,19,55,19,0
Gary Gardner,ENG,MF,31,Birmingham City,EFL,2.3,2,2,0,2,0,2,2,100.0,0,3,2,1,6,8,1,0
Gaspar Campos,ESP,"MF,FW",24,Sporting Gijón,Segunda Division,30.7,46,23,12,25,9,26,57,45.6,31,28,2,26,10,56,10,1
Gaston Gonzalez,ARG,"FW,DF",21,Orlando City,MLS,8.0,13,9,8,3,2,8,15,53.3,7,8,2,6,5,18,10,0
Gastón Brugman,URU,MF,30,LA Galaxy,MLS,21.1,57,36,30,21,6,27,56,48.2,29,26,7,19,37,94,28,0
Gastón Giménez,PAR,MF,31,Fire,MLS,24.4,57,40,18,32,7,29,51,56.9,22,46,17,29,28,85,25,1
Gastón Pereiro,URU,FW,28,Ternana,Serie B,15.3,6,3,2,3,1,3,9,33.3,6,4,0,4,0,6,9,0
Gastón Silva,URU,DF,29,Puebla,Liga MX,27.9,48,30,33,14,1,33,64,51.6,31,46,22,24,23,71,129,0
Gastón Valles,URU,"FW,MF",23,Espanyol,Segunda Division,3.8,8,5,0,4,4,5,8,62.5,3,6,1,5,0,8,2,0
Gauthier Hein,FRA,MF,26,Auxerre,Ligue 2,35.7,38,22,13,15,10,22,49,44.9,27,19,1,18,10,48,7,0
Gautier Larsonneur,FRA,GK,26,Saint-Étienne,Ligue 2,32.0,0,0,0,0,0,0,3,0.0,3,0,0,0,0,0,12,2
Gavin Bazunu,IRL,GK,21,Southampton,EFL,41.0,2,2,1,1,0,2,2,100.0,0,0,0,0,1,3,16,3
Gavin Beavers,USA,GK,17,RSL,MLS,6.5,0,0,0,0,0,0,0,0.0,0,0,0,0,0,0,5,1
Gaël Kakuta,COD,"MF,FW",32,Amiens,Ligue 2,18.6,42,29,9,20,13,12,27,44.4,15,12,1,11,15,57,9,0
Gaëtan Charbonnier,FRA,"FW,MF",34,Saint-Étienne,Ligue 2,7.7,4,3,0,3,1,0,3,0.0,3,2,0,2,0,4,9,0
Gaëtan Charbonnier,FRA,"FW,MF",34,Bastia,Ligue 2,7.4,8,4,2,3,3,4,7,57.1,3,5,1,4,1,9,12,0
Gaëtan Courtet,FRA,"FW,MF",34,Guingamp,Ligue 2,7.1,6,5,2,3,1,1,14,7.1,13,4,0,4,3,9,4,0
Gaëtan Courtet,FRA,FW,34,Dunkerque,Ligue 2,17.8,15,9,4,6,5,7,29,24.1,22,8,4,4,8,23,29,0
Gaëtan Paquiez,FRA,DF,29,Grenoble,Ligue 2,27.1,59,38,38,16,5,36,79,45.6,43,47,17,30,36,95,80,0
Gaëtan Perrin,FRA,"FW,MF",27,Auxerre,Ligue 2,33.3,34,21,7,13,14,21,52,40.4,31,20,0,20,18,52,5,0
Gaëtan Poussin,FRA,GK,25,Zaragoza,Segunda Division,2.3,0,0,0,0,0,0,1,0.0,1,0,0,0,1,1,2,2
Gaëtan Weissbeck,FRA,"MF,FW",26,Bordeaux,Ligue 2,27.2,55,29,25,22,8,25,53,47.2,28,24,1,23,22,77,19,0
Gennaro Acampora,ITA,MF,29,Bari,Serie B,13.0,34,22,17,16,1,12,25,48.0,13,19,3,16,7,41,10,0
Gennaro Borrelli,ITA,FW,23,Brescia,Serie B,16.1,8,5,3,3,2,4,10,40.0,6,11,2,9,1,9,23,0
Gennaro Tutino,ITA,"FW,MF",26,Cosenza,Serie B,31.0,6,3,1,2,3,2,8,25.0,6,11,5,6,1,7,17,0
George Byers,SCO,MF,27,Sheffield Weds,EFL,15.3,28,13,9,17,2,11,35,31.4,24,26,5,21,30,58,38,1
George Campbell,USA,DF,21,CF Montréal,MLS,20.6,42,29,32,7,3,26,39,66.7,13,26,10,16,25,67,51,7
George Edmundson,ENG,DF,25,Ipswich Town,EFL,9.9,16,10,11,5,0,12,18,66.7,6,6,4,2,5,21,42,0
George Evans,ENG,MF,28,Millwall,EFL,0.2,0,0,0,0,0,0,0,0.0,0,1,0,1,0,0,0,0
George Hall,ENG,"MF,FW",19,Birmingham City,EFL,1.5,2,1,1,1,0,2,4,50.0,2,1,0,1,1,3,0,0
George Hirst,ENG,FW,24,Ipswich Town,EFL,19.6,3,1,0,1,2,0,5,0.0,5,8,3,5,2,5,7,0
George Honeyman,ENG,MF,28,Millwall,EFL,23.1,70,45,26,34,10,31,70,44.3,39,28,0,28,26,96,29,2
George Long,ENG,GK,29,Norwich City,EFL,6.7,0,0,0,0,0,0,1,0.0,1,0,0,0,0,0,2,0
George Marks,USA,GK,23,Charlotte,MLS,7.0,1,1,1,0,0,0,0,0.0,0,0,0,0,0,1,4,1
George Pușcaș,ROU,FW,27,Bari,Serie B,9.6,1,0,0,1,0,1,2,50.0,1,0,0,0,2,3,5,0
George Saville,NIR,MF,30,Millwall,EFL,29.5,86,48,35,46,5,40,78,51.3,38,55,15,40,50,136,42,0
George Tanner,ENG,DF,23,Bristol City,EFL,33.7,80,49,54,22,4,47,76,61.8,29,36,13,23,32,112,105,2
Georgie Kelly,IRL,FW,26,Rotherham Utd,EFL,3.5,3,3,1,2,0,0,2,0.0,2,6,2,4,2,5,7,0
Georginio Rutter,FRA,"FW,MF",21,Leeds United,EFL,41.5,64,43,16,27,21,29,62,46.8,33,32,3,29,20,84,32,0
Georgios Koutsias,GRE,"FW,MF",18,Fire,MLS,11.3,4,2,2,1,1,2,16,12.5,14,8,4,4,3,7,13,0
Geovane,BRA,DF,21,FC Dallas,MLS,11.0,15,10,8,5,2,11,20,55.0,9,15,6,9,15,30,42,0
Gerard Buabo,ENG,FW,19,Ipswich Town,EFL,0.0,0,0,0,0,0,0,0,0.0,0,0,0,0,0,0,0,0
Gerard Hernandez,ESP,MF,19,Villarreal B,Segunda Division,0.0,0,0,0,0,0,0,0,0.0,0,0,0,0,0,0,0,0
Gerard Valentín,ESP,"MF,DF",30,Huesca,Segunda Division,26.1,52,25,24,20,8,26,44,59.1,18,27,2,25,12,64,32,0
Gerard Yepes,ESP,MF,20,Sampdoria,Serie B,30.7,65,44,42,18,5,30,57,52.6,27,40,8,32,49,114,59,1
Gerardo Arteaga,MEX,DF,24,Monterrey,Liga MX,9.3,18,13,13,4,1,8,13,61.5,5,12,2,10,16,34,17,0
Gerardo Valenzuela,USA,MF,18,FC Cincinnati,MLS,0.1,1,0,1,0,0,1,1,100.0,0,0,0,0,1,2,0,0
Germán Berterame,ARG,"FW,MF",24,Monterrey,Liga MX,19.8,10,3,2,8,0,2,8,25.0,6,19,0,19,12,22,24,0
Germán Sánchez,ESP,DF,37,Racing Sant,Segunda Division,30.4,24,15,16,7,1,9,17,52.9,8,33,28,5,25,49,185,0
Germán Valera,ESP,"MF,FW",22,Zaragoza,Segunda Division,24.6,36,21,16,15,5,13,33,39.4,20,25,2,23,19,55,25,0
Gessime Yassine,FRA,"MF,FW",17,Dunkerque,Ligue 2,15.2,48,29,16,22,10,21,46,45.7,25,24,3,21,9,57,14,0
Giacint Rafele,ITA,MF,18,Catanzaro,Serie B,0.0,0,0,0,0,0,0,0,0.0,0,1,0,1,0,0,0,0
Giacomo Beretta,ITA,FW,31,Calcio Lecco 1912,Serie B,0.4,0,0,0,0,0,0,0,0.0,0,0,0,0,0,0,0,0
Giacomo Calò,ITA,MF,26,Cosenza,Serie B,26.0,39,22,12,23,4,15,43,34.9,28,41,16,25,30,69,37,0
Giacomo Drago,ITA,GK,22,Südtirol,Serie B,1.0,0,0,0,0,0,0,0,0.0,0,0,0,0,0,0,1,0
Giacomo Faticanti,ITA,MF,19,Ternana,Serie B,4.7,9,6,5,3,1,5,10,50.0,5,4,2,2,9,18,15,0
Giacomo Manzari,ITA,"MF,FW",22,Ascoli,Serie B,5.8,8,4,3,5,0,3,5,60.0,2,4,0,4,1,9,4,0
Giacomo Manzari,ITA,FW,22,FeralpiSalò,Serie B,5.2,2,2,1,1,0,0,2,0.0,2,5,0,5,1,3,4,0
Giacomo Olzer,ITA,"MF,FW",22,Brescia,Serie B,10.0,19,13,6,7,6,7,14,50.0,7,15,3,12,12,31,15,0
Giacomo Poluzzi,ITA,GK,35,Südtirol,Serie B,37.0,1,0,1,0,0,1,1,100.0,0,0,0,0,0,1,14,3
Giacomo Quagliata,ITA,DF,23,Cremonese,Serie B,12.8,11,6,3,7,1,4,8,50.0,4,14,1,13,19,30,19,0
Giacomo Ricci,ITA,DF,26,Bari,Serie B,28.6,72,51,43,22,7,34,54,63.0,20,34,5,29,44,116,67,0
Giacomo Satalino,ITA,GK,24,Reggiana,Serie B,8.8,0,0,0,0,0,0,1,0.0,1,0,0,0,0,0,2,1
Giacomo Vrioni,ALB,FW,24,NE Revolution,MLS,14.6,7,5,1,5,1,2,16,12.5,14,8,3,5,4,11,12,0
Gian-Luca Itter,GER,DF,24,Greuther Fürth,2. Bundesliga,13.8,27,16,12,15,0,17,24,70.8,7,20,6,14,17,44,25,0
Gianluca Busio,USA,MF,21,Venezia,Serie B,32.6,59,37,31,20,8,27,59,45.8,32,46,10,36,24,83,65,1
Gianluca Di Chiara,ITA,DF,29,Parma,Serie B,18.2,30,19,14,10,6,17,23,73.9,6,31,6,25,17,47,36,1
Gianluca Frabotta,ITA,DF,24,Cosenza,Serie B,12.6,23,17,10,9,4,13,21,61.9,8,21,6,15,18,41,45,0
Gianluca Frabotta,ITA,DF,24,Bari,Serie B,4.9,1,0,1,0,0,1,5,20.0,4,6,0,6,9,10,8,0
Gianluca Saro,ITA,GK,23,Cremonese,Serie B,8.0,0,0,0,0,0,0,0,0.0,0,0,0,0,0,0,1,1
Gibran Lajud,MEX,GK,29,Santos,Liga MX,9.0,1,1,1,0,0,0,2,0.0,2,0,0,0,0,1,6,0
Gideon Jung,GER,DF,28,Greuther Fürth,2. Bundesliga,25.7,20,14,13,7,0,7,13,53.8,6,20,12,8,31,51,88,0
Gideon Mensah,GHA,DF,25,Auxerre,Ligue 2,23.3,63,40,27,24,12,35,58,60.3,23,23,5,18,30,93,42,2
Gilberto Sepúlveda,MEX,DF,24,Guadalajara,Liga MX,23.8,26,20,14,11,1,12,18,66.7,6,35,23,12,35,61,73,0
Gino Fechner,GER,MF,25,Wehen,2. Bundesliga,18.4,42,26,18,23,1,16,30,53.3,14,25,6,19,21,63,41,0
Gino Vivi,CRC,"MF,DF",22,LA Galaxy,MLS,0.9,0,0,0,0,0,0,1,0.0,1,0,0,0,3,3,0,0
Giorgi Chakvetadze,GEO,"MF,FW",23,Watford,EFL,17.8,28,22,15,11,2,10,33,30.3,23,17,1,16,12,40,5,0
Giorgi Kochorashvili,GEO,MF,24,Levante,Segunda Division,14.3,26,14,12,11,3,13,26,50.0,13,13,5,8,17,43,12,0
Giorgio Altare,ITA,DF,24,Venezia,Serie B,25.1,53,36,36,14,3,25,44,56.8,19,39,23,16,52,105,102,1
Giorgio Chiellini,ITA,DF,38,LAFC,MLS,15.2,18,11,13,5,0,8,16,50.0,8,9,6,3,29,47,58,0
Giorgio Galli,ITA,MF,26,Calcio Lecco 1912,Serie B,14.6,41,20,19,20,2,12,23,52.2,11,19,5,14,29,70,25,1
Giorgos Giakoumakis,GRE,FW,28,Atlanta Utd,MLS,19.8,23,16,5,9,9,10,30,33.3,20,20,4,16,2,25,34,0
Giovanni Aguilar,USA,MF,24,Vancouver W'caps,MLS,0.1,1,1,1,0,0,0,0,0.0,0,0,0,0,0,1,0,0
Giovanni Crociata,ITA,"MF,FW",25,Calcio Lecco 1912,Serie B,28.4,40,23,20,15,5,21,50,42.0,29,27,2,25,20,60,25,0
Giovanni Haag,FRA,MF,23,Rodez Aveyron,Ligue 2,30.1,96,50,41,48,7,48,82,58.5,34,50,10,40,44,140,47,0
Giovanni Leoni,ITA,DF,16,Sampdoria,Serie B,8.5,17,11,14,3,0,10,15,66.7,5,8,3,5,15,32,37,0
Giovanni Zaro,ITA,DF,29,Modena,Serie B,36.6,71,40,42,27,2,33,55,60.0,22,62,35,27,57,128,159,0
Giuseppe Ambrosino,ITA,FW,19,Catanzaro,Serie B,14.1,3,3,0,3,0,1,11,9.1,10,9,1,8,2,5,12,0
Giuseppe Aurelio,ITA,DF,23,Palermo,Serie B,9.4,13,6,11,2,0,7,14,50.0,7,6,2,4,14,27,20,1
Giuseppe Bellusci,ITA,DF,33,Ascoli,Serie B,28.8,44,28,27,13,4,24,33,72.7,9,34,19,15,36,80,110,1
Giuseppe Carriero,ITA,MF,25,Cittadella,Serie B,17.7,39,26,16,17,6,18,33,54.5,15,32,5,27,14,53,22,0
Giuseppe Cuomo,ITA,DF,25,Südtirol,Serie B,7.3,11,7,5,5,1,4,7,57.1,3,8,6,2,9,20,33,0
Giuseppe Di Serio,ITA,FW,22,Spezia,Serie B,6.9,3,2,0,2,1,2,2,100.0,0,7,1,6,2,5,6,0
Giuseppe Sibilli,ITA,"FW,MF",26,Bari,Serie B,32.0,35,23,8,17,10,13,39,33.3,26,20,6,14,8,43,15,0
Glen Kamara,FIN,MF,27,Leeds United,EFL,30.0,38,20,9,23,6,18,32,56.3,14,21,5,16,33,71,17,0
Godson Kyeremeh,FRA,"MF,FW",23,Caen,Ligue 2,20.0,21,11,6,7,8,12,22,54.5,10,11,2,9,19,40,5,0
Gonzalo Abrego,ARG,MF,23,Cremonese,Serie B,12.2,30,20,11,11,8,15,27,55.6,12,20,4,16,10,40,12,0
Gonzalo Nápoli,URU,"MF,FW",23,León,Liga MX,6.4,17,9,9,8,0,8,15,53.3,7,6,0,6,5,22,4,1
Gonzalo Pelúa,URU,DF,20,FC Juárez,Liga MX,4.5,4,4,3,1,0,2,6,33.3,4,6,2,4,8,12,21,1
Gonzalo Piovi,ARG,DF,28,Cruz Azul,Liga MX,15.2,40,20,21,17,2,19,34,55.9,15,14,3,11,39,79,51,0
Gonzalo Verdú,ESP,DF,35,Cartagena,Segunda Division,18.6,19,11,12,7,0,7,13,53.8,6,21,17,4,21,40,113,0
Grady Diangana,COD,"MF,FW",25,West Brom,EFL,26.1,30,17,15,13,2,13,24,54.2,11,32,1,31,8,38,6,0
Graham Zusi,USA,DF,36,Sporting KC,MLS,9.6,19,14,11,6,2,14,22,63.6,8,12,4,8,11,30,25,0
Grant Hall,ENG,"DF,MF",31,Rotherham Utd,EFL,3.1,2,2,2,0,0,1,2,50.0,1,3,2,1,2,4,21,1
Grant Hanley,SCO,DF,31,Norwich City,EFL,6.1,7,4,4,3,0,2,3,66.7,1,4,3,1,8,15,20,2
Greg Cunningham,IRL,DF,32,Preston,EFL,8.1,13,7,7,5,1,9,17,52.9,8,8,3,5,9,22,17,1
Greg Docherty,SCO,MF,26,Hull City,EFL,3.6,6,4,4,2,0,3,14,21.4,11,4,2,2,3,9,12,0
Greg Leigh,JAM,DF,28,Ipswich Town,EFL,0.0,1,0,1,0,0,1,1,100.0,0,0,0,0,0,1,1,0
Greg Ranjitsingh,TRI,GK,29,Toronto FC,MLS,4.0,0,0,0,0,0,0,1,0.0,1,0,0,0,1,1,5,1
Grego Sierra,ESP,DF,31,Burgos,Segunda Division,21.9,21,12,15,6,0,8,18,44.4,10,24,16,8,19,40,106,2
Gregore,BRA,MF,28,Inter Miami,MLS,4.3,7,5,3,2,2,6,12,50.0,6,7,1,6,3,10,5,0
Gregorio Luperini,ITA,MF,29,Ternana,Serie B,26.9,41,25,22,15,4,20,56,35.7,36,41,4,37,30,71,21,0
Gregorio Morachioli,ITA,"FW,MF",23,Bari,Serie B,10.5,8,4,3,3,2,3,12,25.0,9,12,2,10,2,10,5,0
Gregorio Tanco,ARG,DF,23,Spezia,Serie B,1.6,8,5,6,2,0,4,6,66.7,2,3,1,2,3,11,12,0
Griffin Dorsey,USA,DF,23,Dynamo FC,MLS,11.4,14,10,8,4,2,4,8,50.0,4,13,3,10,13,27,34,0
Guido Pizarro,ARG,DF,33,UANL,Liga MX,23.9,36,24,19,14,3,18,46,39.1,28,18,11,7,23,59,39,0
Guido Rovere,ITA,MF,16,Cremonese,Serie B,0.3,1,1,1,0,0,1,1,100.0,0,0,0,0,1,2,0,0
Guilherme Ramos,POR,DF,25,Hamburger SV,2. Bundesliga,17.3,30,22,21,8,1,18,30,60.0,12,29,18,11,29,59,69,2
Guillaume Jannez,FRA,DF,34,US Concarneau,Ligue 2,33.0,69,41,47,21,1,41,68,60.3,27,48,23,25,59,128,147,1
Guillermo Allison,MEX,GK,32,Querétaro,Liga MX,19.8,0,0,0,0,0,0,1,0.0,1,1,0,1,0,0,5,2
Guillermo Martínez Ayala,MEX,FW,28,UNAM,Liga MX,12.8,7,2,0,5,2,2,5,40.0,3,8,0,8,1,8,6,0
Guillermo Martínez Ayala,MEX,FW,28,Puebla,Liga MX,15.0,6,1,1,3,2,2,7,28.6,5,9,3,6,1,7,17,0
Guillermo Muñoz,MEX,FW,18,Santos,Liga MX,0.2,1,1,0,1,0,0,0,0.0,0,1,0,1,0,1,0,0
Guillermo Rosas,ESP,"DF,MF",24,Sporting Gijón,Segunda Division,17.5,71,43,53,15,3,39,55,70.9,16,17,5,12,20,91,31,0
Gustav Christensen,DEN,"FW,MF",18,Hertha BSC,2. Bundesliga,3.2,6,4,4,1,1,3,7,42.9,4,5,2,3,1,7,3,0
Gustavo Bou,ARG,"FW,MF",32,NE Revolution,MLS,14.0,12,7,5,5,2,4,16,25.0,12,11,1,10,7,19,4,0
Gustavo Cabral,ARG,DF,37,Pachuca,Liga MX,25.3,31,17,20,9,2,14,26,53.8,12,28,18,10,34,65,95,0
Gustavo Del Prete,ARG,"MF,FW",27,UNAM,Liga MX,8.2,14,8,4,7,3,6,16,37.5,10,4,1,3,2,16,6,0
Gustavo Del Prete,ARG,"FW,MF",27,Mazatlán,Liga MX,12.4,21,11,5,11,5,10,22,45.5,12,13,2,11,3,24,2,0
Gustavo Ferrareis,BRA,DF,27,Puebla,Liga MX,29.3,63,39,32,25,6,31,64,48.4,33,35,8,27,34,97,68,0
Gustavo Hamer,NED,MF,26,Coventry City,EFL,0.8,2,0,2,0,0,1,2,50.0,1,2,1,1,1,3,0,0
Gustavo Henrique,BRA,DF,31,Valladolid,Segunda Division,7.7,5,4,3,2,0,3,6,50.0,3,9,7,2,5,10,29,0
Gustavo Sangaré,BFA,MF,26,Quevilly-Rouen,Ligue 2,19.2,54,38,19,30,5,22,56,39.3,34,22,6,16,31,85,25,0
Gustavo Vallecilla,ECU,DF,23,Crew,MLS,9.4,17,12,11,6,0,10,22,45.5,12,12,5,7,10,27,16,0
Guzmán Corujo,URU,DF,26,Charlotte,MLS,3.9,9,8,7,2,0,7,8,87.5,1,3,2,1,5,14,14,1
Gyasi Zardes,USA,FW,31,Austin,MLS,16.3,13,8,3,8,2,8,17,47.1,9,8,1,7,1,14,16,0
Haissem Hassan,FRA,"MF,FW",22,Sporting Gijón,Segunda Division,26.6,23,15,12,8,3,8,30,26.7,22,18,0,18,10,33,11,0
Haji Wright,USA,"FW,MF",25,Coventry City,EFL,33.0,36,23,14,12,10,13,24,54.2,11,27,3,24,4,40,18,0
Hakeem Odoffin,ENG,"DF,MF",25,Rotherham Utd,EFL,34.5,80,50,53,23,4,30,46,65.2,16,62,33,29,72,152,123,0
Halid Šabanović,BIH,DF,23,Valenciennes,Ligue 2,2.6,4,4,1,2,1,4,8,50.0,4,1,0,1,1,5,7,0
Hamady Diop,SEN,"DF,MF",20,Charlotte,MLS,0.4,1,1,1,0,0,0,1,0.0,1,1,0,1,0,1,5,0
Hamjatou Soukouna,MLI,DF,24,Annecy,Ligue 2,15.6,20,13,16,3,1,14,18,77.8,4,17,7,10,17,37,73,0
Hampus Finndell,SWE,MF,23,Braunschweig,2. Bundesliga,2.7,7,3,3,4,0,2,6,33.3,4,2,1,1,8,15,3,0
Hamza Choudhury,ENG,"DF,MF",25,Leicester City,EFL,16.4,44,32,20,22,2,18,43,41.9,25,27,10,17,28,72,37,0
Hamza El Kaouakibi,MAR,"DF,MF",25,Südtirol,Serie B,2.6,3,1,1,2,0,1,3,33.3,2,8,1,7,1,4,8,0
Hamza Sakhi,FRA,MF,27,Ajaccio,Ligue 2,14.5,24,17,13,9,2,13,28,46.4,15,11,1,10,5,29,1,0
Hany Mukhtar,GER,"FW,MF",27,Nashville,MLS,31.5,16,10,0,9,7,10,33,30.3,23,15,0,15,6,22,5,0
Haralambos Makridis,GRE,"FW,MF",27,Osnabrück,2. Bundesliga,12.4,19,12,10,7,2,5,19,26.3,14,9,0,9,10,29,22,0
Haret Ortega,MEX,DF,23,FC Juárez,Liga MX,5.0,10,8,7,3,0,4,5,80.0,1,4,2,2,11,21,27,1
Haris Tabakovic,BIH,FW,29,Hertha BSC,2. Bundesliga,28.4,12,8,3,7,2,5,11,45.5,6,19,7,12,2,14,42,0
Harold Preciado,COL,FW,29,Santos,Liga MX,21.3,9,5,0,6,3,2,6,33.3,4,13,3,10,1,10,20,0
Harrison Afful,GHA,DF,36,Charlotte,MLS,10.6,11,7,4,5,2,7,19,36.8,12,10,2,8,22,33,26,1
Harrison Ashby,SCO,"DF,MF",21,Swansea City,EFL,8.9,26,20,13,11,2,12,25,48.0,13,12,4,8,18,44,18,1
Harry Clarke,ENG,DF,22,Ipswich Town,EFL,26.2,37,25,16,15,6,24,39,61.5,15,37,9,28,25,62,60,1
Harry Cornick,ENG,"FW,MF",28,Bristol City,EFL,12.2,19,11,8,6,5,10,26,38.5,16,14,2,12,3,22,16,0
Harry Darling,ENG,DF,23,Swansea City,EFL,32.9,37,19,18,18,1,22,46,47.8,24,46,30,16,36,73,101,0
Harry Leonard,ENG,FW,19,Blackburn,EFL,9.3,6,5,4,2,0,3,11,27.3,8,7,2,5,4,10,6,0
Harry Pickering,ENG,DF,24,Blackburn,EFL,33.3,76,48,42,28,6,42,63,66.7,21,43,12,31,32,108,86,1
Harry Souttar,AUS,DF,24,Leicester City,EFL,1.1,1,1,1,0,0,0,0,0.0,0,0,0,0,0,1,2,0
Harry Vaughan,IRL,"MF,FW",19,Hull City,EFL,1.6,4,3,3,1,0,2,4,50.0,2,0,0,0,0,4,1,0
Harry Winks,ENG,MF,27,Leicester City,EFL,44.9,73,46,30,34,9,46,90,51.1,44,34,13,21,37,110,22,4
Harvey Neville,IRL,"DF,MF",20,Inter Miami,MLS,2.2,6,4,4,2,0,5,11,45.5,6,4,1,3,4,10,4,0
Hasan Kuruçay,TUR,DF,25,Braunschweig,2. Bundesliga,23.7,46,26,31,15,0,23,38,60.5,15,40,15,25,59,105,115,1
Hassan Ndam,CMR,DF,24,NY Red Bulls,MLS,7.8,16,11,10,6,0,11,15,73.3,4,14,6,8,15,31,26,0
Hassani Dotson,USA,"MF,FW",25,Minnesota Utd,MLS,28.6,65,34,21,33,11,27,47,57.4,20,48,9,39,32,97,50,0
Hauke Wahl,GER,DF,29,St. Pauli,2. Bundesliga,31.9,36,22,17,19,0,15,22,68.2,7,22,10,12,30,66,81,0
Hayden Carter,ENG,DF,23,Blackburn,EFL,28.4,49,31,30,18,1,24,44,54.5,20,51,28,23,38,87,102,2
Hayden Coulson,ENG,DF,25,Middlesbrough,EFL,1.6,2,0,0,1,1,1,3,33.3,2,6,0,6,4,6,4,0
Hayden Hackney,ENG,MF,21,Middlesbrough,EFL,20.1,36,18,10,20,6,23,54,42.6,31,33,5,28,9,45,8,0
Hayden Sargis,USA,DF,20,D.C. United,MLS,0.2,0,0,0,0,0,0,0,0.0,0,0,0,0,0,0,1,0
Haydon Roberts,ENG,DF,21,Bristol City,EFL,13.9,16,9,4,11,1,11,21,52.4,10,16,2,14,12,28,30,1
Hector Hevel,NED,"MF,FW",28,Cartagena,Segunda Division,9.8,19,10,6,11,2,8,15,53.3,7,6,1,5,7,26,7,0
Hector Jiménez,USA,MF,34,Austin,MLS,0.6,0,0,0,0,0,0,1,0.0,1,0,0,0,1,1,0,0
Hendrick Zuck,GER,"DF,MF",33,Kaiserslautern,2. Bundesliga,1.8,4,2,2,1,1,1,2,50.0,1,1,0,1,3,7,5,0
Henning Matriciani,GER,DF,23,Schalke 04,2. Bundesliga,13.9,40,24,32,6,2,22,36,61.1,14,26,9,17,22,62,47,0
Henri Saivet,SEN,"MF,FW",32,Pau FC,Ligue 2,27.3,50,32,16,29,5,26,62,41.9,36,25,4,21,16,66,42,0
Henri Salomaa,FIN,"FW,MF",20,Calcio Lecco 1912,Serie B,1.2,0,0,0,0,0,0,0,0.0,0,1,0,1,1,1,0,0
Henry Kessler,USA,DF,24,NE Revolution,MLS,7.7,15,13,9,6,0,6,7,85.7,1,19,12,7,5,20,26,0
Henry Martín,MEX,FW,30,América,Liga MX,17.3,15,10,1,11,3,1,10,10.0,9,5,0,5,7,22,10,0
Henry Rorig,GER,"DF,FW",23,Osnabrück,2. Bundesliga,4.9,7,7,6,1,0,6,9,66.7,3,3,0,3,7,14,12,0
Herbert Bockhorn,GER,"DF,MF",28,Magdeburg,2. Bundesliga,25.2,52,33,27,19,6,31,55,56.4,24,39,11,28,25,77,39,1
Herbert Endeley,USA,"MF,FW",21,FC Dallas,MLS,2.4,4,4,3,0,1,3,5,60.0,2,2,0,2,1,5,3,0
Heriberto Jurado,MEX,MF,18,Necaxa,Liga MX,13.1,26,15,11,12,3,12,27,44.4,15,11,1,10,6,32,10,0
Hernani,BRA,MF,29,Parma,Serie B,24.4,57,36,16,31,10,28,67,41.8,39,37,7,30,37,94,31,1
Hianga Mananga Mbock,FRA,MF,23,Caen,Ligue 2,7.3,26,11,8,15,3,12,25,48.0,13,8,1,7,12,38,9,0
Higinio Marín,ESP,FW,30,Albacete,Segunda Division,14.9,16,9,2,12,2,3,7,42.9,4,17,5,12,2,18,16,0
Himad Abdelli,ALG,"MF,FW",23,Angers,Ligue 2,34.5,78,46,19,52,7,40,85,47.1,45,57,6,51,34,112,20,0
Hiram Mier,MEX,MF,33,Guadalajara,Liga MX,0.1,0,0,0,0,0,0,0,0.0,0,1,1,0,0,0,0,0
Hjörtur Hermannsson,ISL,DF,28,Pisa,Serie B,8.1,13,9,7,4,2,8,11,72.7,3,7,3,4,9,22,24,0
Houboulang Mendes,GNB,DF,26,CD Mirandés,Segunda Division,2.9,5,4,4,1,0,4,5,80.0,1,1,0,1,2,7,5,0
Hugo Gambor,FRA,"DF,MF",20,Dunkerque,Ligue 2,17.9,26,17,20,5,1,7,13,53.8,6,12,4,8,25,51,48,1
Hugo González Durán,MEX,GK,32,Mazatlán,Liga MX,28.3,0,0,0,0,0,0,2,0.0,2,1,0,1,0,0,10,0
Hugo Isaác Rodríguez,MEX,DF,33,Santos,Liga MX,6.3,12,9,9,3,0,9,11,81.8,2,8,6,2,7,19,24,0
Hugo Nervo,ARG,DF,32,Atlas,Liga MX,33.0,38,25,28,9,1,22,38,57.9,16,40,30,10,50,88,130,0
Hugo Novoa,ESP,"MF,FW",21,Villarreal B,Segunda Division,6.4,12,6,6,5,1,8,13,61.5,5,12,0,12,0,12,4,0
Hugo Perez,ESP,DF,21,Villarreal B,Segunda Division,1.8,3,0,3,0,0,2,3,66.7,1,2,0,2,1,4,7,0
Hugo Picard,FRA,"MF,FW",20,Guingamp,Ligue 2,22.1,35,28,17,14,4,20,53,37.7,33,29,0,29,16,51,4,0
Hugo Rama,ESP,MF,27,Oviedo,Segunda Division,0.5,0,0,0,0,0,0,1,0.0,1,1,0,1,0,0,0,0
Hugo Vallejo,ESP,"MF,FW",24,Huesca,Segunda Division,19.0,16,11,5,9,2,8,28,28.6,20,16,1,15,10,26,12,0
Hugo Vandermersch,FRA,DF,24,Elversberg,2. Bundesliga,25.3,52,35,35,13,4,37,71,52.1,34,43,7,36,27,79,78,0
Hugo Vandermersch,FRA,"DF,MF",24,Caen,Ligue 2,1.0,4,2,2,0,2,2,3,66.7,1,0,0,0,1,5,2,0
Hugo-Hilaire Mbongue Mbongue,CAN,"FW,MF",18,Toronto FC,MLS,2.9,1,0,0,1,0,0,2,0.0,2,2,0,2,0,1,3,0
Hwang Ui-jo,KOR,"FW,MF",30,Norwich City,EFL,8.6,2,1,1,1,0,1,2,50.0,1,1,0,1,1,3,3,0
Håvard Nielsen,NOR,"FW,MF",30,Hannover 96,2. Bundesliga,21.0,28,17,11,11,6,7,14,50.0,7,26,7,19,3,31,21,0
Héber,BRA,"FW,MF",31,Seattle,MLS,11.8,6,6,0,4,2,2,12,16.7,10,8,0,8,0,6,2,0
Héber Pena,ESP,"FW,MF",34,Racing Ferrol,Segunda Division,21.6,33,21,10,15,8,15,41,36.6,26,30,0,30,8,41,1,0
Héctor Herrera,MEX,MF,32,Dynamo FC,MLS,28.1,55,37,20,26,9,20,52,38.5,32,48,12,36,19,74,16,0
Héctor Holguín,MEX,GK,22,Santos,Liga MX,2.7,0,0,0,0,0,0,0,0.0,0,0,0,0,0,0,0,0
Héctor Moreno,MEX,DF,35,Monterrey,Liga MX,18.3,8,5,6,1,1,6,11,54.5,5,16,10,6,16,24,44,0
Héctor Uribe,MEX,"MF,DF",19,León,Liga MX,1.6,1,0,0,1,0,1,2,50.0,1,0,0,0,0,1,0,0
Hólmbert Friðjónsson,ISL,"FW,MF",30,Holstein Kiel,2. Bundesliga,4.0,2,1,0,1,1,1,1,100.0,0,1,0,1,2,4,9,0
Iago López,ESP,DF,25,Alcorcón,Segunda Division,29.6,82,52,59,18,5,32,55,58.2,23,37,11,26,46,128,76,1
Ian Carlo Poveda,ENG,"MF,FW",23,Sheffield Weds,EFL,6.3,10,3,3,5,2,2,8,25.0,6,4,0,4,2,12,1,0
Ian Carlo Poveda,ENG,"MF,FW",23,Leeds United,EFL,1.7,4,2,2,2,0,0,1,0.0,1,2,0,2,1,5,0,0
Ian Forns,ESP,DF,20,Espanyol,Segunda Division,1.3,5,4,4,0,1,3,4,75.0,1,1,0,1,1,6,3,1
Ian Fray,USA,"DF,MF",20,Inter Miami,MLS,7.3,18,9,10,7,1,12,19,63.2,7,11,4,7,9,27,16,1
Ian Harkes,USA,MF,27,NE Revolution,MLS,6.7,12,2,8,4,0,4,10,40.0,6,5,0,5,9,21,4,0
Ian Mackay,ESP,GK,37,Eldense,Segunda Division,7.0,0,0,0,0,0,0,0,0.0,0,0,0,0,1,1,1,0
Ian Murphy,USA,DF,23,FC Cincinnati,MLS,16.9,34,20,21,11,2,12,23,52.2,11,20,8,12,10,44,42,0
Ibrahim Kasule,UGA,MF,18,NY Red Bulls,MLS,0.3,0,0,0,0,0,0,1,0.0,1,2,1,1,0,0,1,0
Ibrahim Maza,GER,MF,17,Hertha BSC,2. Bundesliga,6.6,13,8,8,2,3,2,3,66.7,1,3,0,3,6,19,11,0
Ibrahim Sissoko,MLI,FW,27,Saint-Étienne,Ligue 2,23.8,19,12,4,10,5,8,15,53.3,7,16,2,14,7,26,24,0
Ibrahim Traoré,FRA,FW,17,Troyes,Ligue 2,0.7,0,0,0,0,0,0,1,0.0,1,0,0,0,1,1,0,0
Ibrahima Ba,SEN,DF,18,Valenciennes,Ligue 2,0.2,0,0,0,0,0,0,0,0.0,0,0,0,0,1,1,0,0
Ibrahima Cissé,MLI,DF,22,Schalke 04,2. Bundesliga,2.6,3,2,2,1,0,0,3,0.0,3,6,4,2,4,7,15,0
Ibrahima Kebe,MLI,MF,23,CD Mirandés,Segunda Division,1.3,4,4,4,0,0,1,2,50.0,1,1,1,0,1,5,1,0
Ibrahima Niane,SEN,"FW,MF",24,Angers,Ligue 2,9.4,5,2,1,3,1,3,5,60.0,2,5,1,4,1,6,3,0
Ibrahima Sory Diallo,SEN,"FW,MF",20,Valenciennes,Ligue 2,0.4,0,0,0,0,0,0,1,0.0,1,1,1,0,0,0,2,0
Ibrahima Sy,SEN,MF,20,Dunkerque,Ligue 2,1.8,6,4,2,2,2,2,2,100.0,0,3,0,3,3,9,0,0
Ibrahima Wadji,SEN,FW,28,Saint-Étienne,Ligue 2,5.4,3,2,0,2,1,0,0,0.0,0,1,0,1,0,3,0,0
Idekel Domínguez,MEX,DF,23,Atlas,Liga MX,7.5,16,9,5,9,2,8,18,44.4,10,12,1,11,12,28,14,0
Idrissa Touré,GER,"MF,FW",25,Pisa,Serie B,8.3,19,10,7,8,4,10,17,58.8,7,12,3,9,9,28,19,0
Idriz Voca,KVX,MF,26,Cosenza,Serie B,17.4,23,16,12,8,3,10,27,37.0,17,11,3,8,12,35,28,0
Ignace Van Der Brempt,BEL,DF,21,Hamburger SV,2. Bundesliga,19.7,63,35,42,14,7,34,46,73.9,12,29,8,21,19,82,57,2
Ignacio Jeraldino,CHI,MF,28,Sporting Gijón,Segunda Division,0.4,1,0,0,1,0,0,1,0.0,1,1,0,1,0,1,1,0
Ignacio Rivero,URU,"DF,MF",31,Cruz Azul,Liga MX,27.3,52,27,29,22,1,38,94,40.4,56,42,10,32,17,69,53,0
Ignasi Vilarrasa,ESP,DF,24,Huesca,Segunda Division,29.8,54,35,44,8,2,34,52,65.4,18,14,7,7,12,66,95,0
Igor Lichnovsky,CHI,DF,29,América,Liga MX,19.6,21,15,15,5,1,12,16,75.0,4,22,12,10,35,56,79,2
Igor Matanovic,CRO,FW,20,Karlsruher,2. Bundesliga,25.8,14,8,5,4,5,5,17,29.4,12,18,4,14,5,19,28,0
Ike Ugbo,CAN,"FW,MF",24,Sheffield Weds,EFL,14.4,16,12,7,5,4,8,12,66.7,4,9,0,9,4,20,10,0
Ike Ugbo,CAN,FW,24,Cardiff City,EFL,10.4,7,1,1,5,1,3,3,100.0,0,11,1,10,0,7,11,0
Iker Alday,ESP,"FW,DF",21,Eibar,Segunda Division,0.2,1,0,1,0,0,1,1,100.0,0,1,0,1,0,1,0,0
Iker Benito,ESP,"FW,DF",21,FC Andorra,Segunda Division,25.6,36,16,20,14,2,17,27,63.0,10,30,2,28,19,55,29,0
Iker Bilbao,ESP,"MF,FW",28,Alcorcón,Segunda Division,1.2,2,1,1,1,0,1,1,100.0,0,4,3,1,1,3,1,0
Iker Kortajarena,ESP,MF,23,Huesca,Segunda Division,15.2,10,5,7,2,1,6,11,54.5,5,12,4,8,6,16,19,0
Iker Losada,ESP,"MF,FW",22,Racing Ferrol,Segunda Division,37.4,21,10,2,13,6,9,34,26.5,25,26,3,23,16,37,19,1
Iker Moreno,MEX,DF,19,Atlético,Liga MX,5.2,15,11,8,6,1,8,17,47.1,9,9,0,9,11,26,17,0
Iker Seguín,ESP,"DF,MF",34,Amorebieta,Segunda Division,6.5,12,8,10,2,0,9,11,81.8,2,8,2,6,6,18,15,0
Iker Undabarrena,ESP,MF,29,Leganés,Segunda Division,24.7,44,20,18,25,1,19,47,40.4,28,32,8,24,36,80,36,0
Iker Unzueta,ESP,FW,25,Amorebieta,Segunda Division,11.1,3,0,1,1,1,0,4,0.0,4,7,1,6,2,5,9,0
Iker Álvarez,AND,GK,22,Villarreal B,Segunda Division,32.0,1,0,1,0,0,1,1,100.0,0,1,0,1,0,1,10,2
Ilan Kebbal,ALG,"MF,FW",25,Paris FC,Ligue 2,34.4,50,24,16,27,7,22,70,31.4,48,25,0,25,15,65,5,1
Ilia Gruev,BUL,MF,23,Leeds United,EFL,19.7,47,24,18,23,6,12,31,38.7,19,16,4,12,27,74,14,0
Ilias Akhomach,MAR,MF,20,Villarreal B,Segunda Division,1.7,2,1,1,1,0,2,4,50.0,2,0,0,0,1,3,0,0
Ilias Chair,MAR,"FW,MF",25,QPR,EFL,41.5,44,27,23,14,7,18,50,36.0,32,42,1,41,20,64,7,1
Ilias Iliadis,GRE,"DF,MF",21,CF Montréal,MLS,2.8,5,3,2,2,1,3,4,75.0,1,0,0,0,5,10,4,0
Ilias Koutsoupias,GRE,MF,22,Bari,Serie B,10.7,28,15,13,12,3,10,14,71.4,4,10,1,9,9,37,9,0
Ilie Sánchez,ESP,MF,32,LAFC,MLS,28.8,60,34,24,23,13,30,75,40.0,45,31,8,23,36,96,33,0
Ilija Nestorovski,MKD,"FW,MF",33,Ascoli,Serie B,11.6,6,3,2,4,0,2,7,28.6,5,5,2,3,1,7,15,0
Ilijah Paul,USA,"FW,MF",20,RSL,MLS,1.2,1,1,0,0,1,0,2,0.0,2,0,0,0,0,1,1,0
Illan Meslier,FRA,GK,23,Leeds United,EFL,43.6,1,1,1,0,0,1,2,50.0,1,0,0,0,0,1,28,2
Illian Hernandez,MEX,FW,23,América,Liga MX,3.4,0,0,0,0,0,0,1,0.0,1,1,0,1,1,1,6,0
Illian Hernandez,MEX,FW,23,Pachuca,Liga MX,4.5,3,2,0,2,1,1,5,20.0,4,5,0,5,0,3,11,0
Ilyas Ansah,GER,"FW,MF",18,Paderborn 07,2. Bundesliga,13.5,11,8,1,6,4,4,14,28.6,10,13,3,10,2,13,14,0
Ilyas Chaira,MAR,"FW,MF",23,CD Mirandés,Segunda Division,31.9,62,47,27,24,11,33,66,50.0,33,64,5,59,17,79,58,0
Ilyes Hamache,FRA,"FW,MF",20,Valenciennes,Ligue 2,16.1,23,11,11,9,3,7,19,36.8,12,23,1,22,18,41,11,0
Immanuel Pherai,SUR,"MF,FW",22,Hamburger SV,2. Bundesliga,21.4,22,17,8,11,3,6,25,24.0,19,17,3,14,10,32,11,0
Imran Louza,MAR,MF,24,Watford,EFL,10.2,14,11,1,9,4,7,25,28.0,18,12,1,11,5,19,4,0
Indiana Vassilev,USA,MF,21,St. Louis,MLS,23.5,46,27,21,22,3,27,65,41.5,38,29,4,25,10,56,8,1
Ionuț Nedelcearu,ROU,DF,27,Palermo,Serie B,18.4,16,13,12,4,0,8,10,80.0,2,14,11,3,12,28,68,0
Irvin Cardona,FRA,"MF,FW",25,Saint-Étienne,Ligue 2,15.2,19,14,8,6,5,9,22,40.9,13,15,3,12,7,26,9,0
Irvyn Lomami,FRA,"DF,MF",19,Stade Laval,Ligue 2,1.2,1,1,1,0,0,0,0,0.0,0,2,1,1,1,2,0,0
Isaac Hayden,ENG,MF,28,QPR,EFL,11.0,26,17,15,8,3,10,18,55.6,8,19,13,6,25,51,20,0
Isaac Matondo,FRA,"MF,FW",24,US Concarneau,Ligue 2,15.8,13,8,6,5,2,7,22,31.8,15,14,0,14,12,25,8,0
Isaiah Jones,ENG,FW,24,Middlesbrough,EFL,28.7,64,38,31,19,14,24,57,42.1,33,25,2,23,17,81,20,2
Isaiah Parente,USA,"MF,FW",22,Crew,MLS,0.5,2,2,0,2,0,0,5,0.0,5,1,0,1,1,3,1,0
Isak Jansson,SWE,"MF,FW",22,Cartagena,Segunda Division,10.8,11,5,2,6,3,4,14,28.6,10,12,2,10,5,16,11,0
Isak Jensen,DEN,"MF,FW",19,St. Louis,MLS,1.6,4,3,1,2,1,3,9,33.3,6,5,0,5,1,5,2,0
Isaác Brizuela,MEX,FW,32,Guadalajara,Liga MX,11.7,11,6,4,4,3,4,11,36.4,7,7,1,6,7,18,5,0
Isaías Violante,MEX,"FW,MF",19,Toluca,Liga MX,1.5,2,2,1,0,1,0,2,0.0,2,2,1,1,1,3,2,0
Isidro Suárez,MEX,FW,20,Monterrey,Liga MX,0.2,1,1,0,1,0,0,1,0.0,1,0,0,0,0,1,0,0
Ismael Bouneb,FRA,MF,17,Valenciennes,Ligue 2,0.3,1,0,0,1,0,0,0,0.0,0,0,0,0,0,1,0,0
Ismael Govea,MEX,DF,26,Santos,Liga MX,19.1,39,26,25,12,2,21,33,63.6,12,24,11,13,13,52,69,0
Ismael Tajouri-Shradi,LBY,FW,28,Minnesota Utd,MLS,3.9,5,3,3,1,1,1,7,14.3,6,3,0,3,0,5,2,0
Ismail Achik,ITA,"FW,MF",23,Bari,Serie B,9.1,6,5,2,3,1,2,10,20.0,8,9,1,8,2,8,4,0
Ismaël Koné,CAN,MF,21,Watford,EFL,28.4,40,27,19,18,3,12,26,46.2,14,32,5,27,16,56,17,0
Ismaëlben Boura,COM,DF,22,Troyes,Ligue 2,25.2,63,43,41,19,3,30,51,58.8,21,18,6,12,40,103,69,2
Israel Boatwright,DOM,"MF,DF",17,Inter Miami,MLS,0.8,1,0,1,0,0,1,3,33.3,2,1,1,0,0,1,4,0
Israel García,ESP,MF,20,Alcorcón,Segunda Division,0.1,0,0,0,0,0,0,0,0.0,0,0,0,0,0,0,0,0
Israel Larios,MEX,"FW,MF",20,Atlas,Liga MX,1.6,3,2,0,3,0,2,5,40.0,3,2,0,2,0,3,2,0
Israel Luna,MEX,MF,21,Pachuca,Liga MX,2.8,6,3,3,3,0,1,4,25.0,3,1,0,1,5,11,3,0
Israel Reyes,MEX,DF,23,América,Liga MX,15.3,23,18,13,7,3,11,16,68.8,5,12,8,4,29,52,36,0
Issa Soumaré,SEN,"FW,MF",22,Auxerre,Ligue 2,5.4,5,4,2,2,1,2,8,25.0,6,11,1,10,3,8,4,0
Issiar Dramé,MLI,DF,24,Bastia,Ligue 2,19.5,26,16,14,9,3,10,13,76.9,3,28,22,6,28,54,62,1
Issouf Macalou,CIV,"FW,MF",24,Valenciennes,Ligue 2,0.2,0,0,0,0,0,0,1,0.0,1,1,0,1,0,0,0,0
Issouf Paro,BFA,DF,28,US Concarneau,Ligue 2,11.2,16,9,9,6,1,11,15,73.3,4,15,8,7,18,34,48,4
Issouf Sissokho,MLI,MF,21,Bordeaux,Ligue 2,13.7,27,19,11,12,4,12,24,50.0,12,16,3,13,18,45,3,1
Iulius Marginean,ROU,"MF,FW",22,Ternana,Serie B,2.6,9,5,4,4,1,8,14,57.1,6,2,1,1,2,11,9,0
Iva Gelashvili,GEO,DF,22,Spezia,Serie B,4.5,7,5,5,2,0,4,7,57.1,3,7,6,1,7,14,15,0
Ivan Durdov,CRO,FW,23,CD Mirandés,Segunda Division,4.3,1,1,0,1,0,0,1,0.0,1,3,0,3,1,2,4,0
Ivan Filipović,CRO,GK,28,Paris FC,Ligue 2,8.5,0,0,0,0,0,0,0,0.0,0,0,0,0,0,0,4,1
Ivan Marconi,ITA,DF,33,Palermo,Serie B,7.5,13,9,6,7,0,4,12,33.3,8,10,6,4,10,23,37,0
Ivan Monzón,ESP,FW,21,Zaragoza,Segunda Division,27.3,22,13,3,9,10,7,15,46.7,8,12,1,11,2,24,21,0
Ivan Prtajin,CRO,FW,27,Wehen,2. Bundesliga,26.9,8,3,3,4,1,1,9,11.1,8,9,2,7,7,15,44,0
Ivan Šunjić,CRO,MF,26,Birmingham City,EFL,29.2,64,37,33,27,4,30,70,42.9,40,46,11,35,53,117,45,0
Ivane Chegra,FRA,"MF,FW",19,Ajaccio,Ligue 2,1.9,6,2,2,3,1,1,6,16.7,5,3,0,3,1,7,1,0
Ivo Vázquez,MEX,DF,22,Puebla,Liga MX,1.6,4,3,2,1,1,4,6,66.7,2,0,0,0,1,5,4,1
Iván Angulo,COL,"FW,DF",23,Orlando City,MLS,27.6,32,17,17,10,5,14,36,38.9,22,32,3,29,17,49,19,0
Iván Ayllón,ESP,"FW,MF",23,Cartagena,Segunda Division,5.7,10,4,2,4,4,4,6,66.7,2,7,0,7,5,15,5,0
Iván Calero,ESP,DF,29,Cartagena,Segunda Division,36.0,63,42,43,16,4,47,90,52.2,43,32,14,18,29,92,110,0
Iván Cédric,ESP,FW,22,Valladolid,Segunda Division,4.8,1,0,1,0,0,0,1,0.0,1,0,0,0,1,2,3,0
Iván Franco,PAR,"FW,MF",22,Dynamo FC,MLS,11.8,20,11,9,6,5,7,31,22.6,24,17,1,16,5,25,7,0
Iván Gil,ESP,"MF,FW",24,FC Andorra,Segunda Division,33.0,22,13,6,9,7,9,36,25.0,27,28,2,26,10,32,10,0
Iván Martos,ESP,DF,27,Huesca,Segunda Division,17.2,33,17,21,10,2,20,32,62.5,12,15,4,11,30,63,69,0
Iván Morante,ESP,MF,23,Racing Sant,Segunda Division,20.5,31,17,15,15,1,17,46,37.0,29,25,8,17,21,52,31,0
Iván Moreno,MEX,"DF,MF",25,León,Liga MX,17.5,33,20,20,12,1,18,41,43.9,23,16,4,12,14,47,27,1
Iván Muñoz,ESP,DF,19,Valladolid,Segunda Division,0.1,0,0,0,0,0,0,0,0.0,0,0,0,0,0,0,0,0
Iván Márquez,ESP,DF,29,Nürnberg,2. Bundesliga,14.4,17,8,13,3,1,11,16,68.8,5,20,13,7,18,35,81,2
Iván Romero,ESP,"FW,MF",23,Levante,Segunda Division,9.6,14,9,3,9,2,5,12,41.7,7,9,1,8,8,22,8,0
Iván Sánchez,ESP,"MF,FW",31,Valladolid,Segunda Division,26.8,51,29,17,28,6,16,45,35.6,29,34,4,30,12,63,7,0
Iván Tona,MEX,MF,23,Tijuana,Liga MX,5.4,12,6,5,7,0,6,13,46.2,7,6,1,5,5,17,7,0
Iyad Mohamed,COM,MF,22,Pau FC,Ligue 2,6.7,19,14,7,11,1,8,14,57.1,6,11,4,7,10,29,15,0
Iñigo García,ESP,MF,20,Alcorcón,Segunda Division,0.2,3,3,1,1,1,3,3,100.0,0,0,0,0,0,3,1,0
Iñigo Vicente,ESP,"FW,MF",26,Racing Sant,Segunda Division,38.6,73,48,26,31,16,35,110,31.8,75,53,3,50,40,113,7,2
J.T. Marcinkowski,USA,GK,25,SJ Earthquakes,MLS,12.4,0,0,0,0,0,0,0,0.0,0,0,0,0,0,0,6,0
Jacen Russell-Rowe,CAN,"FW,MF",20,Crew,MLS,6.0,7,4,1,3,3,3,9,33.3,6,6,0,6,2,9,2,0
Jack Bonham,IRL,GK,29,Stoke City,EFL,14.0,0,0,0,0,0,0,1,0.0,1,0,0,0,0,0,5,0
Jack Clarke,ENG,"MF,FW",22,Sunderland,EFL,38.8,60,45,26,24,10,24,62,38.7,38,31,1,30,20,80,11,1
Jack Colback,ENG,MF,33,QPR,EFL,22.1,36,21,23,10,3,15,38,39.5,23,29,14,15,37,73,10,0
Jack Elliott,ENG,DF,27,Philadelphia,MLS,31.0,41,23,27,13,1,21,40,52.5,19,40,20,20,46,87,125,0
Jack Grieves,ENG,"DF,FW",18,Watford,EFL,0.6,1,1,0,1,0,1,1,100.0,0,0,0,0,0,1,1,0
Jack Lahne,SWE,"MF,FW",21,Amiens,Ligue 2,3.2,6,4,1,3,2,3,6,50.0,3,1,0,1,5,11,1,0
Jack Lynn,USA,"MF,FW",23,Orlando City,MLS,0.4,0,0,0,0,0,0,0,0.0,0,0,0,0,1,1,2,0
Jack Maher,USA,DF,23,Nashville,MLS,32.0,37,22,26,10,1,20,28,71.4,8,25,17,8,23,60,128,0
Jack McGlynn,USA,MF,19,Philadelphia,MLS,18.0,28,13,17,9,2,20,44,45.5,24,11,1,10,13,41,14,0
Jack Panayotou,USA,"MF,DF",18,NE Revolution,MLS,3.6,9,6,4,3,2,4,9,44.4,5,3,0,3,2,11,2,0
Jack Price,ENG,MF,30,Rapids,MLS,0.4,2,1,1,0,1,1,1,100.0,0,0,0,0,1,3,0,0
Jack Rudoni,ENG,"MF,FW",23,Huddersfield,EFL,34.0,63,41,27,27,9,28,57,49.1,29,48,7,41,29,92,31,0
Jack Simpson,ENG,DF,26,Cardiff City,EFL,0.2,0,0,0,0,0,0,0,0.0,0,0,0,0,0,0,1,1
Jack Skahan,USA,"FW,MF",24,SJ Earthquakes,MLS,4.0,3,3,2,1,0,1,5,20.0,4,4,0,4,3,6,2,0
Jack Stacey,ENG,DF,27,Norwich City,EFL,42.8,99,75,53,36,10,46,80,57.5,34,47,21,26,54,153,115,2
Jack Stephens,ENG,DF,29,Southampton,EFL,16.6,24,14,11,10,3,15,22,68.2,7,31,15,16,19,43,30,2
Jack Taylor,IRL,MF,25,Ipswich Town,EFL,9.8,25,14,7,13,5,12,27,44.4,15,13,2,11,19,44,9,1
Jack Whatmough,ENG,"DF,MF",26,Preston,EFL,14.0,19,10,10,9,0,8,19,42.1,11,26,11,15,15,34,70,0
Jackson Conway,USA,FW,21,Atlanta Utd,MLS,0.6,0,0,0,0,0,0,0,0.0,0,0,0,0,0,0,0,0
Jackson Hopkins,USA,MF,18,D.C. United,MLS,2.2,2,1,1,0,1,1,3,33.3,2,0,0,0,2,4,2,0
Jackson Irvine,AUS,MF,30,St. Pauli,2. Bundesliga,26.2,34,23,6,20,8,14,35,40.0,21,27,9,18,18,52,58,1
Jackson Ragen,USA,DF,24,Seattle,MLS,31.6,32,22,29,3,0,21,35,60.0,14,53,31,22,31,63,142,0
Jackson Yueill,USA,MF,25,SJ Earthquakes,MLS,30.2,40,23,13,18,9,18,46,39.1,28,21,4,17,32,72,29,0
Jacob Brown,SCO,FW,25,Stoke City,EFL,1.0,3,2,2,0,1,1,2,50.0,1,2,0,2,0,3,0,0
Jacob Chapman,AUS,GK,22,Huddersfield,EFL,1.5,0,0,0,0,0,0,0,0.0,0,0,0,0,0,0,2,0
Jacob Greaves,ENG,DF,22,Hull City,EFL,43.0,76,53,40,33,3,37,59,62.7,22,55,36,19,44,120,198,1
Jacob Greene,USA,DF,19,D.C. United,MLS,5.4,13,7,11,1,1,11,17,64.7,6,8,4,4,2,15,18,0
Jacob Jackson,USA,GK,22,NE Revolution,MLS,2.0,0,0,0,0,0,0,0,0.0,0,0,0,0,0,0,0,0
Jacob Shaffelburg,CAN,"FW,MF",23,Nashville,MLS,14.6,9,5,2,3,4,5,22,22.7,17,21,0,21,16,25,6,0
Jacobo,ESP,"MF,FW",27,Alcorcón,Segunda Division,29.2,57,38,23,18,16,25,81,30.9,56,41,5,36,18,75,48,0
Jacopo Da Riva,ITA,MF,22,Reggiana,Serie B,0.8,3,2,0,1,2,2,4,50.0,2,4,0,4,3,6,2,0
Jacopo Manconi,ITA,"FW,MF",29,Modena,Serie B,18.4,17,8,3,10,4,3,15,20.0,12,15,2,13,2,19,18,0
Jacopo Petriccione,ITA,MF,28,Catanzaro,Serie B,11.8,16,8,9,6,1,10,14,71.4,4,12,5,7,11,27,15,0
Jacopo Segre,ITA,MF,26,Palermo,Serie B,27.6,71,40,31,37,3,26,39,66.7,13,25,4,21,18,89,44,0
Jacopo Tarantino,ITA,"FW,MF",18,Ascoli,Serie B,1.2,0,0,0,0,0,0,2,0.0,2,2,0,2,0,0,0,0
Jacques Ekomie,GAB,DF,19,Bordeaux,Ligue 2,14.9,45,27,27,12,6,18,30,60.0,12,14,4,10,22,67,30,1
Jacques Siwe,FRA,"MF,FW",22,Guingamp,Ligue 2,5.3,7,5,1,2,4,4,7,57.1,3,1,0,1,3,10,5,0
Jaden Philogene Bidace,ENG,"FW,MF",21,Hull City,EFL,31.2,78,48,31,30,17,32,79,40.5,47,43,2,41,21,99,24,0
Jaden Warner,ENG,DF,20,Norwich City,EFL,1.7,1,0,1,0,0,0,2,0.0,2,2,1,1,2,3,7,0
Jahaziel Marchand,MEX,MF,21,Pachuca,Liga MX,2.2,5,5,1,3,1,3,5,60.0,2,6,1,5,3,8,2,0
Jahce Novello,AUS,FW,19,Cosenza,Serie B,0.1,0,0,0,0,0,0,0,0.0,0,1,0,1,0,0,1,0
Jaheim Headley,ENG,"DF,MF",21,Huddersfield,EFL,18.3,56,31,29,25,2,29,45,64.4,16,19,1,18,15,71,43,0
Jahkeele Marshall-Rutty,CAN,"MF,DF",18,Toronto FC,MLS,12.8,29,15,19,9,1,12,24,50.0,12,13,1,12,6,35,12,0
Jaidon Anthony,ENG,"FW,MF",23,Leeds United,EFL,5.6,14,5,6,6,2,8,18,44.4,10,10,0,10,2,16,4,0
Jaime Alvarez,MEX,MF,20,Tijuana,Liga MX,0.0,0,0,0,0,0,0,1,0.0,1,0,0,0,0,0,0,0
Jaime Garrido,ESP,MF,21,Alcorcón,Segunda Division,0.4,1,1,0,0,1,0,0,0.0,0,1,0,1,1,2,0,0
Jaime Gómez Valencia,MEX,"DF,MF",30,Querétaro,Liga MX,17.6,51,26,31,14,6,26,44,59.1,18,17,5,12,13,64,24,0
Jaime Seoane,ESP,"MF,FW",27,Oviedo,Segunda Division,27.4,52,29,21,21,10,23,57,40.4,34,19,4,15,14,66,18,1
Jaime Suárez Juesas,ESP,MF,27,Oviedo,Segunda Division,15.8,32,17,17,12,3,14,29,48.3,15,22,12,10,28,60,27,0
Jaime Vázquez,ESP,DF,18,Oviedo,Segunda Division,1.0,0,0,0,0,0,0,0,0.0,0,4,4,0,1,1,1,1
Jaine Barreiro,COL,DF,29,León,Liga MX,20.5,33,23,27,6,0,22,30,73.3,8,21,12,9,35,68,82,0
Jair Amador,EQG,DF,34,Zaragoza,Segunda Division,31.7,36,19,25,10,1,14,15,93.3,1,32,19,13,44,80,169,3
Jair Cortés,MEX,"DF,MF",22,Necaxa,Liga MX,10.1,37,26,19,15,3,26,42,61.9,16,13,1,12,12,49,33,0
Jair Díaz,MEX,DF,24,Mazatlán,Liga MX,19.7,52,34,32,15,5,32,58,55.2,26,11,5,6,16,68,36,0
Jair González,MEX,FW,21,Santos,Liga MX,5.2,8,5,3,4,1,2,5,40.0,3,3,1,2,4,12,4,0
Jairo Izquierdo,ESP,"DF,FW",30,Cartagena,Segunda Division,29.5,38,22,18,11,9,15,38,39.5,23,17,2,15,15,53,31,0
Jairo Torres,MEX,FW,23,FC Juárez,Liga MX,3.3,1,1,1,0,0,0,2,0.0,2,2,0,2,1,2,1,0
Jairo Torres,MEX,"MF,FW",22,Fire,MLS,8.5,7,4,4,1,2,3,15,20.0,12,5,0,5,6,13,10,1
Jak Alnwick,ENG,GK,30,Cardiff City,EFL,24.0,0,0,0,0,0,0,3,0.0,3,2,0,2,0,0,12,1
Jake Bidwell,ENG,DF,30,Coventry City,EFL,22.8,32,21,17,9,6,20,28,71.4,8,27,12,15,31,63,60,0
Jake Clarke-Salter,ENG,DF,25,QPR,EFL,29.6,65,41,45,18,2,30,42,71.4,12,30,15,15,32,97,135,1
Jake Cooper,ENG,DF,28,Millwall,EFL,44.0,34,18,21,11,2,13,30,43.3,17,54,38,16,58,92,197,1
Jake Davis,USA,DF,21,Sporting KC,MLS,22.6,67,40,32,29,6,35,79,44.3,44,27,8,19,34,101,53,0
Jake Garrett,ENG,MF,20,Blackburn,EFL,8.7,19,10,4,10,5,9,13,69.2,4,9,4,5,7,26,3,1
Jake Livermore,ENG,MF,33,Watford,EFL,23.0,45,23,21,22,2,31,41,75.6,10,41,19,22,25,70,28,0
Jake Nerwinski,USA,DF,28,St. Louis,MLS,24.6,40,22,24,12,4,20,56,35.7,36,29,4,25,38,78,64,2
Jakob Glesnes,NOR,DF,28,Philadelphia,MLS,31.0,48,27,28,15,5,23,48,47.9,25,44,26,18,46,94,90,1
Jakob Sørensen,DEN,"DF,MF",25,Norwich City,EFL,5.5,5,4,3,1,1,3,5,60.0,2,0,0,0,4,9,17,0
Jakov Medić,CRO,DF,24,St. Pauli,2. Bundesliga,1.0,1,1,0,1,0,1,2,50.0,1,1,1,0,0,1,4,0
Jakub Stolarczyk,POL,GK,22,Leicester City,EFL,2.0,0,0,0,0,0,0,0,0.0,0,0,0,0,0,0,0,1
Jakub Łabojko,POL,MF,25,Ternana,Serie B,14.6,25,16,13,9,3,9,26,34.6,17,19,9,10,22,47,27,0
Jalen Neal,USA,DF,19,LA Galaxy,MLS,14.3,13,10,10,3,0,7,13,53.8,6,21,12,9,22,35,58,0
Jamal Lewis,NIR,"DF,MF",25,Watford,EFL,30.8,72,46,41,24,7,43,71,60.6,28,35,8,27,19,91,59,1
Jamal Lowe,JAM,"FW,MF",29,Swansea City,EFL,25.0,26,17,4,14,8,11,30,36.7,19,25,7,18,15,41,38,0
Jamal Thiaré,SEN,FW,29,Atlanta Utd,MLS,0.6,0,0,0,0,0,0,0,0.0,0,1,0,1,1,1,1,0
James Beadle,ENG,GK,19,Sheffield Weds,EFL,19.0,0,0,0,0,0,0,2,0.0,2,0,0,0,0,0,9,1
James Bree,ENG,DF,25,Southampton,EFL,12.0,19,11,10,7,2,13,19,68.4,6,8,2,6,7,26,24,0
James Hill,ENG,DF,21,Blackburn,EFL,14.4,33,21,19,12,2,17,23,73.9,6,17,8,9,29,62,63,0
James Justin,ENG,DF,25,Leicester City,EFL,29.1,71,42,28,37,6,32,52,61.5,20,34,15,19,44,115,84,0
James Lawrence,WAL,DF,30,Nürnberg,2. Bundesliga,1.0,0,0,0,0,0,0,2,0.0,2,2,1,1,2,2,1,0
James Morris,ENG,DF,21,Watford,EFL,8.6,19,11,10,9,0,14,21,66.7,7,11,4,7,15,34,31,0
James Pantemis,CAN,GK,25,CF Montréal,MLS,1.9,0,0,0,0,0,0,0,0.0,0,0,0,0,0,0,2,0
James Sands,USA,"MF,DF",22,NYCFC,MLS,24.1,59,36,28,28,3,25,48,52.1,23,38,10,28,26,85,29,0
James Ward-Prowse,ENG,MF,28,Southampton,EFL,1.0,1,0,0,1,0,0,0,0.0,0,1,1,0,1,2,2,0
James Wilson,ENG,DF,17,Middlesbrough,EFL,0.0,0,0,0,0,0,0,0,0.0,0,0,0,0,0,0,0,0
Jamie Allen,ENG,MF,28,Coventry City,EFL,12.9,15,7,9,4,2,6,22,27.3,16,6,1,5,14,29,7,1
Jamie Knight-Lebel,CAN,DF,18,Bristol City,EFL,0.3,2,1,0,2,0,1,1,100.0,0,0,0,0,0,2,1,0
Jamie Lawrence,GER,DF,20,Magdeburg,2. Bundesliga,5.3,8,7,8,0,0,4,7,57.1,3,11,8,3,9,17,19,2
Jamie Lindsay,SCO,MF,27,Rotherham Utd,EFL,12.0,15,9,7,6,2,9,19,47.4,10,17,4,13,10,25,14,0
Jamie McCart,SCO,DF,26,Rotherham Utd,EFL,0.1,2,2,2,0,0,1,1,100.0,0,1,1,0,0,2,5,0
Jamie Paterson,ENG,"MF,FW",31,Swansea City,EFL,35.8,61,40,11,31,19,33,66,50.0,33,45,5,40,24,85,23,0
Jamie Shackleton,ENG,"DF,FW",23,Leeds United,EFL,7.5,16,11,6,6,4,8,13,61.5,5,7,1,6,4,20,12,1
Jamie Vardy,ENG,FW,36,Leicester City,EFL,19.6,7,3,0,3,4,2,8,25.0,6,10,1,9,2,9,13,1
Jamil Siebert,GER,DF,21,Düsseldorf,2. Bundesliga,19.8,44,23,26,15,3,23,45,51.1,22,37,15,22,18,62,78,1
Jamilu Collins,NGA,DF,28,Cardiff City,EFL,33.2,104,76,64,32,8,71,100,71.0,29,43,9,34,64,168,99,0
Jamiro Monteiro,CPV,MF,29,SJ Earthquakes,MLS,23.6,37,24,15,18,4,10,48,20.8,38,23,2,21,15,52,4,0
Jan Bednarek,POL,DF,27,Southampton,EFL,39.4,34,18,19,14,1,16,29,55.2,13,46,34,12,61,95,145,0
Jan Carmona,MEX,"FW,DF",19,FC Juárez,Liga MX,0.5,0,0,0,0,0,0,0,0.0,0,1,0,1,1,1,0,0
Jan Elvedi,SUI,DF,26,Kaiserslautern,2. Bundesliga,33.0,51,36,37,10,4,24,39,61.5,15,45,24,21,37,88,140,0
Jan Gyamerah,GER,DF,28,Nürnberg,2. Bundesliga,24.5,61,33,32,25,4,29,42,69.0,13,48,12,36,29,90,73,2
Jan Luca Schuler,GER,FW,24,Magdeburg,2. Bundesliga,19.7,3,3,1,1,1,1,5,20.0,4,20,2,18,5,8,42,0
Jan Mlakar,SVN,"FW,MF",24,Pisa,Serie B,16.0,18,8,6,8,4,8,18,44.4,10,8,2,6,2,20,12,0
Jan Reichert,GER,GK,22,Nürnberg,2. Bundesliga,1.0,0,0,0,0,0,0,0,0.0,0,0,0,0,0,0,1,0
Jan Sobociński,POL,DF,23,Charlotte,MLS,7.2,15,11,8,7,0,7,15,46.7,8,8,5,3,7,22,26,1
Jan Zuberek,POL,FW,19,Ternana,Serie B,0.3,0,0,0,0,0,0,0,0.0,0,2,1,1,0,0,0,0
Jan-Hendrik Marx,GER,"DF,FW",28,Braunschweig,2. Bundesliga,3.9,2,1,2,0,0,2,13,15.4,11,2,0,2,3,5,5,0
Jandro Orellana,ESP,MF,23,FC Andorra,Segunda Division,26.7,71,43,27,36,8,31,47,66.0,16,25,10,15,15,86,37,1
Janik Bachmann,GER,"MF,DF",27,Hansa Rostock,2. Bundesliga,15.2,26,11,15,11,0,11,21,52.4,10,17,8,9,17,43,32,0
Janis Antiste,FRA,"MF,FW",20,Reggiana,Serie B,18.7,14,10,5,7,2,2,16,12.5,14,19,2,17,14,28,28,0
Jann-Fiete Arp,GER,"FW,MF",23,Holstein Kiel,2. Bundesliga,8.6,12,9,8,3,1,4,17,23.5,13,10,0,10,5,17,7,0
Jannes Horn,GER,DF,26,Nürnberg,2. Bundesliga,24.2,20,14,12,6,2,12,19,63.2,7,35,16,19,18,38,97,1
Jannes Wulff,GER,"FW,MF",23,Osnabrück,2. Bundesliga,11.4,22,12,8,11,3,13,27,48.1,14,15,1,14,10,32,10,0
Jannik Dehm,GER,"DF,MF",27,Hannover 96,2. Bundesliga,23.0,46,32,28,11,7,26,40,65.0,14,24,10,14,18,64,66,0
Jannik Hofmann,GER,"FW,MF",21,Nürnberg,2. Bundesliga,3.1,6,3,5,1,0,4,10,40.0,6,1,0,1,3,9,7,0
Jannik Huth,GER,GK,29,Paderborn 07,2. Bundesliga,14.0,1,0,1,0,0,1,3,33.3,2,0,0,0,0,1,5,2
Jannik Rochelt,GER,"FW,MF",24,Elversberg,2. Bundesliga,29.8,24,17,11,9,4,12,37,32.4,25,31,1,30,11,35,21,0
Jannik Vestergaard,DEN,DF,30,Leicester City,EFL,41.3,53,32,32,19,2,27,43,62.8,16,53,36,17,42,95,143,1
Jannis Heuer,GER,DF,24,Paderborn 07,2. Bundesliga,8.8,24,15,12,11,1,9,13,69.2,4,15,11,4,8,32,46,1
Jannis Lang,GER,"DF,MF",21,Hansa Rostock,2. Bundesliga,3.3,7,7,6,1,0,4,5,80.0,1,2,0,2,4,11,21,0
Jannis Nikolaou,GER,"MF,DF",30,Braunschweig,2. Bundesliga,14.4,42,22,24,18,0,17,32,53.1,15,23,5,18,21,63,50,0
Janoi Donacien,LCA,DF,29,Ipswich Town,EFL,2.4,5,2,4,1,0,2,2,100.0,0,4,0,4,2,7,4,0
Japhet Tanganga,ENG,DF,24,Millwall,EFL,17.2,22,14,16,6,0,9,12,75.0,3,32,20,12,25,47,69,0
Jared Stroud,USA,"MF,FW",26,St. Louis,MLS,21.9,44,25,18,17,9,18,69,26.1,51,29,1,28,14,58,15,1
Jari Vandeputte,BEL,"MF,DF",27,Catanzaro,Serie B,34.3,42,20,22,17,3,21,42,50.0,21,35,2,33,19,61,31,0
Jarosław Niezgoda,POL,FW,27,Portland Timbers,MLS,7.3,7,3,2,4,1,2,7,28.6,5,6,2,4,2,9,4,0
Jascha Brandt,GER,FW,20,Paderborn 07,2. Bundesliga,0.3,1,1,1,0,0,0,0,0.0,0,1,0,1,0,1,0,0
Jasmin Kurtić,SVN,MF,34,Südtirol,Serie B,8.8,12,8,4,7,1,6,14,42.9,8,8,3,5,9,21,13,0
Jason Berthomier,FRA,"MF,FW",33,Valenciennes,Ligue 2,1.4,2,1,0,2,0,1,2,50.0,1,1,0,1,0,2,0,0
Jason Ceka,GER,"FW,MF",23,Magdeburg,2. Bundesliga,12.6,9,4,5,2,2,3,11,27.3,8,9,0,9,4,13,1,0
Jason Knight,IRL,"MF,FW",22,Bristol City,EFL,42.6,60,43,16,31,13,17,59,28.8,42,24,2,22,41,101,45,0
Jason Lokilo,BEL,"FW,MF",24,Hull City,EFL,7.9,7,4,3,3,1,4,14,28.6,10,7,0,7,3,10,4,0
Jason Pendant,FRA,DF,26,Quevilly-Rouen,Ligue 2,27.5,37,26,16,19,2,22,49,44.9,27,35,7,28,37,74,56,0
Jasper Löffelsend,GER,MF,25,RSL,MLS,12.6,37,24,16,20,1,16,39,41.0,23,16,2,14,11,48,22,0
Jasper van der Werff,SUI,DF,24,Hansa Rostock,2. Bundesliga,19.0,50,30,31,16,3,27,66,40.9,39,19,5,14,16,66,63,1
Jaume Grau,ESP,MF,27,Zaragoza,Segunda Division,20.4,59,39,18,34,7,29,60,48.3,31,35,12,23,25,84,27,2
Javain Brown,JAM,DF,23,Vancouver W'caps,MLS,19.6,33,18,12,17,4,18,30,60.0,12,19,7,12,21,54,67,1
Javairô Dilrosun,NED,"FW,MF",25,América,Liga MX,6.8,6,5,0,4,2,3,4,75.0,1,12,0,12,4,10,2,0
Javi Lara,ESP,"MF,FW",38,Alcorcón,Segunda Division,16.1,13,9,7,5,1,9,22,40.9,13,9,4,5,9,22,11,1
Javi López,ESP,MF,23,Burgos,Segunda Division,0.6,0,0,0,0,0,0,2,0.0,2,1,0,1,1,1,2,0
Javi Martínez,ESP,MF,24,Huesca,Segunda Division,31.4,42,27,15,21,6,16,58,27.6,42,29,4,25,22,64,26,0
Javi Martón,ESP,FW,25,CD Mirandés,Segunda Division,13.5,14,7,5,4,5,7,11,63.6,4,4,0,4,2,16,13,0
Javi Pamies,ESP,"DF,MF",21,Elche,Segunda Division,0.1,0,0,0,0,0,0,0,0.0,0,0,0,0,0,0,1,0
Javi Puado,ESP,"MF,FW",26,Espanyol,Segunda Division,31.1,30,17,13,10,7,18,33,54.5,15,21,6,15,11,41,27,0
Javi Pérez,ESP,MF,28,Alcorcón,Segunda Division,19.0,51,26,22,25,4,23,42,54.8,19,19,6,13,14,65,31,0
Javi Sánchez,ESP,DF,27,Valladolid,Segunda Division,5.2,5,2,3,2,0,3,7,42.9,4,9,6,3,9,14,10,0
Javi Vargas,ESP,MF,23,Albacete,Segunda Division,0.0,0,0,0,0,0,0,0,0.0,0,0,0,0,0,0,0,0
Javier Alonso,ESP,MF,25,Tenerife,Segunda Division,0.2,1,1,0,1,0,1,1,100.0,0,0,0,0,0,1,0,0
Javier Aquino,MEX,DF,33,UANL,Liga MX,23.9,53,35,34,17,2,34,71,47.9,37,30,5,25,34,87,45,0
Javier Avilés,ESP,"FW,MF",26,Amorebieta,Segunda Division,7.0,7,3,2,3,2,2,4,50.0,2,5,0,5,1,8,3,0
Javier Casas,USA,MF,19,Fire,MLS,0.6,1,1,0,0,1,0,0,0.0,0,0,0,0,1,2,1,0
Javier Castro,ESP,DF,23,Alcorcón,Segunda Division,35.6,56,33,40,15,1,26,44,59.1,18,56,48,8,33,89,164,1
Javier Eduardo López,MEX,"MF,FW",28,Pachuca,Liga MX,5.2,6,2,3,2,1,3,8,37.5,5,2,0,2,1,7,3,0
Javier Eraso,ESP,"FW,MF",34,Amorebieta,Segunda Division,8.8,2,0,2,0,0,1,8,12.5,7,3,0,3,2,4,6,0
Javier Güemez,MEX,MF,31,Atlético,Liga MX,31.2,58,36,29,26,3,27,59,45.8,32,31,13,18,17,75,42,1
Javier Hernández,MEX,FW,35,Guadalajara,Liga MX,2.5,1,0,0,1,0,0,0,0.0,0,1,0,1,0,1,0,0
Javier Hernández,MEX,FW,34,LA Galaxy,MLS,7.6,2,1,0,1,1,1,3,33.3,2,1,0,1,4,6,2,0
Javier Marcelo Correa,ARG,"FW,DF",30,Santos,Liga MX,1.8,3,2,0,1,2,3,3,100.0,0,0,0,0,0,3,1,0
Javier Mier,ESP,MF,25,Huesca,Segunda Division,11.8,23,15,6,14,3,8,18,44.4,10,17,2,15,7,30,14,0
Javier Ontiveros,ESP,"MF,FW",26,Villarreal B,Segunda Division,32.8,58,32,22,26,10,28,78,35.9,50,40,2,38,18,76,28,0
Javier Salas,MEX,MF,29,FC Juárez,Liga MX,20.8,32,19,16,15,1,16,32,50.0,16,18,12,6,17,49,33,0
Jawed Kalai,FRA,"FW,DF",23,Valenciennes,Ligue 2,0.8,3,2,1,2,0,1,3,33.3,2,2,0,2,0,3,1,0
Jay Dasilva,WAL,DF,25,Coventry City,EFL,25.6,41,24,26,13,2,17,32,53.1,15,22,3,19,13,54,43,2
Jay Fulton,SCO,MF,29,Swansea City,EFL,30.6,52,31,17,29,6,18,44,40.9,26,45,21,24,58,110,40,2
Jay Idzes,IDN,DF,23,Venezia,Serie B,23.3,44,27,25,12,7,21,30,70.0,9,39,20,19,23,67,89,0
Jay Stansfield,ENG,"FW,MF",20,Birmingham City,EFL,37.1,41,29,7,17,17,17,51,33.3,34,40,2,38,6,47,12,0
Jayden Reid,USA,MF,21,NY Red Bulls,MLS,0.0,0,0,0,0,0,0,0,0.0,0,0,0,0,0,0,0,0
Jaylin Lindsey,USA,DF,22,Charlotte,MLS,14.5,30,19,14,11,5,11,23,47.8,12,23,4,19,15,45,35,0
Jayson Molumby,IRL,MF,23,West Brom,EFL,12.3,14,9,4,6,4,5,11,45.5,6,15,2,13,9,23,12,0
Jaziel Martínez,MEX,MF,22,Monterrey,Liga MX,0.5,1,0,1,0,0,0,1,0.0,1,0,0,0,1,2,0,0
Jaziel Martínez,MEX,MF,22,Atlas,Liga MX,6.1,10,5,2,8,0,5,16,31.3,11,11,4,7,7,17,11,0
Jean Eric Moursou,CMR,MF,18,Valenciennes,Ligue 2,4.5,7,4,3,3,1,4,7,57.1,3,3,0,3,3,10,6,0
Jean Grillot,FRA,DF,17,Bordeaux,Ligue 2,0.0,2,1,1,1,0,2,2,100.0,0,0,0,0,0,2,0,0
Jean Hugonet,FRA,"MF,DF",23,Magdeburg,2. Bundesliga,10.4,24,17,10,14,0,10,21,47.6,11,18,11,7,8,32,31,0
Jean Louchet,FRA,GK,26,Valenciennes,Ligue 2,31.0,0,0,0,0,0,0,1,0.0,1,0,0,0,1,1,12,3
Jean Marcelin,FRA,DF,23,Bordeaux,Ligue 2,11.5,25,12,21,3,1,15,19,78.9,4,9,7,2,7,32,34,3
Jean Mattéo Bahoya,FRA,"MF,FW",18,Angers,Ligue 2,8.0,16,9,3,7,6,6,20,30.0,14,19,0,19,9,25,6,0
Jean Meneses,CHI,"FW,MF",30,Toluca,Liga MX,24.3,32,16,9,15,8,11,29,37.9,18,31,0,31,14,46,10,1
Jean Mota,BRA,MF,29,Inter Miami,MLS,10.1,37,22,21,13,3,23,46,50.0,23,14,4,10,11,48,10,0
Jean Ruiz,FRA,DF,25,Pau FC,Ligue 2,32.4,40,21,21,18,1,26,47,55.3,21,44,23,21,43,83,141,1
Jean Seri,CIV,MF,32,Hull City,EFL,35.3,50,32,16,27,7,31,64,48.4,33,41,17,24,29,79,31,3
Jean Zimmer,GER,DF,29,Kaiserslautern,2. Bundesliga,25.1,40,27,23,15,2,21,50,42.0,29,27,7,20,18,58,49,0
Jean-Claude Ngando,CMR,"MF,FW",23,Vancouver W'caps,MLS,0.9,4,4,0,3,1,2,4,50.0,2,1,0,1,1,5,2,0
Jean-Luc Dompé,FRA,"FW,MF",27,Hamburger SV,2. Bundesliga,17.7,15,12,6,4,5,9,18,50.0,9,7,1,6,8,23,10,0
Jean-Philippe Gbamin,CIV,MF,27,Dunkerque,Ligue 2,18.1,27,17,8,16,3,15,27,55.6,12,21,7,14,21,48,17,0
Jean-Pierre Nsame,CMR,"FW,DF",30,Como,Serie B,2.1,0,0,0,0,0,0,0,0.0,0,1,0,1,0,0,0,0
Jean-Sylvain Babin,MTQ,DF,37,Alcorcón,Segunda Division,18.9,16,11,10,4,2,6,13,46.2,7,23,18,5,13,29,99,0
Jed Wallace,ENG,"FW,MF",29,West Brom,EFL,31.3,33,24,7,15,11,12,46,26.1,34,28,1,27,5,38,18,0
Jeff Hendrick,IRL,MF,31,Sheffield Weds,EFL,5.4,6,5,3,3,0,5,7,71.4,2,4,2,2,3,9,7,0
Jefferson Intriago,ECU,MF,27,Mazatlán,Liga MX,26.4,35,21,12,17,6,21,46,45.7,25,18,3,15,14,49,19,2
Jefferson Savarino,VEN,"MF,FW",26,RSL,MLS,21.6,18,16,7,7,4,7,23,30.4,16,6,0,6,4,22,4,0
Jekob Jeno,NCL,"MF,FW",23,Grenoble,Ligue 2,2.4,4,2,2,1,1,2,6,33.3,4,2,1,1,7,11,4,0
Jens Castrop,GER,MF,20,Nürnberg,2. Bundesliga,22.5,62,39,23,31,8,30,51,58.8,21,40,9,31,25,87,39,1
Jenson Seelt,NED,DF,20,Sunderland,EFL,11.5,32,17,18,10,4,15,25,60.0,10,16,9,7,15,47,22,1
Jeong Sangbin,KOR,"FW,MF",20,Minnesota Utd,MLS,10.7,4,2,1,0,3,2,3,66.7,1,2,0,2,7,11,3,0
Jere Uronen,FIN,DF,28,Charlotte,MLS,6.8,8,5,3,4,1,2,7,28.6,5,8,4,4,9,17,12,0
Jeremiah Streng,FIN,"FW,MF",21,Ascoli,Serie B,4.5,3,2,1,1,1,2,3,66.7,1,2,0,2,1,4,2,0
Jeremy Arévalo,ESP,"FW,MF",19,Racing Sant,Segunda Division,1.6,1,1,0,1,0,0,0,0.0,0,2,0,2,1,2,1,0
Jeremy Dudziak,TUN,"DF,MF",27,Hertha BSC,2. Bundesliga,9.4,22,14,10,8,4,10,17,58.8,7,12,3,9,12,34,16,0
Jeremy Ebobisse,USA,FW,25,SJ Earthquakes,MLS,32.9,16,9,3,9,4,6,25,24.0,19,10,3,7,14,30,13,0
Jeremy Ngakia,ENG,DF,22,Watford,EFL,10.2,23,17,13,8,2,5,13,38.5,8,16,0,16,13,36,13,1
Jeremy Rafanello,USA,MF,22,Philadelphia,MLS,0.1,0,0,0,0,0,0,1,0.0,1,0,0,0,0,0,1,0
Jeremy Sarmiento,ECU,FW,21,Ipswich Town,EFL,7.1,14,10,3,10,1,6,14,42.9,8,13,1,12,3,17,10,0
Jeremy Sarmiento,ECU,"FW,MF",21,West Brom,EFL,8.1,19,13,8,6,5,5,14,35.7,9,6,0,6,5,24,2,0
Jeroen Zoet,NED,GK,32,Spezia,Serie B,25.0,0,0,0,0,0,0,1,0.0,1,1,0,1,1,1,8,2
Jerry Yates,ENG,FW,26,Swansea City,EFL,25.4,13,10,3,6,4,4,13,30.8,9,22,3,19,3,16,9,0
Jesse Joronen,FIN,GK,30,Venezia,Serie B,29.0,0,0,0,0,0,0,0,0.0,0,0,0,0,0,0,9,1
Jessy Bénet,FRA,MF,28,Grenoble,Ligue 2,25.3,67,40,31,30,6,27,57,47.4,30,26,6,20,24,91,22,0
Jesús Alberto Angulo,MEX,DF,25,UANL,Liga MX,28.7,65,39,30,28,7,39,57,68.4,18,26,11,15,42,107,64,1
Jesús Alcantar,MEX,DF,20,Necaxa,Liga MX,1.0,6,3,5,1,0,5,9,55.6,4,0,0,0,0,6,13,0
Jesús Angulo,MEX,"MF,FW",26,Toluca,Liga MX,17.2,18,8,4,11,3,7,17,41.2,10,6,0,6,2,20,1,1
Jesús Angulo,MEX,MF,26,León,Liga MX,1.8,4,4,1,3,0,1,1,100.0,0,2,0,2,0,4,1,0
Jesús Batiz,USA,"MF,FW",23,Toronto FC,MLS,0.7,1,1,0,1,0,0,0,0.0,0,2,1,1,0,1,0,0
Jesús Belza,ESP,"MF,FW",20,Tenerife,Segunda Division,3.5,3,2,2,1,0,3,7,42.9,4,3,1,2,1,4,2,0
Jesús Bernal,ESP,MF,27,Racing Ferrol,Segunda Division,40.1,69,42,32,35,2,37,89,41.6,52,57,12,45,64,133,77,1
Jesús Clemente,ESP,"MF,FW",24,Eldense,Segunda Division,22.0,38,21,16,15,7,16,32,50.0,16,29,3,26,11,49,18,1
Jesús Corona,MEX,"MF,FW",30,Monterrey,Liga MX,9.9,10,6,3,4,3,3,8,37.5,5,8,0,8,8,18,4,0
Jesús Daniel Bueno,VEN,MF,23,Philadelphia,MLS,10.7,37,21,12,23,2,18,37,48.6,19,17,1,16,17,54,17,1
Jesús David Murillo Largacha,COL,DF,28,LAFC,MLS,15.8,29,15,19,10,0,17,31,54.8,14,20,8,12,19,48,59,0
Jesús Dueñas,MEX,"MF,FW",34,Cruz Azul,Liga MX,0.9,2,2,0,2,0,0,1,0.0,1,2,1,1,0,2,0,0
Jesús Ferreira,USA,FW,22,FC Dallas,MLS,25.2,30,14,13,10,7,11,30,36.7,19,6,0,6,14,44,16,0
Jesús Gallardo,MEX,"DF,FW",28,Monterrey,Liga MX,20.0,40,20,19,17,4,19,36,52.8,17,23,3,20,16,56,26,0
Jesús Garza,MEX,DF,23,UANL,Liga MX,11.1,34,21,21,11,2,18,31,58.1,13,10,3,7,16,50,23,0
Jesús Hernández,MEX,"FW,MF",21,Pachuca,Liga MX,8.9,13,9,7,5,1,7,18,38.9,11,15,0,15,1,14,4,0
Jesús Jiménez,ESP,"FW,MF",29,FC Dallas,MLS,7.6,8,4,0,5,3,4,7,57.1,3,7,0,7,2,10,1,1
Jesús Molina,MEX,MF,35,UNAM,Liga MX,4.1,12,7,3,9,0,3,5,60.0,2,4,2,2,5,17,12,0
Jesús Orozco,MEX,DF,21,Guadalajara,Liga MX,27.1,48,30,36,9,3,18,28,64.3,10,32,17,15,27,75,84,1
Jesús Piñuelas,MEX,DF,25,Toluca,Liga MX,1.7,3,1,2,0,1,1,2,50.0,1,2,0,2,1,4,8,0
Jesús Rivas,MEX,DF,20,UNAM,Liga MX,10.5,30,22,15,10,5,14,28,50.0,14,12,5,7,15,45,28,0
Jesús Rodríguez,MEX,GK,30,Puebla,Liga MX,34.0,0,0,0,0,0,0,6,0.0,6,0,0,0,0,0,12,5
Jesús Ruiz,ESP,GK,27,Alcorcón,Segunda Division,29.0,0,0,0,0,0,0,0,0.0,0,0,0,0,0,0,17,1
Jesús Serrato,MEX,FW,17,Atlas,Liga MX,0.1,1,1,0,1,0,1,1,100.0,0,0,0,0,0,1,0,0
Jesús Sánchez García,MEX,DF,33,Guadalajara,Liga MX,3.3,25,15,12,11,2,13,23,56.5,10,7,1,6,2,27,7,0
Jesús Vega,MEX,DF,23,Tijuana,Liga MX,4.2,11,8,3,6,2,4,9,44.4,5,1,0,1,7,18,5,0
Jesús Venegas,MEX,MF,28,FC Juárez,Liga MX,7.3,12,7,4,8,0,5,11,45.5,6,10,5,5,6,18,13,0
Jesús Venegas,MEX,MF,28,Toluca,Liga MX,6.7,15,10,8,7,0,5,17,29.4,12,9,3,6,13,28,16,0
Jewison Bennette,CRC,FW,19,Sunderland,EFL,0.1,0,0,0,0,0,0,0,0.0,0,0,0,0,0,0,0,0
Jhegson Méndez,ECU,MF,27,Elche,Segunda Division,3.3,8,5,7,1,0,3,7,42.9,4,1,0,1,6,14,4,0
Jhojan Valencia,COL,MF,26,Austin,MLS,15.9,43,27,20,22,1,18,32,56.3,14,25,9,16,30,73,19,1
Jhon Chancellor,VEN,DF,31,Necaxa,Liga MX,4.3,8,6,7,1,0,3,5,60.0,2,10,2,8,6,14,27,0
Jhon Murillo,VEN,"FW,DF",27,Atlas,Liga MX,11.3,15,9,6,5,4,7,9,77.8,2,11,1,10,5,20,5,0
Jhon Murillo,VEN,"FW,MF",27,Atlético,Liga MX,14.6,14,9,4,10,0,5,17,29.4,12,10,0,10,6,20,7,0
Jimmy Dunne,IRL,DF,25,QPR,EFL,26.0,48,26,31,14,3,20,27,74.1,7,19,10,9,23,71,121,0
Jimmy Kaparos,GER,DF,21,Schalke 04,2. Bundesliga,0.1,0,0,0,0,0,0,0,0.0,0,0,0,0,1,1,0,1
Jimmy Maurer,USA,GK,34,FC Dallas,MLS,4.8,0,0,0,0,0,0,0,0.0,0,0,0,0,0,0,2,0
Jimmy Medranda,COL,"MF,DF",28,Crew,MLS,1.2,6,3,5,1,0,1,3,33.3,2,3,1,2,4,10,0,0
Jimmy Roye,FRA,MF,34,Stade Laval,Ligue 2,28.2,30,14,11,12,7,16,35,45.7,19,20,3,17,20,50,54,0
Joachim Kayi Sanda,FRA,DF,16,Valenciennes,Ligue 2,16.5,44,25,28,13,3,15,25,60.0,10,23,8,15,29,73,65,0
Joakim Nilsson,SWE,DF,28,St. Louis,MLS,6.6,12,9,8,4,0,9,12,75.0,3,20,14,6,12,24,29,0
Joan Femenías,ESP,GK,27,Levante,Segunda Division,9.0,0,0,0,0,0,0,0,0.0,0,0,0,0,0,0,0,0
Joan García,ESP,GK,23,Espanyol,Segunda Division,14.0,1,0,1,0,0,1,1,100.0,0,0,0,0,0,1,6,1
Joao Joshimar Rojas,ECU,"MF,FW",25,Monterrey,Liga MX,4.4,4,3,0,3,1,2,6,33.3,4,2,0,2,2,6,1,0
Joaquín Montecinos,CHI,"FW,MF",27,Querétaro,Liga MX,2.6,1,0,0,1,0,1,4,25.0,3,2,0,2,2,3,2,0
Joaquín Moxica,MEX,FW,17,Monterrey,Liga MX,0.2,0,0,0,0,0,0,0,0.0,0,0,0,0,0,0,1,0
Joaquín Muñoz,ESP,"FW,MF",25,Huesca,Segunda Division,22.5,27,18,8,11,8,12,37,32.4,25,26,1,25,7,34,11,0
Joaquín Torres,ARG,"MF,FW",26,Philadelphia,MLS,3.9,4,4,1,1,2,1,2,50.0,1,3,0,3,2,6,0,0
Jobe Bellingham,ENG,"MF,FW",17,Sunderland,EFL,40.3,60,38,23,29,8,24,47,51.1,23,55,14,41,32,92,58,2
Jocelyn Janneh,SLE,MF,20,Bastia,Ligue 2,26.6,107,82,56,45,6,49,89,55.1,40,53,7,46,53,160,33,0
Joe Allen,WAL,MF,33,Swansea City,EFL,7.1,13,8,3,7,3,8,15,53.3,7,5,1,4,15,28,9,0
Joe Aribo,NGA,MF,27,Southampton,EFL,17.8,48,31,13,21,14,18,30,60.0,12,24,2,22,9,57,8,0
Joe Bendik,USA,GK,33,Philadelphia,MLS,7.6,0,0,0,0,0,0,0,0.0,0,0,0,0,0,0,2,0
Joe Bryan,ENG,"DF,MF",29,Millwall,EFL,16.1,45,31,21,20,4,27,50,54.0,23,25,6,19,27,72,30,1
Joe Corona,USA,MF,33,Tijuana,Liga MX,3.7,13,5,6,5,2,3,7,42.9,4,3,1,2,4,17,7,0
Joe Edwards,ENG,"DF,MF",32,Plymouth Argyle,EFL,24.1,52,36,24,23,5,29,62,46.8,33,41,8,33,37,89,74,0
Joe Gelhardt,ENG,"MF,FW",21,Leeds United,EFL,2.2,2,1,1,0,1,1,2,50.0,1,2,0,2,1,3,2,0
Joe Gubbins,ENG,DF,21,QPR,EFL,1.0,1,1,0,1,0,0,0,0.0,0,0,0,0,1,2,3,0
Joe Ralls,ENG,MF,29,Cardiff City,EFL,25.7,56,37,20,32,4,22,43,51.2,21,26,6,20,21,77,29,1
Joe Rankin-Costello,ENG,"MF,DF",24,Blackburn,EFL,18.5,30,19,16,13,1,14,36,38.9,22,22,8,14,22,52,22,0
Joe Rodon,WAL,DF,25,Leeds United,EFL,41.4,48,34,35,12,1,21,31,67.7,10,48,36,12,50,98,198,0
Joe Rothwell,ENG,MF,28,Southampton,EFL,5.0,6,4,1,5,0,0,6,0.0,6,6,2,4,6,12,5,2
Joe Walsh,ENG,GK,21,QPR,EFL,1.0,0,0,0,0,0,0,0,0.0,0,0,0,0,0,0,0,0
Joe Williams,ENG,MF,26,Bristol City,EFL,28.4,67,35,25,39,3,37,75,49.3,38,47,15,32,28,95,48,0
Joe Willis,USA,GK,34,Nashville,MLS,32.0,0,0,0,0,0,0,1,0.0,1,0,0,0,0,0,3,1
Joel Colwill,WAL,MF,18,Cardiff City,EFL,0.4,2,1,2,0,0,0,0,0.0,0,0,0,0,1,3,1,0
Joel Jorquera,ESP,"MF,FW",23,Eldense,Segunda Division,8.9,26,13,16,6,4,12,16,75.0,4,13,1,12,8,34,9,0
Joel Pohjanpalo,FIN,FW,28,Venezia,Serie B,30.0,11,6,2,7,2,4,9,44.4,5,16,4,12,3,14,27,0
Joel Waterman,CAN,DF,27,CF Montréal,MLS,26.4,32,19,18,12,2,20,34,58.8,14,52,33,19,31,63,87,0
Joey Akpunonu,USA,DF,21,FC Cincinnati,MLS,0.1,0,0,0,0,0,0,0,0.0,0,0,0,0,0,0,0,0
Joey Müller,GER,DF,22,Schalke 04,2. Bundesliga,0.5,0,0,0,0,0,0,1,0.0,1,1,0,1,0,0,0,0
Joey Phuthi,ZIM,FW,18,Sheffield Weds,EFL,0.1,0,0,0,0,0,0,0,0.0,0,0,0,0,0,0,0,0
Joffrey Cuffaut,FRA,DF,35,Valenciennes,Ligue 2,16.2,25,21,20,4,1,19,39,48.7,20,21,13,8,33,58,74,0
Jofre,ESP,"MF,FW",23,Espanyol,Segunda Division,20.5,20,14,10,5,5,7,22,31.8,15,17,0,17,7,27,23,0
Johan Gomez,USA,"FW,MF",22,Braunschweig,2. Bundesliga,24.7,15,7,3,9,3,7,19,36.8,12,24,3,21,8,23,10,0
Johann Obiang,GAB,DF,30,Pau FC,Ligue 2,18.6,21,15,13,7,1,10,27,37.0,17,10,3,7,25,46,49,0
Johannes Eggestein,GER,FW,25,St. Pauli,2. Bundesliga,24.6,10,5,5,2,3,6,13,46.2,7,13,0,13,5,15,9,0
Johannes Geis,GER,MF,29,Nürnberg,2. Bundesliga,3.6,12,7,7,4,1,8,11,72.7,3,7,3,4,3,15,15,0
John,BRA,GK,28,Valladolid,Segunda Division,11.0,0,0,0,0,0,0,0,0.0,0,0,0,0,0,0,9,3
John Buckley,ENG,"MF,FW",23,Sheffield Weds,EFL,5.2,17,9,8,6,3,9,19,47.4,10,6,0,6,10,27,3,0
John Buckley,ENG,MF,23,Blackburn,EFL,5.6,13,8,1,12,0,7,14,50.0,7,14,3,11,7,20,4,0
John Donald,ESP,"MF,DF",23,Elche,Segunda Division,18.9,32,21,14,14,4,19,31,61.3,12,23,5,18,30,62,33,1
John Fleck,SCO,MF,31,Blackburn,EFL,0.2,1,0,0,0,1,1,2,50.0,1,0,0,0,0,1,0,0
John Iredale,AUS,"FW,MF",23,Wehen,2. Bundesliga,8.2,10,5,3,4,3,2,8,25.0,6,6,0,6,4,14,15,0
John Klein,USA,MF,23,St. Louis,MLS,0.3,2,2,0,1,1,1,1,100.0,0,1,0,1,1,3,0,0
John McCarthy,USA,GK,30,LAFC,MLS,25.0,2,2,2,0,0,1,1,100.0,0,0,0,0,1,3,7,2
John Nelson,USA,DF,24,St. Louis,MLS,14.1,31,20,15,13,3,18,39,46.2,21,18,2,16,16,47,43,1
John Pulskamp,USA,GK,21,Sporting KC,MLS,5.0,1,0,1,0,0,1,1,100.0,0,0,0,0,0,1,3,0
John Ruddy,ENG,GK,36,Birmingham City,EFL,44.0,0,0,0,0,0,0,2,0.0,2,0,0,0,1,1,16,3
John Swift,ENG,"MF,FW",28,West Brom,EFL,20.7,23,14,10,12,1,7,28,25.0,21,15,2,13,10,33,11,1
John Tolkin,USA,DF,20,NY Red Bulls,MLS,26.4,54,34,34,16,4,35,53,66.0,18,26,4,22,26,80,44,0
John Verhoek,NED,"FW,MF",34,Osnabrück,2. Bundesliga,2.9,1,1,0,1,0,0,2,0.0,2,8,2,6,0,1,5,0
John-Patrick Strauß,PHI,DF,27,Hansa Rostock,2. Bundesliga,8.8,17,9,8,6,3,10,20,50.0,10,11,3,8,7,24,17,1
Johnny Russell,SCO,FW,32,Sporting KC,MLS,18.7,16,8,7,6,3,7,17,41.2,10,21,1,20,18,34,18,0
Johny Placide,HAI,GK,35,Bastia,Ligue 2,32.0,1,0,1,0,0,1,1,100.0,0,0,0,0,1,2,20,1
Jojea Kwizera,RWA,DF,24,CF Montréal,MLS,1.5,3,1,1,1,1,1,3,33.3,2,0,0,0,1,4,0,0
Jokin Ezkieta,ESP,GK,27,Racing Sant,Segunda Division,42.0,0,0,0,0,0,0,0,0.0,0,0,0,0,0,0,27,1
Jomaine Consbruch,GER,MF,21,Greuther Fürth,2. Bundesliga,10.3,16,10,7,8,1,10,17,58.8,7,9,1,8,4,20,4,1
Jon Bautista,ESP,FW,28,Eibar,Segunda Division,25.5,30,18,4,17,9,6,16,37.5,10,21,6,15,7,37,24,0
Jon Bell,JAM,DF,25,St. Louis,MLS,1.6,2,1,1,1,0,1,3,33.3,2,3,2,1,2,4,5,0
Jon Gallagher,IRL,"DF,MF",26,Austin,MLS,31.0,40,24,18,14,8,21,42,50.0,21,27,6,21,22,62,45,1
Jon García Herrero,ESP,DF,33,Racing Ferrol,Segunda Division,35.4,46,26,35,9,2,25,46,54.3,21,51,34,17,47,93,161,1
Jon Karrikaburu,ESP,FW,21,FC Andorra,Segunda Division,14.8,11,6,6,2,3,4,11,36.4,7,6,1,5,4,15,20,0
Jon Mikel Magunagoitia,ESP,GK,23,Amorebieta,Segunda Division,16.0,0,0,0,0,0,0,1,0.0,1,0,0,0,0,0,6,0
Jon Morcillo,ESP,"MF,FW",25,Amorebieta,Segunda Division,23.4,17,12,7,8,2,8,28,28.6,20,25,3,22,19,36,16,0
Jon Rowe,ENG,"FW,MF",20,Norwich City,EFL,22.7,45,23,14,22,9,14,31,45.2,17,23,3,20,14,59,17,1
Jona Niemiec,GER,FW,21,Düsseldorf,2. Bundesliga,9.3,20,13,7,8,5,6,22,27.3,16,22,0,22,9,29,15,0
Jonas David,GER,DF,23,Hansa Rostock,2. Bundesliga,13.3,29,16,23,5,1,17,29,58.6,12,12,8,4,10,39,46,0
Jonas Meffert,GER,MF,28,Hamburger SV,2. Bundesliga,31.3,66,35,25,35,6,36,70,51.4,34,47,11,36,32,98,45,1
Jonas Sterner,GER,DF,21,Holstein Kiel,2. Bundesliga,5.8,11,6,8,3,0,9,21,42.9,12,16,2,14,3,14,13,0
Jonas Urbig,GER,GK,19,Greuther Fürth,2. Bundesliga,33.0,1,1,1,0,0,0,0,0.0,0,1,0,1,0,1,19,2
Jonatan Villal,USA,"MF,FW",18,Atlético,Liga MX,1.4,2,2,1,0,1,1,2,50.0,1,1,0,1,1,3,1,0
Jonathan Bond,ENG,GK,29,LA Galaxy,MLS,22.8,0,0,0,0,0,0,0,0.0,0,1,0,1,2,2,17,5
Jonathan Buatu Mananga,ANG,DF,29,Valenciennes,Ligue 2,15.6,30,20,25,5,0,19,22,86.4,3,20,11,9,27,57,71,0
Jonathan Dean,USA,DF,25,Fire,MLS,15.3,24,13,15,8,1,12,23,52.2,11,21,5,16,23,47,49,1
Jonathan Dubasin,BEL,"FW,MF",24,Oviedo,Segunda Division,9.4,12,8,8,4,0,10,15,66.7,5,11,3,8,7,19,5,0
Jonathan Gomez,USA,DF,20,CD Mirandés,Segunda Division,33.3,49,33,31,15,3,32,56,57.1,24,36,12,24,35,84,74,0
Jonathan Goncalvés,FRA,"MF,DF",34,Annecy,Ligue 2,2.2,2,1,1,1,0,1,6,16.7,5,2,1,1,2,4,5,0
Jonathan González,MEX,MF,24,Monterrey,Liga MX,6.6,10,6,5,5,0,5,10,50.0,5,5,2,3,13,23,10,0
Jonathan Hogg,ENG,MF,34,Huddersfield,EFL,29.9,83,51,28,46,9,38,67,56.7,29,46,20,26,45,128,61,1
Jonathan Iglesias,URU,MF,34,Guingamp,Ligue 2,3.7,13,9,4,9,0,5,11,45.5,6,3,0,3,2,15,5,0
Jonathan Klinsmann,USA,GK,25,LA Galaxy,MLS,9.2,0,0,0,0,0,0,0,0.0,0,0,0,0,0,0,7,1
Jonathan Kodjia,CIV,"FW,MF",33,Annecy,Ligue 2,4.2,4,3,0,2,2,2,2,100.0,0,3,0,3,2,6,5,0
Jonathan Lewis,USA,"FW,MF",25,Rapids,MLS,13.2,10,7,2,7,1,4,11,36.4,7,4,2,2,4,14,3,0
Jonathan Mensah,GHA,DF,32,SJ Earthquakes,MLS,21.7,8,6,5,3,0,5,10,50.0,5,28,17,11,20,28,92,1
Jonathan Osorio,CAN,"MF,FW",30,Toronto FC,MLS,20.8,22,16,9,8,5,9,18,50.0,9,10,0,10,16,38,11,0
Jonathan Padilla,MEX,"MF,FW",17,Guadalajara,Liga MX,7.4,26,14,10,13,3,15,35,42.9,20,19,2,17,4,30,4,0
Jonathan Panzo,ENG,DF,22,Cardiff City,EFL,0.9,1,1,1,0,0,1,2,50.0,1,0,0,0,3,4,3,0
Jonathan Perez,MEX,"DF,MF",20,LA Galaxy,MLS,1.3,3,1,1,1,1,0,1,0.0,1,1,0,1,2,5,1,0
Jonathan Perlaza,ECU,DF,25,Querétaro,Liga MX,3.1,13,10,7,5,1,4,6,66.7,2,3,0,3,6,19,8,0
Jonathan Rodríguez,URU,"FW,MF",30,América,Liga MX,9.0,10,4,3,7,0,3,9,33.3,6,3,0,3,1,11,9,0
Jonathan Silva,ARG,DF,29,Albacete,Segunda Division,18.4,49,31,20,24,5,30,41,73.2,11,18,4,14,11,60,38,0
Jonathan Sirois,CAN,GK,21,CF Montréal,MLS,32.1,4,1,4,0,0,4,6,66.7,2,0,0,0,1,5,12,1
Jonathan Torres,ARG,MF,26,Querétaro,Liga MX,0.1,1,1,1,0,0,0,0,0.0,0,0,0,0,0,1,1,0
Jonathan Varane,FRA,MF,22,Sporting Gijón,Segunda Division,7.9,23,14,13,10,0,10,16,62.5,6,9,6,3,22,45,15,0
Jonathan dos Santos,MEX,MF,33,América,Liga MX,26.0,57,39,24,32,1,25,63,39.7,38,27,6,21,44,101,23,3
Joni Montiel,ESP,MF,25,Burgos,Segunda Division,10.6,24,12,12,9,3,12,29,41.4,17,8,0,8,3,27,9,1
Joni Montiel,ESP,"MF,FW",25,Valladolid,Segunda Division,4.9,8,5,1,3,4,6,13,46.2,7,4,0,4,0,8,2,0
Jonjoe Kenny,ENG,DF,26,Hertha BSC,2. Bundesliga,28.1,66,42,27,32,7,35,55,63.6,20,47,13,34,36,102,73,0
Jonny Howson,ENG,MF,35,Middlesbrough,EFL,34.4,53,33,20,32,1,26,53,49.1,27,30,10,20,34,87,51,2
Jony,ESP,FW,32,Cartagena,Segunda Division,0.1,0,0,0,0,0,0,0,0.0,0,0,0,0,0,0,0,0
Jony Álamo,ESP,MF,22,Cartagena,Segunda Division,6.2,12,4,7,5,0,7,16,43.8,9,6,2,4,4,16,8,0
Jordan Adéoti,BEN,"MF,DF",34,Stade Laval,Ligue 2,6.0,16,7,5,9,2,9,19,47.4,10,6,0,6,3,19,8,0
Jordan Carrillo,MEX,MF,22,Sporting Gijón,Segunda Division,0.1,0,0,0,0,0,0,0,0.0,0,0,0,0,0,0,0,0
Jordan Carrillo,MEX,"MF,FW",21,Santos,Liga MX,12.5,17,13,4,11,2,5,13,38.5,8,13,0,13,7,24,4,0
Jordan Dongmo,CMR,MF,22,Troyes,Ligue 2,0.1,1,1,1,0,0,0,0,0.0,0,0,0,0,0,1,2,0
Jordan Faria,CAN,FW,22,Toronto FC,MLS,0.3,0,0,0,0,0,0,0,0.0,0,0,0,0,0,0,0,0
Jordan Houghton,ENG,MF,27,Plymouth Argyle,EFL,31.8,53,28,16,32,5,21,44,47.7,23,46,21,25,24,77,52,1
Jordan Hugill,ENG,FW,31,Rotherham Utd,EFL,25.9,6,1,0,6,0,2,7,28.6,5,13,4,9,2,8,27,1
Jordan James,WAL,"MF,FW",19,Birmingham City,EFL,25.6,52,32,22,24,6,18,45,40.0,27,39,3,36,28,80,27,1
Jordan Lefort,FRA,DF,29,Angers,Ligue 2,33.8,55,34,36,16,3,40,65,61.5,25,30,15,15,58,113,99,0
Jordan Morris,USA,FW,28,Seattle,MLS,22.0,12,9,5,6,1,4,8,50.0,4,13,2,11,3,15,11,0
Jordan Perruzza,CAN,"FW,MF",22,Toronto FC,MLS,1.4,1,0,0,0,1,0,1,0.0,1,0,0,0,0,1,0,0
Jordan Poha,FRA,DF,20,Valenciennes,Ligue 2,15.9,29,18,23,5,1,14,20,70.0,6,23,10,13,17,46,74,0
Jordan Sierra,ECU,"MF,FW",26,Querétaro,Liga MX,14.9,37,23,15,19,3,18,44,40.9,26,12,4,8,17,54,9,0
Jordan Silva,MEX,DF,29,Atlético,Liga MX,10.7,20,18,12,8,0,8,15,53.3,7,14,11,3,16,36,59,4
Jordan Storey,ENG,DF,25,Preston,EFL,40.0,49,31,25,19,5,25,43,58.1,18,47,16,31,81,130,129,1
Jordan Tell,GLP,"MF,FW",26,Stade Laval,Ligue 2,3.1,7,6,2,5,0,3,5,60.0,2,1,0,1,2,9,3,0
Jordan Thompson,NIR,"DF,MF",26,Stoke City,EFL,24.6,59,37,27,27,5,30,47,63.8,17,20,8,12,21,80,43,0
Jordi Alba,ESP,DF,33,Inter Miami,MLS,4.9,9,5,5,4,0,4,7,57.1,3,2,0,2,1,10,9,0
Jordi Cortizo,MEX,"MF,FW",27,Monterrey,Liga MX,17.3,56,37,24,13,19,24,55,43.6,31,18,0,18,10,66,3,0
Jordi Masip,ESP,GK,35,Valladolid,Segunda Division,31.0,1,1,1,0,0,1,1,100.0,0,0,0,0,0,1,8,0
Jordi Mboula,ESP,"FW,MF",25,Racing Sant,Segunda Division,12.7,9,4,6,1,2,7,18,38.9,11,14,3,11,8,17,10,0
Jordy Caicedo,ECU,FW,25,Atlas,Liga MX,17.9,5,3,2,1,2,3,10,30.0,7,7,2,5,4,9,25,0
Jordy Gaspar,ANG,"DF,FW",26,Pau FC,Ligue 2,14.2,24,17,18,6,0,12,21,57.1,9,14,5,9,14,38,29,0
Jordy de Wijs,NED,DF,28,Düsseldorf,2. Bundesliga,22.6,23,11,10,12,1,13,20,65.0,7,35,20,15,30,53,90,0
Jorge Agustín Rodríguez,ARG,MF,27,Monterrey,Liga MX,12.6,32,15,17,13,2,16,29,55.2,13,13,5,8,11,43,27,0
Jorge Berlanga,MEX,DF,20,Pachuca,Liga MX,11.5,16,11,5,11,0,10,18,55.6,8,12,2,10,18,34,50,0
Jorge Cabello,ESP,DF,20,Levante,Segunda Division,5.7,10,6,7,3,0,5,6,83.3,1,7,6,1,1,11,17,0
Jorge Cabezas,COL,"FW,MF",19,NY Red Bulls,MLS,1.3,2,1,1,1,0,1,3,33.3,2,2,0,2,0,2,0,0
Jorge Gonzalez,ESP,MF,19,Valladolid,Segunda Division,0.0,0,0,0,0,0,0,0,0.0,0,0,0,0,0,0,0,0
Jorge Guzmán,MEX,"FW,MF",19,Atlas,Liga MX,8.1,10,6,3,6,1,3,9,33.3,6,7,0,7,4,14,6,0
Jorge Mier,ESP,"DF,MF",25,Amorebieta,Segunda Division,11.6,30,22,21,5,4,16,27,59.3,11,20,4,16,11,41,41,0
Jorge Miramón,ESP,"DF,FW",35,Leganés,Segunda Division,22.1,43,26,21,18,4,20,37,54.1,17,25,6,19,23,66,40,0
Jorge Pombo,ESP,"FW,MF",30,FC Andorra,Segunda Division,6.8,1,1,0,0,1,0,5,0.0,5,4,0,4,0,1,2,0
Jorge Pombo,ESP,MF,30,Racing Sant,Segunda Division,0.2,0,0,0,0,0,0,0,0.0,0,0,0,0,0,0,0,0
Jorge Pulido,ESP,DF,33,Huesca,Segunda Division,35.9,21,12,17,3,1,7,15,46.7,8,35,28,7,38,59,182,1
Jorge Rodríguez,MEX,DF,21,Necaxa,Liga MX,13.9,41,24,23,15,3,18,33,54.5,15,19,8,11,19,60,32,0
Jorge Ruvalcaba,MEX,"MF,FW",22,UNAM,Liga MX,0.7,3,1,1,0,2,0,3,0.0,3,0,0,0,1,4,0,0
Jorge Sáenz,ESP,DF,27,Leganés,Segunda Division,35.2,50,34,37,13,0,21,34,61.8,13,32,22,10,30,80,185,0
Jorge Yriarte,VEN,MF,24,Amorebieta,Segunda Division,4.2,8,4,4,3,1,5,8,62.5,3,1,0,1,4,12,13,0
Jorge Yriarte,VEN,MF,24,Eibar,Segunda Division,0.6,1,1,1,0,0,0,0,0.0,0,2,0,2,0,1,0,0
Jorge Zarfino,URU,"FW,MF",32,Sporting Gijón,Segunda Division,0.3,0,0,0,0,0,0,1,0.0,1,0,0,0,0,0,2,0
Joris Chougrani,FRA,DF,32,Rodez Aveyron,Ligue 2,10.7,21,13,10,8,3,11,19,57.9,8,13,6,7,19,40,30,0
Josan,ESP,DF,34,Elche,Segunda Division,24.0,58,33,30,23,5,38,61,62.3,23,22,5,17,27,85,22,0
Jose Amo,ESP,DF,26,Tenerife,Segunda Division,27.6,20,13,15,5,0,11,21,52.4,10,28,21,7,31,51,102,0
Jose Matos,ESP,DF,29,Burgos,Segunda Division,34.9,94,64,60,25,9,44,70,62.9,26,41,11,30,61,155,97,0
Josef Martínez,VEN,FW,29,Inter Miami,MLS,19.3,5,3,2,0,3,3,8,37.5,5,5,1,4,1,6,12,0
Josep Antoni Gayá,ESP,DF,23,Amorebieta,Segunda Division,17.2,35,26,24,11,0,15,26,57.7,11,21,11,10,25,60,73,0
Josep Señé,ESP,MF,32,Racing Ferrol,Segunda Division,23.1,37,20,13,21,3,15,33,45.5,18,17,3,14,21,58,22,0
Joseph Boyamba,GER,"FW,MF",27,Elversberg,2. Bundesliga,4.8,15,10,4,10,1,5,11,45.5,6,3,0,3,1,16,3,0
Joseph Hodge,IRL,MF,20,QPR,EFL,4.0,10,9,1,4,5,4,6,66.7,2,6,1,5,4,14,2,0
Joseph Hungbo,ENG,"FW,MF",23,Nürnberg,2. Bundesliga,4.6,6,2,3,2,1,4,5,80.0,1,6,1,5,1,7,3,0
Joseph James,ENG,DF,17,Bristol City,EFL,0.9,2,0,0,2,0,2,3,66.7,1,2,0,2,1,3,1,0
Joseph Lopy,SEN,MF,31,Angers,Ligue 2,18.8,42,27,16,24,2,13,29,44.8,16,18,5,13,19,61,17,1
Joseph Mendes,GNB,FW,32,Rodez Aveyron,Ligue 2,0.1,0,0,0,0,0,0,1,0.0,1,0,0,0,1,1,0,0
Joseph Mora,CRC,DF,30,Charlotte,MLS,2.1,5,3,4,1,0,3,5,60.0,2,4,0,4,4,9,6,0
Joseph Rosales,HON,"FW,MF",22,Minnesota Utd,MLS,12.1,32,22,10,18,4,14,27,51.9,13,19,2,17,12,44,14,1
Josh Bauer,USA,DF,24,Nashville,MLS,5.8,8,6,3,5,0,4,4,100.0,0,9,8,1,11,19,15,0
Josh Bowler,ENG,"FW,MF",24,Cardiff City,EFL,26.4,35,24,19,12,4,15,33,45.5,18,32,2,30,16,51,10,0
Josh Coburn,ENG,FW,20,Middlesbrough,EFL,11.1,6,2,0,5,1,3,7,42.9,4,4,0,4,1,7,8,0
Josh Eccles,ENG,MF,23,Coventry City,EFL,36.4,99,60,46,44,9,43,89,48.3,46,59,14,45,44,143,58,2
Josh Ginnelly,ENG,"FW,DF",26,Swansea City,EFL,2.1,1,0,1,0,0,0,0,0.0,0,0,0,0,1,2,1,0
Josh Key,ENG,"DF,FW",23,Swansea City,EFL,24.4,53,31,26,24,3,33,58,56.9,25,22,8,14,23,76,48,0
Josh Koroma,SLE,"FW,MF",24,Huddersfield,EFL,26.9,26,18,11,7,8,10,23,43.5,13,21,2,19,8,34,12,0
Josh Laurent,ENG,MF,28,Stoke City,EFL,29.9,59,39,21,28,10,16,31,51.6,15,31,8,23,29,88,33,0
Josh Maja,NGA,FW,24,West Brom,EFL,2.2,1,1,0,1,0,0,0,0.0,0,0,0,0,1,2,1,0
Josh Ruffels,ENG,DF,29,Huddersfield,EFL,8.6,17,11,9,8,0,4,15,26.7,11,10,1,9,14,31,22,0
Josh Sargent,USA,FW,23,Norwich City,EFL,20.6,10,5,3,4,3,3,9,33.3,6,16,3,13,5,15,11,0
Josh Tymon,ENG,DF,24,Swansea City,EFL,37.0,61,34,29,26,6,36,56,64.3,20,42,9,33,46,107,77,1
Josh Tymon,ENG,DF,24,Stoke City,EFL,0.7,0,0,0,0,0,0,0,0.0,0,0,0,0,1,1,3,0
Josh Wilson-Esbrand,ENG,"DF,MF",20,Cardiff City,EFL,7.4,10,6,7,1,2,5,11,45.5,6,2,1,1,6,16,10,0
Josh Windass,ENG,"MF,FW",29,Sheffield Weds,EFL,19.4,19,10,6,6,7,10,26,38.5,16,19,0,19,8,27,9,0
Joshua Atencio,USA,MF,21,Seattle,MLS,10.9,41,28,12,21,8,21,38,55.3,17,15,2,13,16,57,14,0
Joshua Austerfield,ENG,MF,21,Huddersfield,EFL,0.8,1,0,0,1,0,0,0,0.0,0,0,0,0,1,2,0,0
Joshua Bolma,GHA,MF,20,NE Revolution,MLS,0.3,2,2,1,1,0,1,1,100.0,0,0,0,0,0,2,0,0
Joshua Kayode,NGA,"MF,FW",30,Rotherham Utd,EFL,0.5,1,1,0,0,1,1,1,100.0,0,1,0,1,0,1,0,0
Joshua Mees,GER,"FW,MF",27,Holstein Kiel,2. Bundesliga,4.9,1,0,0,0,1,1,2,50.0,1,4,0,4,3,4,3,0
Joshua Quarshie,GER,DF,19,Düsseldorf,2. Bundesliga,5.2,4,1,3,0,1,1,3,33.3,2,4,2,2,6,10,27,0
Joshua Seary,ENG,"DF,MF",18,Preston,EFL,0.3,2,1,0,2,0,1,1,100.0,0,0,0,0,0,2,0,0
Joshua Tenkorang,ITA,"MF,FW",23,Calcio Lecco 1912,Serie B,1.6,1,1,0,1,0,1,2,50.0,1,1,1,0,1,2,1,0
Joshua Yaro,GHA,DF,28,St. Louis,MLS,10.1,23,17,16,5,2,10,12,83.3,2,13,6,7,18,41,48,0
Josias Lukembila,SUI,"FW,MF",23,Paris FC,Ligue 2,18.3,30,21,17,6,7,14,27,51.9,13,20,1,19,9,39,8,1
Josué Colmán,PAR,"FW,MF",25,Mazatlán,Liga MX,18.2,14,5,6,8,0,7,22,31.8,15,6,0,6,9,23,8,1
Josué Dorrio,ESP,"MF,FW",30,Amorebieta,Segunda Division,37.5,39,24,10,25,4,13,43,30.2,30,23,1,22,18,57,19,0
Josué Díaz,MEX,"DF,MF",18,Cruz Azul,Liga MX,0.5,0,0,0,0,0,0,0,0.0,0,1,0,1,1,1,0,0
Josué Escartin,FRA,"DF,MF",20,Ajaccio,Ligue 2,1.7,3,3,0,2,1,0,1,0.0,1,8,2,6,2,5,2,0
José Abella,MEX,DF,29,FC Juárez,Liga MX,10.4,27,13,14,11,2,13,26,50.0,13,6,3,3,10,37,35,0
José Abella,MEX,DF,29,Atlas,Liga MX,17.0,35,20,18,10,7,20,41,48.8,21,10,3,7,21,56,38,0
José Andrés Martínez,VEN,MF,28,Philadelphia,MLS,20.3,52,30,30,19,3,31,56,55.4,25,26,10,16,33,85,18,1
José Antonio Rodríguez,MEX,GK,31,Tijuana,Liga MX,27.5,1,1,1,0,0,1,1,100.0,0,0,0,0,0,1,11,1
José Antonio Ríos,ESP,DF,34,Eibar,Segunda Division,18.5,26,22,16,6,4,17,29,58.6,12,12,2,10,14,40,34,0
José Caicedo,COL,MF,21,UNAM,Liga MX,21.2,45,28,13,30,2,19,49,38.8,30,23,7,16,34,79,36,2
José Carlos Lazo,ESP,"MF,FW",28,Espanyol,Segunda Division,3.6,6,3,0,3,3,2,7,28.6,5,4,2,2,1,7,3,0
José Castillo Pérez,MEX,DF,21,Pachuca,Liga MX,8.3,21,14,11,9,1,16,18,88.9,2,15,5,10,8,29,22,0
José Castillo Pérez,MEX,DF,21,Guadalajara,Liga MX,5.7,9,8,5,4,0,5,5,100.0,0,9,4,5,5,14,17,0
José Cifuentes,ECU,MF,23,LAFC,MLS,15.1,27,22,9,11,7,11,38,28.9,27,15,2,13,11,38,11,0
José Corona,MEX,GK,42,Tijuana,Liga MX,6.5,0,0,0,0,0,0,1,0.0,1,0,0,0,0,0,0,3
José Corpas,ESP,"FW,DF",32,Eibar,Segunda Division,23.0,25,15,11,10,4,15,39,38.5,24,25,0,25,20,45,33,1
José David Ramírez,MEX,"DF,MF",27,León,Liga MX,15.2,26,16,14,11,1,15,28,53.6,13,10,3,7,9,35,30,0
José Eulogio,MEX,GK,19,Pachuca,Liga MX,2.0,0,0,0,0,0,0,0,0.0,0,0,0,0,0,0,0,0
José Fajardo,PAN,"FW,MF",29,D.C. United,MLS,2.7,4,1,2,2,0,0,1,0.0,1,1,0,1,0,4,0,0
José Fontán,ESP,DF,24,Cartagena,Segunda Division,35.6,69,46,41,24,4,45,63,71.4,18,33,16,17,54,123,150,0
José Galindo,MEX,DF,25,UNAM,Liga MX,2.0,2,2,1,0,1,0,2,0.0,2,0,0,0,2,4,10,0
José García,MEX,DF,27,FC Juárez,Liga MX,17.9,32,17,26,6,0,18,29,62.1,11,14,8,6,27,59,92,0
José González,MEX,FW,24,Atlético,Liga MX,1.9,0,0,0,0,0,0,2,0.0,2,1,0,1,0,0,1,0
José Gragera,ESP,MF,23,Espanyol,Segunda Division,20.1,70,39,24,36,10,32,54,59.3,22,46,10,36,40,110,27,2
José Iván Rodríguez,MEX,MF,27,León,Liga MX,15.2,45,30,20,25,0,23,44,52.3,21,21,8,13,19,64,21,1
José Joaquín Esquivel,MEX,"MF,DF",25,Mazatlán,Liga MX,9.9,15,6,8,5,2,6,19,31.6,13,18,5,13,16,31,21,0
José Joaquín Esquivel,MEX,MF,25,Necaxa,Liga MX,3.0,8,3,6,2,0,0,2,0.0,2,6,2,4,4,12,1,0
José Juan Macías,MEX,"FW,MF",23,Guadalajara,Liga MX,3.2,3,2,0,2,1,1,2,50.0,1,1,0,1,0,3,0,0
José León Bernal,ESP,DF,29,Tenerife,Segunda Division,24.2,17,12,15,2,0,6,11,54.5,5,19,15,4,16,33,120,0
José Lozano,MEX,"DF,FW",24,Atlas,Liga MX,18.2,34,18,22,10,2,20,31,64.5,11,23,7,16,16,50,39,1
José Madueña,MEX,DF,33,Mazatlán,Liga MX,13.9,25,19,12,8,5,9,17,52.9,8,7,1,6,16,41,37,0
José Marsà,ESP,DF,22,FC Andorra,Segunda Division,21.8,29,19,18,9,2,18,29,62.1,11,22,11,11,26,55,69,4
José Martínez,ESP,DF,29,FC Dallas,MLS,15.9,18,12,13,4,1,9,13,69.2,4,14,8,6,16,34,66,0
José Menor,SPA,FW,21,Burgos,Segunda Division,0.1,0,0,0,0,0,0,0,0.0,0,0,0,0,0,0,0,0
José Mulato,COL,"FW,MF",20,FC Dallas,MLS,1.2,2,2,1,1,0,1,2,50.0,1,0,0,0,0,2,0,0
José Paradela,ARG,"FW,MF",24,Necaxa,Liga MX,13.5,23,14,5,13,5,8,14,57.1,6,9,3,6,7,30,2,0
José Rangel Aguilar,MEX,GK,23,Guadalajara,Liga MX,18.2,1,1,1,0,0,0,0,0.0,0,0,0,0,0,1,11,1
José Salinas,ESP,"DF,MF",23,Elche,Segunda Division,11.0,15,10,8,5,2,9,11,81.8,2,14,5,9,3,18,23,1
José Zúñiga,COL,FW,29,Querétaro,Liga MX,9.5,5,1,1,1,3,2,6,33.3,4,2,0,2,2,7,3,0
José Zúñiga,COL,"FW,MF",29,Tijuana,Liga MX,8.1,11,8,1,7,3,3,8,37.5,5,3,0,3,2,13,8,0
José Ángel,ESP,DF,34,Sporting Gijón,Segunda Division,33.3,56,41,35,15,6,35,64,54.7,29,29,8,21,30,86,102,0
Jovan Nišić,SRB,DF,25,Pau FC,Ligue 2,0.1,0,0,0,0,0,0,0,0.0,0,0,0,0,0,0,0,0
Jovanny Bolívar,VEN,FW,22,Albacete,Segunda Division,0.5,0,0,0,0,0,0,0,0.0,0,0,0,0,0,0,2,0
Jovanny Bolívar,VEN,"FW,MF",22,Huesca,Segunda Division,3.4,7,4,1,5,1,1,2,50.0,1,1,0,1,0,7,1,0
Jozy Altidore,USA,FW,33,NE Revolution,MLS,2.3,0,0,0,0,0,0,2,0.0,2,0,0,0,0,0,0,0
João Moutinho,POR,DF,25,Spezia,Serie B,1.9,2,0,2,0,0,0,0,0.0,0,2,0,2,2,4,3,0
João Paulo Mior,BRA,MF,31,Seattle,MLS,27.3,70,39,35,29,6,49,103,47.6,54,30,7,23,48,118,47,0
Joël Latibeaudière,JAM,"DF,MF",23,Coventry City,EFL,30.3,66,41,32,26,8,22,54,40.7,32,42,18,24,35,101,86,1
Joël Piroe,NED,"MF,FW",23,Leeds United,EFL,28.0,26,19,1,18,7,7,23,30.4,16,17,3,14,6,32,8,0
Joël Piroe,NED,FW,23,Swansea City,EFL,3.0,3,2,1,2,0,1,3,33.3,2,1,0,1,4,7,3,0
Juan Antonio Ros,ESP,DF,28,Albacete,Segunda Division,12.2,11,10,9,2,0,6,7,85.7,1,4,2,2,15,26,57,2
Juan Artola,ESP,"FW,MF",24,Alcorcón,Segunda Division,9.1,14,10,1,11,2,9,17,52.9,8,6,1,5,3,17,17,0
Juan Berrocal,ESP,DF,25,Eibar,Segunda Division,31.9,28,17,18,8,2,19,31,61.3,12,29,19,10,41,69,109,2
Juan Brigido,MEX,"FW,DF",21,Guadalajara,Liga MX,3.0,5,2,2,1,2,2,3,66.7,1,5,0,5,0,5,0,0
Juan Brunetta,ARG,"MF,FW",26,Santos,Liga MX,15.7,17,14,0,13,4,4,8,50.0,4,17,0,17,4,21,5,0
Juan Brunetta,ARG,MF,26,UANL,Liga MX,13.5,14,6,3,7,4,6,14,42.9,8,9,1,8,7,21,5,0
Juan Cantú,MEX,FW,19,América,Liga MX,0.3,0,0,0,0,0,0,0,0.0,0,0,0,0,0,0,0,0
Juan Carlos,ESP,"FW,MF",33,Cartagena,Segunda Division,10.7,15,6,3,10,2,5,15,33.3,10,11,4,7,2,17,3,1
Juan Cruz,ESP,"FW,MF",24,Leganés,Segunda Division,10.6,10,6,8,1,1,6,16,37.5,10,4,0,4,5,15,5,0
Juan David Castro,MEX,"MF,FW",31,Atlético,Liga MX,6.1,9,5,3,5,1,5,7,71.4,2,6,2,4,6,15,4,0
Juan David Mosquera,COL,DF,20,Portland Timbers,MLS,26.7,38,27,20,9,9,14,39,35.9,25,17,1,16,18,56,35,0
Juan Delgado,CHI,"DF,MF",30,Sheffield Weds,EFL,7.6,14,11,12,2,0,11,25,44.0,14,7,0,7,9,23,10,0
Juan Domínguez,MEX,"FW,MF",24,Toluca,Liga MX,23.9,29,22,5,20,4,10,29,34.5,19,11,2,9,7,36,6,0
Juan Escobar,PAR,DF,28,Cruz Azul,Liga MX,13.6,25,17,18,7,0,17,29,58.6,12,15,8,7,22,47,59,1
Juan Escobar,PAR,DF,28,Toluca,Liga MX,10.0,7,4,5,2,0,5,11,45.5,6,7,3,4,15,22,51,2
Juan Ferney Otero,COL,"FW,MF",29,Sporting Gijón,Segunda Division,35.4,29,18,12,12,5,13,36,36.1,23,29,5,24,14,43,46,0
Juan Gamboa,MEX,"MF,FW",22,Toluca,Liga MX,1.7,4,1,1,2,1,4,5,80.0,1,2,0,2,0,4,1,0
Juan Gutierrez,ESP,DF,24,Racing Sant,Segunda Division,1.2,2,1,2,0,0,1,2,50.0,1,2,1,1,2,4,4,0
Juan Ignacio Dinenno,ARG,"FW,MF",28,UNAM,Liga MX,8.8,2,2,0,1,1,2,10,20.0,8,3,2,1,1,3,2,0
Juan José Sánchez,COL,DF,25,UANL,Liga MX,7.1,10,6,5,5,0,4,10,40.0,6,11,9,2,12,22,24,0
Juan José Sánchez,COL,DF,25,Atlanta Utd,MLS,23.7,33,14,20,13,0,16,25,64.0,9,24,17,7,37,70,98,0
Juan Luna,MEX,MF,20,UANL,Liga MX,0.0,0,0,0,0,0,0,0,0.0,0,0,0,0,0,0,0,0
Juan María,ESP,"DF,MF",23,CD Mirandés,Segunda Division,17.2,29,17,18,10,1,18,41,43.9,23,22,7,15,20,49,46,1
Juan Pablo Vigón,MEX,MF,32,UANL,Liga MX,12.9,20,16,6,12,2,7,26,26.9,19,14,4,10,6,26,7,0
Juan Perea,COL,FW,23,Hansa Rostock,2. Bundesliga,16.4,7,4,2,4,1,1,7,14.3,6,13,3,10,4,11,6,0
Juan Pérez,ESP,GK,27,Huesca,Segunda Division,1.0,0,0,0,0,0,0,0,0.0,0,0,0,0,0,0,0,0
Juan Sabater,SPA,DF,17,Cartagena,Segunda Division,0.5,1,1,1,0,0,1,1,100.0,0,0,0,0,0,1,3,0
Juan Sanabria,URU,"DF,FW",23,Atlético,Liga MX,32.0,78,53,51,22,5,47,76,61.8,29,38,10,28,39,117,82,2
Juan Sebastian Serrano,ESP,FW,22,Zaragoza,Segunda Division,0.1,0,0,0,0,0,0,0,0.0,0,0,0,0,0,0,0,0
Juan Soriano,ESP,GK,26,Tenerife,Segunda Division,39.2,0,0,0,0,0,0,1,0.0,1,0,0,0,0,0,14,0
Juan Zapata,COL,MF,23,Atlas,Liga MX,14.9,31,20,9,18,4,13,25,52.0,12,16,1,15,10,41,8,0
Juanjo Narváez,COL,"FW,MF",29,Cartagena,Segunda Division,14.0,7,4,2,3,2,1,8,12.5,7,8,0,8,5,12,9,0
Juanjo Nieto,ESP,DF,29,Huesca,Segunda Division,24.1,59,37,38,17,4,33,56,58.9,23,8,1,7,39,98,69,1
Juanma,ESP,"FW,MF",31,Albacete,Segunda Division,24.1,24,16,11,10,3,11,25,44.0,14,29,0,29,9,33,6,0
Juanma Bravo,ESP,"MF,FW",26,Alcorcón,Segunda Division,10.4,34,24,15,13,6,18,29,62.1,11,14,2,12,10,44,15,0
Juanto Ortuño,ESP,FW,32,Eldense,Segunda Division,20.3,18,6,0,9,9,5,15,33.3,10,10,1,9,2,20,13,0
Jubal,BRA,DF,29,Auxerre,Ligue 2,31.0,64,37,39,22,3,34,51,66.7,17,33,17,16,36,100,121,0
Judson,BRA,MF,29,SJ Earthquakes,MLS,5.2,21,16,12,9,0,9,25,36.0,16,6,2,4,11,32,6,0
Julen Lobete,ESP,"FW,MF",23,FC Andorra,Segunda Division,30.1,29,23,14,6,9,10,26,38.5,16,20,2,18,10,39,21,1
Jules Gaudin,FRA,DF,23,Paris FC,Ligue 2,33.3,67,52,45,20,2,43,81,53.1,38,40,10,30,55,122,82,3
Jules-Anthony Vilsaint,CAN,FW,20,CF Montréal,MLS,4.6,5,3,0,1,4,1,3,33.3,2,4,0,4,1,6,2,0
Julian Börner,GER,DF,32,Hannover 96,2. Bundesliga,1.6,1,0,1,0,0,1,1,100.0,0,0,0,0,2,3,8,0
Julian Gaines,USA,DF,20,LAFC,MLS,0.7,2,0,1,1,0,2,4,50.0,2,1,0,1,0,2,1,0
Julian Green,USA,MF,28,Greuther Fürth,2. Bundesliga,23.2,29,17,5,21,3,11,26,42.3,15,13,1,12,16,45,14,0
Julian Gressel,USA,"DF,MF",29,Crew,MLS,8.2,17,11,5,8,4,11,20,55.0,9,9,1,8,6,23,8,0
Julian Gressel,USA,MF,29,Vancouver W'caps,MLS,15.1,23,10,8,13,2,15,33,45.5,18,15,3,12,14,37,12,0
Julian Hall,USA,FW,14,NY Red Bulls,MLS,0.1,0,0,0,0,0,0,0,0.0,0,0,0,0,0,0,0,0
Julian Kania,ESP,FW,21,Nürnberg,2. Bundesliga,0.6,1,0,0,1,0,1,1,100.0,0,0,0,0,0,1,0,0
Julian Krahl,GER,GK,23,Kaiserslautern,2. Bundesliga,29.6,3,3,3,0,0,3,4,75.0,1,3,0,3,0,3,12,2
Julian Niehues,GER,MF,22,Kaiserslautern,2. Bundesliga,20.2,50,26,23,19,8,20,42,47.6,22,26,6,20,30,80,44,0
Julien Anziani,FRA,"MF,FW",24,Dunkerque,Ligue 2,27.4,47,26,23,19,5,22,63,34.9,41,26,5,21,23,70,51,0
Julien Celestine,FRA,DF,26,US Concarneau,Ligue 2,29.8,33,22,27,4,2,17,23,73.9,6,35,26,9,29,62,106,2
Julien Fabri,FRA,GK,29,Bastia,Ligue 2,4.0,0,0,0,0,0,0,0,0.0,0,0,0,0,0,0,3,0
Julien Faussurier,FRA,DF,36,US Concarneau,Ligue 2,23.4,33,17,16,15,2,23,45,51.1,22,27,6,21,18,51,34,1
Julien López,ALG,"FW,MF",31,Paris FC,Ligue 2,6.0,9,3,4,3,2,7,11,63.6,4,5,0,5,5,14,0,0
Julien Maggiotti,FRA,"MF,FW",27,Bastia,Ligue 2,4.5,3,3,0,3,0,2,6,33.3,4,1,0,1,2,5,4,0
Julien Masson,FRA,MF,25,Valenciennes,Ligue 2,27.8,75,46,36,32,7,41,76,53.9,35,28,7,21,41,116,30,1
Julien Vetro,FRA,"FW,MF",19,Bordeaux,Ligue 2,3.2,2,2,1,1,0,1,2,50.0,1,2,0,2,1,3,2,0
Julio Alonso,ESP,DF,25,Albacete,Segunda Division,23.6,61,31,31,23,7,30,52,57.7,22,31,6,25,20,81,39,0
Julio Cascante,CRC,DF,29,Austin,MLS,22.9,20,14,14,6,0,15,27,55.6,12,18,14,4,20,40,94,1
Julio Domínguez,MEX,DF,35,Atlético,Liga MX,31.2,33,19,21,10,2,19,26,73.1,7,43,34,9,27,60,118,1
Julio Furch,ARG,FW,34,Atlas,Liga MX,2.0,0,0,0,0,0,0,0,0.0,0,0,0,0,0,0,2,0
Julio José González,MEX,GK,32,UNAM,Liga MX,34.0,0,0,0,0,0,0,0,0.0,0,0,0,0,2,2,35,2
Julio Pleguezuelo,ESP,DF,26,Plymouth Argyle,EFL,22.0,25,17,17,7,1,14,30,46.7,16,26,15,11,32,57,90,1
Julius Kade,GER,MF,24,Wehen,2. Bundesliga,2.9,6,3,1,4,1,2,3,66.7,1,3,1,2,4,10,3,0
Julián Aude,ARG,DF,19,LA Galaxy,MLS,13.3,27,18,17,9,1,19,38,50.0,19,20,5,15,19,46,29,0
Julián Carranza,ARG,FW,22,Philadelphia,MLS,27.6,34,14,5,21,8,7,32,21.9,25,31,4,27,12,46,19,0
Julián Chicco,ARG,MF,26,Leganés,Segunda Division,16.3,30,18,9,19,2,19,42,45.2,23,20,4,16,19,49,20,0
Julián Delmás,ESP,DF,29,Racing Ferrol,Segunda Division,17.8,32,22,11,16,5,15,29,51.7,14,11,3,8,18,50,42,0
Julián Fernández,ARG,"FW,MF",19,NYCFC,MLS,3.6,7,5,2,5,0,6,12,50.0,6,10,0,10,2,9,0,0
Julián Quiñones,MEX,"FW,MF",26,América,Liga MX,22.3,11,9,4,2,5,4,8,50.0,4,18,4,14,9,20,9,0
Juninho,BRA,MF,22,Orlando City,MLS,0.0,0,0,0,0,0,0,0,0.0,0,0,0,0,0,0,0,0
Juninho Bacuna,CUW,"FW,MF",25,Birmingham City,EFL,33.0,66,42,26,29,11,30,64,46.9,34,50,8,42,28,94,47,0
Junior Diaz,CIV,DF,20,Annecy,Ligue 2,14.9,30,16,16,13,1,18,30,60.0,12,21,8,13,22,52,52,0
Junior Firpo,DOM,DF,26,Leeds United,EFL,19.8,59,41,25,23,11,41,58,70.7,17,25,5,20,25,84,40,0
Junior Hoilett,CAN,"FW,MF",32,Vancouver W'caps,MLS,2.6,3,2,0,1,2,2,4,50.0,2,2,0,2,3,6,0,0
Junior Kadile,FRA,"FW,MF",20,Stade Laval,Ligue 2,16.1,24,14,9,9,6,9,27,33.3,18,13,0,13,7,31,2,0
Junior Moreno,VEN,MF,29,FC Cincinnati,MLS,25.0,35,19,19,13,3,17,32,53.1,15,31,13,18,22,57,24,0
Junior Olaitan,BEN,"FW,MF",21,Troyes,Ligue 2,7.6,15,15,6,8,1,8,18,44.4,10,4,1,3,7,22,7,0
Junior Senneville,GLP,DF,32,Dunkerque,Ligue 2,0.4,2,2,1,1,0,2,2,100.0,0,0,0,0,0,2,0,0
Junior Tchamadeu,CMR,"DF,FW",19,Stoke City,EFL,9.7,18,12,12,5,1,7,10,70.0,3,11,1,10,13,31,6,0
Justen Glad,USA,DF,25,RSL,MLS,30.2,39,25,25,13,1,22,35,62.9,13,37,26,11,50,89,120,1
Justin Haak,USA,"DF,MF",21,NYCFC,MLS,10.1,11,8,7,4,0,7,12,58.3,5,9,4,5,20,31,36,2
Justin Heekeren,GER,GK,22,Schalke 04,2. Bundesliga,2.0,0,0,0,0,0,0,0,0.0,0,1,0,1,0,0,1,0
Justin Meram,IRQ,"FW,MF",34,RSL,MLS,2.0,10,9,5,5,0,7,11,63.6,4,2,1,1,4,14,5,0
Justin Meram,IRQ,"FW,MF",34,Charlotte,MLS,14.8,17,10,5,7,5,12,29,41.4,17,12,0,12,7,24,11,0
Justin Rasmussen,USA,DF,24,Portland Timbers,MLS,3.7,9,8,6,2,1,5,10,50.0,5,3,1,2,3,12,8,0
Justin Rennicks,USA,"FW,MF",23,NE Revolution,MLS,4.3,10,5,4,5,1,7,13,53.8,6,7,0,7,1,11,5,0
Justin-Noël Kalumba,FRA,"FW,MF",18,Angers,Ligue 2,7.9,10,4,4,6,0,5,12,41.7,7,7,1,6,6,16,1,1
Jáder Obrian,COL,"FW,MF",27,FC Dallas,MLS,21.0,23,10,9,12,2,10,42,23.8,32,18,0,18,13,36,7,0
Ján Greguš,SVK,MF,32,Minnesota Utd,MLS,10.0,10,7,1,9,0,5,10,50.0,5,3,0,3,8,18,10,0
Ján Greguš,SVK,MF,32,Nashville,MLS,2.5,15,9,10,5,0,7,13,53.8,6,2,0,2,4,19,1,0
Jérémie Broh,ITA,MF,26,Südtirol,Serie B,8.6,7,1,1,6,0,2,5,40.0,3,7,4,3,12,19,9,0
Jérémy Blasco,FRA,DF,25,Huesca,Segunda Division,24.7,22,15,17,4,1,15,24,62.5,9,36,24,12,18,40,120,0
Jérémy Gélin,FRA,MF,26,Amiens,Ligue 2,20.7,35,18,12,13,10,17,51,33.3,34,24,8,16,30,65,25,0
Jérémy Livolant,FRA,FW,25,Bordeaux,Ligue 2,25.6,24,18,11,11,2,10,28,35.7,18,17,1,16,9,33,13,0
Jérémy Mellot,FRA,DF,30,Tenerife,Segunda Division,31.9,95,68,69,21,5,50,80,62.5,30,37,12,25,54,149,103,0
Jérémy Ménez,FRA,"FW,MF",36,Bari,Serie B,4.2,6,4,1,2,3,3,5,60.0,2,5,1,4,1,7,4,0
Jérôme Gondorf,GER,MF,35,Karlsruher,2. Bundesliga,25.8,49,29,22,21,6,23,53,43.4,30,38,12,26,34,83,48,1
Júnior Brumado,BRA,FW,24,Hansa Rostock,2. Bundesliga,16.5,19,11,3,11,5,9,15,60.0,6,10,1,9,0,19,9,0
Júnior Urso,BRA,"MF,FW",33,Orlando City,MLS,2.8,5,3,2,3,0,3,5,60.0,2,2,0,2,2,7,5,0
Jürgen Damm,MEX,"FW,MF",30,Atlético,Liga MX,5.1,16,11,8,8,0,8,18,44.4,10,4,1,3,2,18,3,0
Jürgen Locadia,CUW,"FW,MF",30,Amorebieta,Segunda Division,0.6,0,0,0,0,0,0,1,0.0,1,0,0,0,0,0,0,0
Kaan Caliskaner,GER,"FW,MF",23,Braunschweig,2. Bundesliga,4.1,3,1,1,2,0,1,7,14.3,6,9,2,7,0,3,4,0
Kacper Przybyłko,POL,FW,29,Fire,MLS,10.8,6,3,1,4,1,3,5,60.0,2,10,3,7,3,9,15,0
Kai Andrews,WAL,MF,16,Coventry City,EFL,0.0,0,0,0,0,0,0,0,0.0,0,0,0,0,0,0,0,0
Kai Klefisch,GER,MF,23,Paderborn 07,2. Bundesliga,21.7,33,20,14,16,3,15,30,50.0,15,32,13,19,18,51,38,2
Kai Pröger,GER,"FW,MF",31,Hansa Rostock,2. Bundesliga,21.9,49,32,23,21,5,23,51,45.1,28,33,2,31,13,62,12,0
Kai Wagner,GER,DF,25,Philadelphia,MLS,27.1,60,39,31,23,6,36,63,57.1,27,47,17,30,46,106,30,0
Kaiky,BRA,DF,20,Albacete,Segunda Division,10.5,8,3,5,3,0,3,5,60.0,2,10,7,3,7,15,61,0
Kaine Kesler-Hayden,ENG,"DF,MF",20,Plymouth Argyle,EFL,19.0,29,15,20,7,2,14,26,53.8,12,25,14,11,29,58,45,0
Kal Naismith,SCO,DF,31,Bristol City,EFL,9.9,13,10,9,4,0,6,13,46.2,7,13,8,5,12,25,37,0
Kalidou Sidibé,FRA,MF,24,Guingamp,Ligue 2,21.0,22,13,8,10,4,9,13,69.2,4,20,9,11,20,42,28,0
Kalidou Sidibé,FRA,"MF,FW",24,Quevilly-Rouen,Ligue 2,2.6,4,0,0,4,0,2,4,50.0,2,4,0,4,0,4,2,0
Kalifa Coulibaly,MLI,FW,31,Quevilly-Rouen,Ligue 2,21.0,13,8,3,6,4,5,13,38.5,8,6,1,5,7,20,27,0
Kamal Miller,CAN,DF,25,Inter Miami,MLS,20.5,29,22,21,8,0,23,34,67.6,11,17,10,7,25,54,58,2
Kamal Miller,CAN,DF,25,CF Montréal,MLS,5.3,3,2,1,1,1,2,5,40.0,3,5,3,2,6,9,12,0
Kamaldeen Sulemana,GHA,"FW,MF",21,Southampton,EFL,10.6,12,10,10,2,0,6,12,50.0,6,6,0,6,6,18,1,1
Kamil Jóźwiak,POL,"FW,MF",24,Charlotte,MLS,15.3,38,25,12,23,3,20,53,37.7,33,23,1,22,8,46,15,0
Kandet Diawara,GUI,"FW,MF",23,US Concarneau,Ligue 2,10.7,10,2,0,8,2,1,7,14.3,6,10,0,10,2,12,2,0
Kanji Okunuki,JPN,"FW,MF",23,Nürnberg,2. Bundesliga,21.1,35,21,19,11,5,14,33,42.4,19,31,1,30,5,40,14,1
Kapitbafan Djoco,SEN,FW,27,Annecy,Ligue 2,12.6,13,9,4,8,1,4,13,30.8,9,11,2,9,3,16,6,0
Kapitbafan Djoco,SEN,"FW,MF",27,Bastia,Ligue 2,10.2,10,7,1,5,4,5,10,50.0,5,7,1,6,5,15,8,0
Karifa Yao,CAN,MF,22,Vancouver W'caps,MLS,0.0,0,0,0,0,0,0,0,0.0,0,0,0,0,0,0,0,0
Karim Cissé,GUI,"FW,MF",18,Saint-Étienne,Ligue 2,1.7,1,0,1,0,0,1,1,100.0,0,1,0,1,1,2,3,0
Karim Zedadka,FRA,DF,23,Ascoli,Serie B,12.0,23,17,10,11,2,12,22,54.5,10,9,1,8,15,38,23,0
Karl Darlow,ENG,GK,32,Leeds United,EFL,1.4,0,0,0,0,0,0,0,0.0,0,0,0,0,0,0,0,0
Karl-Johan Johnsson,SWE,GK,33,Bordeaux,Ligue 2,22.0,0,0,0,0,0,0,2,0.0,2,1,0,1,0,0,7,0
Karlan Grant,ENG,"FW,MF",25,Cardiff City,EFL,34.7,24,15,10,11,3,9,25,36.0,16,27,1,26,32,56,26,0
Karlo Butić,CRO,FW,24,FeralpiSalò,Serie B,18.9,9,5,2,5,2,0,4,0.0,4,11,3,8,8,17,20,0
Karlo Lulić,CRO,MF,27,Bari,Serie B,6.6,5,4,1,3,1,1,1,100.0,0,9,3,6,7,12,5,0
Karol Mets,EST,DF,30,St. Pauli,2. Bundesliga,31.8,21,10,9,11,1,12,18,66.7,6,26,10,16,28,49,97,0
Karol Niemczycki,POL,GK,24,Düsseldorf,2. Bundesliga,1.0,0,0,0,0,0,0,1,0.0,1,0,0,0,0,0,1,0
Karol Świderski,POL,"FW,MF",26,Charlotte,MLS,26.8,16,10,1,8,7,9,28,32.1,19,25,3,22,6,22,14,0
Kasey McAteer,ENG,FW,21,Leicester City,EFL,12.9,24,13,12,6,6,10,23,43.5,13,9,3,6,6,30,17,1
Kasey Palmer,JAM,"MF,FW",26,Coventry City,EFL,19.9,40,25,6,24,10,14,38,36.8,24,31,1,30,8,48,15,0
Kassoum Ouattara,FRA,DF,18,Amiens,Ligue 2,9.7,18,12,7,7,4,7,16,43.8,9,14,3,11,15,33,26,0
Kayden Jackson,ENG,FW,29,Ipswich Town,EFL,10.7,16,7,4,7,5,5,19,26.3,14,13,0,13,8,24,9,0
Kayden Pierre,USA,DF,19,Sporting KC,MLS,0.1,0,0,0,0,0,0,0,0.0,0,0,0,0,0,0,0,0
Kayne Bonnevie,FRA,GK,22,Quevilly-Rouen,Ligue 2,2.0,0,0,0,0,0,0,0,0.0,0,0,0,0,0,0,0,0
Keanan Bennetts,ENG,"DF,FW",24,Wehen,2. Bundesliga,3.8,10,7,4,5,1,8,8,100.0,0,2,0,2,6,16,6,0
Keaton Parks,USA,MF,25,NYCFC,MLS,27.9,51,27,22,25,4,24,48,50.0,24,33,10,23,22,73,42,0
Keegan Hughes,USA,DF,22,Crew,MLS,0.0,0,0,0,0,0,0,0,0.0,0,0,0,0,0,0,0,0
Keegan Rosenberry,USA,DF,29,Rapids,MLS,25.2,32,24,12,16,4,21,38,55.3,17,24,13,11,46,78,54,0
Kees De Boer,NED,MF,23,Ternana,Serie B,13.2,12,7,6,6,0,8,16,50.0,8,9,4,5,17,29,18,1
Kei Kamara,SLE,FW,38,Fire,MLS,16.9,6,1,0,3,3,2,9,22.2,7,14,4,10,4,10,29,0
Keidi Bare,ALB,MF,26,Espanyol,Segunda Division,21.5,34,17,13,18,3,15,23,65.2,8,27,4,23,22,56,22,0
Keita Baldé,SEN,"FW,MF",29,Espanyol,Segunda Division,5.2,8,6,2,4,2,3,4,75.0,1,10,0,10,1,9,3,1
Keita Endo,JPN,"MF,DF",25,Braunschweig,2. Bundesliga,2.8,7,5,3,2,2,4,8,50.0,4,5,2,3,2,9,7,0
Keke Maximilian Topp,GER,FW,19,Schalke 04,2. Bundesliga,12.1,13,10,1,6,6,3,6,50.0,3,6,0,6,2,15,3,0
Kelechi Iheanacho,NGA,FW,26,Leicester City,EFL,10.2,5,1,1,2,2,3,5,60.0,2,9,0,9,3,8,2,0
Kellen Fisher,ENG,DF,19,Norwich City,EFL,2.9,8,5,6,1,1,5,7,71.4,2,8,4,4,3,11,8,0
Kellyn Acosta,USA,MF,27,LAFC,MLS,16.6,34,20,13,15,6,17,33,51.5,16,22,2,20,18,52,11,0
Kelvin Amian,FRA,DF,25,Spezia,Serie B,19.0,42,30,32,9,1,16,21,76.2,5,26,15,11,23,65,52,1
Kelvin Leerdam,SUR,DF,32,LA Galaxy,MLS,13.4,13,6,8,3,2,10,15,66.7,5,10,6,4,9,22,63,0
Kelyn Rowe,USA,DF,31,Seattle,MLS,3.8,11,10,7,4,0,9,15,60.0,6,1,0,1,9,20,3,0
Kemar Lawrence,JAM,DF,30,Minnesota Utd,MLS,12.4,17,13,10,5,2,10,13,76.9,3,16,7,9,16,33,27,0
Ken Aboh,ENG,MF,18,Norwich City,EFL,0.1,1,1,1,0,0,0,0,0.0,0,0,0,0,0,1,0,0
Ken Sema,SWE,"FW,MF",29,Watford,EFL,22.3,33,22,15,14,4,22,32,68.8,10,31,2,29,12,45,13,1
Kenan Karaman,TUR,"MF,FW",29,Schalke 04,2. Bundesliga,26.0,17,11,6,8,3,4,7,57.1,3,21,3,18,3,20,18,0
Kendall Burks,USA,"DF,MF",23,Fire,MLS,5.7,8,5,7,1,0,3,6,50.0,3,10,7,3,6,14,26,0
Kendall McIntosh,USA,GK,29,Sporting KC,MLS,13.2,0,0,0,0,0,0,1,0.0,1,1,0,1,0,0,4,0
Kenedy,BRA,"FW,MF",28,Valladolid,Segunda Division,15.6,18,13,5,8,5,10,18,55.6,8,13,0,13,21,39,4,0
Kenji-Van Boto,MAD,DF,27,Pau FC,Ligue 2,18.7,26,16,15,10,1,12,26,46.2,14,17,8,9,22,48,36,0
Kenneth,ESP,MF,23,Espanyol,Segunda Division,0.1,0,0,0,0,0,0,0,0.0,0,0,0,0,0,0,0,0
Kenneth Paal,SUR,DF,26,QPR,EFL,42.2,85,50,50,26,9,49,85,57.6,36,45,12,33,47,132,99,1
Kenny McLean,SCO,"MF,DF",31,Norwich City,EFL,45.4,90,52,41,43,6,41,85,48.2,44,56,25,31,54,144,72,1
Kenny Redondo,GER,"FW,MF",28,Kaiserslautern,2. Bundesliga,16.4,20,10,7,10,3,5,17,29.4,12,19,4,15,9,29,19,1
Kento Hashimoto,JPN,MF,30,Huesca,Segunda Division,20.4,59,36,22,35,2,26,49,53.1,23,24,5,19,41,100,32,0
Kerim Calhanoglu,GER,"DF,MF",20,Greuther Fürth,2. Bundesliga,3.6,13,9,8,2,3,8,12,66.7,4,7,1,6,4,17,10,0
Kervin Arriaga,HON,MF,25,Minnesota Utd,MLS,13.0,16,10,7,9,0,5,19,26.3,14,14,5,9,14,30,29,3
Kerwin Vargas,COL,"FW,MF",21,Charlotte,MLS,16.5,8,7,2,3,3,2,14,14.3,12,18,0,18,20,28,14,0
Keshi Anderson,ENG,"FW,MF",28,Birmingham City,EFL,11.3,14,7,7,4,3,5,14,35.7,9,12,0,12,7,21,12,0
Kevin Balanta,COL,DF,26,Tijuana,Liga MX,29.5,58,35,36,22,0,21,35,60.0,14,27,21,6,44,102,100,1
Kevin Cabral,FRA,"FW,MF",23,Rapids,MLS,13.1,21,11,5,12,4,4,10,40.0,6,11,1,10,9,30,6,0
Kevin Castañeda,MEX,MF,23,Tijuana,Liga MX,15.5,28,16,6,16,6,10,22,45.5,12,11,2,9,9,37,2,0
Kevin Castaño,COL,MF,22,Cruz Azul,Liga MX,8.5,15,10,8,5,2,7,20,35.0,13,7,1,6,5,20,6,1
Kevin Conrad,GER,DF,32,Elversberg,2. Bundesliga,8.0,11,8,8,2,1,8,11,72.7,3,12,9,3,11,22,35,2
Kevin Escamilla,MEX,MF,29,Querétaro,Liga MX,29.6,50,28,16,32,2,31,62,50.0,31,37,15,22,39,89,64,1
Kevin Farade,FRA,FW,27,Annecy,Ligue 2,0.2,0,0,0,0,0,0,0,0.0,0,1,0,1,0,0,0,0
Kevin Haveri,ALB,"DF,FW",21,Ascoli,Serie B,0.6,1,1,0,1,0,1,1,100.0,0,0,0,0,0,1,1,0
Kevin Kraus,GER,DF,30,Kaiserslautern,2. Bundesliga,14.5,15,11,12,2,1,7,16,43.8,9,19,10,9,15,30,67,0
Kevin Long,IRL,DF,32,Birmingham City,EFL,16.1,22,15,15,7,0,11,14,78.6,3,25,16,9,8,30,96,0
Kevin Mier,COL,GK,23,Cruz Azul,Liga MX,17.0,2,2,2,0,0,2,3,66.7,1,0,0,0,0,2,8,0
Kevin Miranda,ITA,DF,20,Catanzaro,Serie B,2.9,6,4,3,3,0,3,4,75.0,1,3,1,2,8,14,15,0
Kevin Molino,TRI,"MF,FW",32,Crew,MLS,0.7,4,3,2,1,1,1,1,100.0,0,2,0,2,0,4,0,0
Kevin Mouanga,FRA,DF,23,Annecy,Ligue 2,16.2,19,11,13,5,1,7,12,58.3,5,17,9,8,26,45,60,0
Kevin Nisbet,SCO,FW,26,Millwall,EFL,15.5,7,7,1,5,1,2,7,28.6,5,8,1,7,3,10,7,0
Kevin O'Toole,USA,"DF,MF",24,NYCFC,MLS,13.3,22,14,15,4,3,18,33,54.5,15,23,7,16,14,36,34,0
Kevin Ortega,MEX,DF,21,Atlético,Liga MX,0.1,0,0,0,0,0,0,0,0.0,0,0,0,0,0,0,0,0
Kevin Ortega,MEX,"MF,FW",21,Monterrey,Liga MX,0.2,2,1,1,0,1,1,2,50.0,1,0,0,0,0,2,0,0
Kevin Schumacher,GER,"DF,MF",25,Hansa Rostock,2. Bundesliga,20.1,38,17,20,15,3,21,46,45.7,25,28,7,21,22,60,64,0
Kevin Tapoko,FRA,MF,29,Stade Laval,Ligue 2,1.2,4,3,1,3,0,2,3,66.7,1,1,0,1,2,6,1,0
Kevin Testud,FRA,"FW,MF",31,Annecy,Ligue 2,8.1,19,13,7,7,5,3,14,21.4,11,16,4,12,6,25,11,0
Kevin Velasco,COL,MF,26,Puebla,Liga MX,26.1,37,21,17,14,6,9,32,28.1,23,16,0,16,15,52,8,0
Kevin Vinetot,FRA,DF,35,Südtirol,Serie B,11.5,8,7,5,3,0,5,7,71.4,2,13,8,5,11,19,41,1
Kevin Álvarez,MEX,DF,24,América,Liga MX,21.7,44,24,26,10,8,25,45,55.6,20,21,4,17,18,62,45,2
Kevon Lambert,JAM,DF,25,RSL,MLS,0.3,1,0,0,0,1,0,0,0.0,0,0,0,0,1,2,3,0
Khalid Boutaïb,MAR,FW,36,Pau FC,Ligue 2,21.8,42,21,14,21,7,14,42,33.3,28,26,4,22,10,52,30,0
Khiry Shelton,USA,"FW,MF",29,Sporting KC,MLS,9.4,8,5,1,6,1,2,6,33.3,4,5,0,5,16,24,10,0
Ki-Jana Hoever,NED,DF,21,Stoke City,EFL,34.1,92,65,50,31,11,61,87,70.1,26,26,7,19,70,162,84,2
Kian Best,ENG,DF,17,Preston,EFL,7.7,19,9,6,10,3,12,25,48.0,13,12,1,11,5,24,4,0
Kian Harratt,ENG,FW,21,Huddersfield,EFL,5.5,3,1,0,2,1,1,2,50.0,1,3,0,3,0,3,4,0
Kianz Froese,CAN,"MF,FW",27,Wehen,2. Bundesliga,8.7,9,6,2,4,3,0,6,0.0,6,8,0,8,0,9,7,0
Kieffer Moore,WAL,FW,30,Ipswich Town,EFL,12.7,11,7,0,7,4,4,8,50.0,4,9,4,5,3,14,15,0
Kiernan Dewsbury-Hall,ENG,MF,24,Leicester City,EFL,40.4,46,29,18,24,4,23,38,60.5,15,40,4,36,17,63,32,1
Kiko Olivas,ESP,DF,35,Cartagena,Segunda Division,16.8,33,23,24,9,0,22,31,71.0,9,21,13,8,26,59,74,1
Killian Corredor,FRA,FW,22,Rodez Aveyron,Ligue 2,35.2,16,7,1,7,8,6,20,30.0,14,13,1,12,4,20,20,0
Kimberly Ezekwem,GER,DF,22,Paderborn 07,2. Bundesliga,4.5,8,3,8,0,0,5,7,71.4,2,3,1,2,3,11,12,0
King Manu,GER,"DF,MF",19,Düsseldorf,2. Bundesliga,0.2,0,0,0,0,0,0,2,0.0,2,1,1,0,1,1,2,0
Kion Etete,ENG,FW,21,Cardiff City,EFL,12.1,13,6,3,8,2,4,10,40.0,6,19,0,19,10,23,19,0
Kipp Keller,USA,DF,22,Austin,MLS,4.9,1,1,1,0,0,0,3,0.0,3,4,3,1,0,1,19,1
Klaus Suso,GER,"DF,MF",18,Düsseldorf,2. Bundesliga,0.4,4,3,3,1,0,1,2,50.0,1,0,0,0,1,5,1,0
Klauss,BRA,FW,25,St. Louis,MLS,14.6,15,7,3,8,4,4,20,20.0,16,9,2,7,7,22,20,0
Kleis Bozhanaj,ALB,"MF,FW",22,Modena,Serie B,7.0,7,4,1,5,1,4,8,50.0,4,8,0,8,5,12,4,0
Kobe Franklin,CAN,"DF,MF",19,Toronto FC,MLS,24.1,55,32,30,19,6,37,61,60.7,24,29,9,20,31,86,67,1
Koen Kostons,NED,"FW,MF",23,Paderborn 07,2. Bundesliga,13.5,7,3,3,2,2,3,7,42.9,4,7,1,6,2,9,7,0
Koffi,CIV,"FW,MF",37,Elversberg,2. Bundesliga,1.4,3,2,1,1,1,2,4,50.0,2,0,0,0,3,6,3,0
Koji Miyoshi,JPN,"FW,MF",26,Birmingham City,EFL,27.7,35,26,15,16,4,17,49,34.7,32,36,7,29,22,57,15,0
Koldo Obieta,ESP,FW,30,Alcorcón,Segunda Division,10.1,6,2,0,2,4,1,5,20.0,4,6,2,4,2,8,12,0
Kolja Oudenne,SWE,MF,21,Hannover 96,2. Bundesliga,6.2,11,5,4,4,3,3,5,60.0,2,12,0,12,2,13,3,0
Konrad De La Fuente,USA,"FW,MF",22,Eibar,Segunda Division,4.1,9,4,7,1,1,5,7,71.4,2,7,0,7,2,11,4,0
Kosi Thompson,CAN,"MF,FW",20,Toronto FC,MLS,6.5,12,6,7,3,2,3,7,42.9,4,13,3,10,11,23,11,0
Kostas Stafylidis,GRE,"DF,MF",29,Hansa Rostock,2. Bundesliga,6.5,13,7,10,3,0,9,11,81.8,2,5,4,1,18,31,23,0
Kouadio-Yves Dabila,CIV,DF,26,Paris FC,Ligue 2,28.2,51,27,26,21,4,27,37,73.0,10,14,4,10,21,72,62,0
Kouadou Assoumou,FRA,FW,20,Troyes,Ligue 2,11.3,13,11,3,6,4,1,9,11.1,8,17,5,12,9,22,6,1
Kristian Fletcher,USA,"FW,MF",17,D.C. United,MLS,1.5,2,2,0,2,0,1,5,20.0,4,0,0,0,0,2,0,0
Kristian Pedersen,DEN,"DF,FW",28,Sheffield Weds,EFL,1.5,3,2,2,1,0,1,3,33.3,2,3,0,3,1,4,5,0
Kristian Pedersen,DEN,DF,28,Swansea City,EFL,3.2,7,5,4,3,0,6,11,54.5,5,6,1,5,8,15,6,0
Kristijan Kahlina,CRO,GK,30,Charlotte,MLS,24.0,2,1,2,0,0,2,4,50.0,2,0,0,0,0,2,16,1
Kristoffer Askildsen,NOR,"MF,FW",22,Sampdoria,Serie B,5.5,14,8,7,6,1,5,10,50.0,5,12,3,9,8,22,14,0
Kristoffer Klaesson,NOR,GK,22,Leeds United,EFL,1.0,0,0,0,0,0,0,0,0.0,0,0,0,0,0,0,0,0
Krystian Bielik,POL,"MF,DF",25,Birmingham City,EFL,33.1,53,29,30,19,4,25,58,43.1,33,55,19,36,59,112,93,2
Kwadwo Opoku,GHA,FW,21,LAFC,MLS,13.1,13,8,2,8,3,8,20,40.0,12,11,2,9,2,15,5,0
Kwadwo Opoku,GHA,FW,21,CF Montréal,MLS,10.3,6,3,2,2,2,2,8,25.0,6,6,0,6,5,11,2,0
Kwasi Okyere Wriedt,GHA,FW,29,Osnabrück,2. Bundesliga,7.9,2,0,0,1,1,0,3,0.0,3,8,1,7,0,2,3,0
Kwasi Sibo,GHA,MF,25,Amorebieta,Segunda Division,34.9,79,49,25,51,3,48,76,63.2,28,37,8,29,37,116,58,0
Kyle Bartley,ENG,DF,32,West Brom,EFL,29.0,17,11,10,6,1,6,14,42.9,8,24,14,10,24,41,130,0
Kyle Duncan,USA,DF,25,NY Red Bulls,MLS,20.5,54,38,21,19,14,37,54,68.5,17,37,4,33,30,84,32,0
Kyle Hiebert,CAN,DF,25,St. Louis,MLS,23.6,45,24,22,18,5,27,43,62.8,16,41,13,28,29,74,95,0
Kyle Hudlin,ENG,FW,23,Huddersfield,EFL,3.1,2,1,1,1,0,0,1,0.0,1,4,0,4,2,4,4,0
Kyle McFadzean,SCO,DF,36,Coventry City,EFL,14.3,12,8,8,3,1,7,12,58.3,5,14,11,3,22,34,51,1
Kyle McFadzean,SCO,DF,36,Blackburn,EFL,10.0,9,8,7,2,0,5,9,55.6,4,14,4,10,15,24,34,0
Kyle Naughton,ENG,DF,34,Swansea City,EFL,8.5,21,12,10,10,1,13,20,65.0,7,16,3,13,13,34,12,0
Kyle Smith,USA,DF,31,Orlando City,MLS,16.6,35,20,26,6,3,20,43,46.5,23,11,2,9,16,51,45,0
Kyle Walker-Peters,ENG,DF,26,Southampton,EFL,42.9,74,52,29,30,15,33,51,64.7,18,37,8,29,49,123,64,1
Kylian Kaïboué,FRA,"MF,DF",24,Amiens,Ligue 2,26.0,93,57,42,36,15,46,88,52.3,42,39,10,29,23,116,51,0
Kyliane Dong,FRA,"FW,MF",18,Troyes,Ligue 2,23.6,22,11,12,7,3,12,26,46.2,14,18,0,18,17,39,10,0
Kévin Appin,MTQ,"MF,FW",26,Burgos,Segunda Division,16.1,38,26,6,27,5,14,37,37.8,23,24,1,23,13,51,35,0
Kévin Boma,TOG,DF,20,Rodez Aveyron,Ligue 2,11.6,26,16,18,8,0,9,16,56.3,7,16,8,8,27,53,52,0
Kévin Danois,FRA,"MF,FW",19,Auxerre,Ligue 2,0.5,5,3,1,3,1,3,3,100.0,0,0,0,0,1,6,0,0
Kévin Van Den Kerkhof,ALG,DF,27,Bastia,Ligue 2,3.0,5,4,2,2,1,4,8,50.0,4,1,0,1,3,8,6,0
Lago Junior,CIV,"FW,MF",33,Racing Sant,Segunda Division,12.4,14,8,6,6,2,4,7,57.1,3,11,1,10,5,19,13,1
Lalas Abubakar,GHA,DF,28,Rapids,MLS,21.3,22,11,17,5,0,13,18,72.2,5,23,17,6,34,56,61,2
Lalo Aguilar,ESP,"DF,MF",22,Leganés,Segunda Division,0.2,0,0,0,0,0,0,0,0.0,0,1,1,0,0,0,0,0
Lamine Diaby,FRA,MF,26,Sheffield Weds,EFL,2.9,8,3,4,3,1,5,12,41.7,7,5,2,3,5,13,5,0
Lamine Fomba,FRA,MF,25,Saint-Étienne,Ligue 2,13.3,26,15,8,13,5,11,28,39.3,17,23,3,20,17,43,22,0
Lamine Gueye,SEN,"MF,DF",25,Paris FC,Ligue 2,0.6,2,1,1,0,1,1,1,100.0,0,0,0,0,1,3,0,0
Lanchi,ESP,"DF,MF",22,Villarreal B,Segunda Division,19.2,39,27,24,13,2,25,45,55.6,20,16,5,11,16,55,49,1
Lancinet Kourouma,ESP,MF,20,Levante,Segunda Division,0.2,0,0,0,0,0,0,0,0.0,0,0,0,0,0,0,0,0
Lander Olaetxea,ESP,"MF,DF",31,Albacete,Segunda Division,34.0,81,52,35,38,8,46,89,51.7,43,39,19,20,52,133,71,0
Landry Dimata,BEL,"FW,MF",26,Espanyol,Segunda Division,0.5,1,0,0,1,0,1,1,100.0,0,0,0,0,0,1,2,0
Laorent Shabani,SWE,"MF,FW",24,FC Andorra,Segunda Division,1.4,1,0,0,0,1,0,0,0.0,0,2,0,2,0,1,0,0
Larrys Mabiala,COD,DF,35,Portland Timbers,MLS,9.8,13,8,10,3,0,9,16,56.3,7,12,7,5,11,24,40,0
Lars Gindorf,GER,"MF,FW",21,Hannover 96,2. Bundesliga,4.6,5,2,1,3,1,2,8,25.0,6,5,0,5,0,5,0,0
Lars Kehl,GER,"MF,FW",21,Osnabrück,2. Bundesliga,3.1,6,4,5,1,0,4,6,66.7,2,1,1,0,2,8,4,0
Lars Ritzka,GER,"MF,DF",25,St. Pauli,2. Bundesliga,16.7,31,19,10,10,11,14,27,51.9,13,24,1,23,13,44,29,0
Lars Stindl,GER,"MF,FW",34,Karlsruher,2. Bundesliga,16.8,12,9,0,7,5,3,12,25.0,9,19,1,18,9,21,4,0
Lassana Diabaté,MLI,GK,19,Valenciennes,Ligue 2,7.0,0,0,0,0,0,0,0,0.0,0,0,0,0,0,0,2,1
Lasse Günther,GER,"DF,MF",20,Wehen,2. Bundesliga,11.5,28,20,19,8,1,17,24,70.8,7,15,1,14,10,38,30,1
Lasse Rosenboom,GER,"MF,DF",21,Holstein Kiel,2. Bundesliga,3.6,8,5,6,1,1,5,6,83.3,1,5,3,2,3,11,20,0
Lassi Lappalainen,FIN,"DF,FW",24,CF Montréal,MLS,11.5,19,14,6,10,3,10,25,40.0,15,17,0,17,8,27,12,0
Lassine Sinayoko,MLI,FW,23,Auxerre,Ligue 2,22.9,30,14,9,13,8,15,27,55.6,12,19,1,18,26,56,23,0
Latif Blessing,GHA,"FW,MF",26,Toronto FC,MLS,1.7,2,1,1,1,0,1,1,100.0,0,2,0,2,0,2,0,0
Latif Blessing,GHA,MF,26,NE Revolution,MLS,11.5,36,20,17,17,2,15,36,41.7,21,15,3,12,14,50,7,1
Laurens Serpe,ITA,DF,22,Spezia,Serie B,1.0,0,0,0,0,0,0,2,0.0,2,0,0,0,1,1,3,0
Laurin Curda,GER,DF,21,Paderborn 07,2. Bundesliga,15.8,26,17,11,12,3,10,19,52.6,9,14,6,8,18,44,49,0
Lautaro Blanco,ARG,"DF,MF",25,Elche,Segunda Division,3.7,7,3,6,1,0,4,8,50.0,4,2,1,1,2,9,6,1
Lautaro Valenti,ARG,DF,24,Parma,Serie B,1.8,0,0,0,0,0,0,3,0.0,3,2,2,0,1,1,2,0
Lauti,URU,"FW,MF",23,Cartagena,Segunda Division,4.4,4,3,0,3,1,1,5,20.0,4,4,0,4,1,5,1,0
Lauti,URU,"FW,MF",23,CD Mirandés,Segunda Division,3.5,4,2,1,1,2,2,3,66.7,1,6,1,5,0,4,0,0
Law McCabe,ENG,MF,17,Middlesbrough,EFL,1.1,1,1,0,1,0,1,3,33.3,2,0,0,0,2,3,1,0
Lawson Sunderland,USA,"MF,FW",21,Inter Miami,MLS,0.7,4,2,0,3,1,1,2,50.0,1,0,0,0,0,4,2,0
Layton Stewart,ENG,"FW,MF",20,Preston,EFL,2.5,5,4,1,3,1,0,1,0.0,1,0,0,0,0,5,0,0
Lazar Stefanovic,CAN,DF,16,Toronto FC,MLS,0.9,1,0,1,0,0,1,2,50.0,1,0,0,0,2,3,8,1
Leander Popp,GER,"FW,MF",18,Greuther Fürth,2. Bundesliga,0.4,0,0,0,0,0,0,0,0.0,0,1,0,1,0,0,0,0
Leandro Cabrera,URU,DF,33,Espanyol,Segunda Division,34.4,52,31,32,18,2,28,42,66.7,14,40,17,23,34,86,124,2
Leandro Chichizola,ARG,GK,33,Parma,Serie B,36.1,0,0,0,0,0,0,1,0.0,1,0,0,0,1,1,17,5
Lebogang Phiri,RSA,"MF,FW",28,Guingamp,Ligue 2,1.8,4,1,1,2,1,4,6,66.7,2,1,1,0,1,5,0,0
Lee Buchanan,ENG,DF,22,Birmingham City,EFL,30.3,78,54,41,27,10,48,78,61.5,30,57,20,37,48,126,126,0
Lee Evans,WAL,MF,29,Ipswich Town,EFL,0.7,1,1,1,0,0,1,1,100.0,0,1,1,0,1,2,5,0
Lee Gregory,ENG,"FW,MF",34,Sheffield Weds,EFL,7.9,8,6,4,1,3,2,11,18.2,9,10,2,8,2,10,9,0
Lee Hyunju,KOR,"MF,FW",20,Wehen,2. Bundesliga,16.9,21,12,7,13,1,4,14,28.6,10,8,1,7,10,31,6,1
Lee Nicholls,ENG,GK,30,Huddersfield,EFL,36.7,0,0,0,0,0,0,0,0.0,0,0,0,0,0,0,18,1
Lee Peltier,ENG,DF,36,Rotherham Utd,EFL,20.3,43,26,29,11,3,22,27,81.5,5,21,17,4,16,59,103,1
Leif Davis,ENG,DF,23,Ipswich Town,EFL,42.0,76,57,43,26,7,53,81,65.4,28,44,11,33,45,121,66,0
Lennart Grill,GER,GK,24,Osnabrück,2. Bundesliga,15.0,1,1,1,0,0,1,1,100.0,0,0,0,0,1,2,6,1
Lenny Joseph,FRA,FW,22,Grenoble,Ligue 2,29.9,59,34,24,23,12,22,43,51.2,21,27,4,23,34,93,25,0
Lenny Pirringuel,BEN,"MF,FW",19,Pau FC,Ligue 2,1.3,1,0,1,0,0,0,1,0.0,1,0,0,0,1,2,0,0
Lenny Vallier,FRA,DF,24,Guingamp,Ligue 2,4.2,12,4,5,6,1,9,13,69.2,4,7,1,6,6,18,6,0
Leo Fuhr Hjelde,NOR,DF,19,Sunderland,EFL,9.5,15,11,6,6,3,6,11,54.5,5,13,5,8,7,22,30,0
Leo Fuhr Hjelde,NOR,DF,19,Leeds United,EFL,0.5,0,0,0,0,0,0,0,0.0,0,2,0,2,0,0,3,0
Leo Väisänen,FIN,DF,25,Austin,MLS,19.6,18,7,13,5,0,12,23,52.2,11,28,24,4,22,40,70,1
Leo Štulac,SVN,MF,28,Palermo,Serie B,11.5,19,11,4,11,4,11,17,64.7,6,14,4,10,8,27,15,0
Leon Bell Bell,CMR,"DF,MF",26,Magdeburg,2. Bundesliga,25.9,44,30,32,10,2,23,57,40.4,34,20,2,18,20,64,48,0
Leon Flach,USA,MF,21,Philadelphia,MLS,19.9,35,19,12,19,4,15,39,38.5,24,28,6,22,32,67,22,0
Leon Jensen,GER,MF,26,Karlsruher,2. Bundesliga,16.2,41,28,20,18,3,21,46,45.7,25,16,3,13,20,61,24,1
Leon Schaffran,GER,GK,25,Greuther Fürth,2. Bundesliga,0.0,0,0,0,0,0,0,0,0.0,0,0,0,0,0,0,0,0
Leonardo Benedetti,ITA,MF,23,Sampdoria,Serie B,6.1,8,7,4,3,1,4,9,44.4,5,18,1,17,6,14,8,0
Leonardo Campana,ECU,FW,22,Inter Miami,MLS,18.2,19,13,4,9,6,9,18,50.0,9,19,7,12,4,23,13,0
Leonardo Loria,ITA,GK,24,Pisa,Serie B,7.0,0,0,0,0,0,0,0,0.0,0,0,0,0,0,0,4,0
Leonardo Mancuso,ITA,"FW,MF",31,Palermo,Serie B,10.3,6,2,0,4,2,2,9,22.2,7,7,1,6,2,8,8,0
Leonardo Marson,ITA,GK,25,Cosenza,Serie B,1.4,0,0,0,0,0,0,0,0.0,0,0,0,0,0,0,2,0
Leonardo Román,ESP,GK,23,Oviedo,Segunda Division,42.0,0,0,0,0,0,0,1,0.0,1,0,0,0,0,0,17,1
Leonardo Sepulveda,USA,DF,22,Guadalajara,Liga MX,4.6,11,7,7,4,0,5,10,50.0,5,4,2,2,4,15,12,0
Leonardo Sernicola,ITA,DF,26,Cremonese,Serie B,30.5,31,22,18,6,7,22,27,81.5,5,22,1,21,29,60,58,0
Leonardo Suárez,ARG,"FW,MF",27,UNAM,Liga MX,7.4,11,10,4,6,1,4,9,44.4,5,5,0,5,5,16,3,0
Leonardo Suárez,ARG,"FW,MF",27,América,Liga MX,7.2,14,9,5,4,5,7,13,53.8,6,5,2,3,5,19,4,0
Leonel Prieto,MEX,MF,21,UANL,Liga MX,0.2,1,0,0,1,0,0,0,0.0,0,1,0,1,0,1,0,0
Leopold Wahlstedt,SWE,GK,24,Blackburn,EFL,20.3,1,1,1,0,0,1,1,100.0,0,0,0,0,0,1,13,2
Levin Öztunalı,GER,"FW,MF",27,Hamburger SV,2. Bundesliga,7.3,2,1,1,1,0,0,2,0.0,2,7,3,4,4,6,6,0
Levonte Johnson,CAN,"FW,DF",23,Vancouver W'caps,MLS,2.2,4,3,4,0,0,0,3,0.0,3,2,0,2,1,5,2,0
Lewie Coyle,ENG,DF,27,Hull City,EFL,34.4,39,22,25,12,2,25,37,67.6,12,36,18,18,41,80,116,2
Lewis Baker,ENG,MF,28,Stoke City,EFL,11.9,13,11,5,6,2,4,11,36.4,7,10,4,6,5,18,10,0
Lewis Gibson,ENG,DF,23,Plymouth Argyle,EFL,39.7,52,35,40,11,1,29,39,74.4,10,76,53,23,33,85,201,0
Lewis Holtby,GER,MF,32,Holstein Kiel,2. Bundesliga,25.1,55,39,19,24,12,22,44,50.0,22,42,2,40,29,84,31,1
Lewis Morgan,SCO,"MF,FW",26,NY Red Bulls,MLS,3.3,1,1,0,1,0,0,1,0.0,1,5,0,5,1,2,3,0
Lewis O'Brien,ENG,MF,24,D.C. United,MLS,16.8,38,21,12,20,6,19,49,38.8,30,21,6,15,17,55,13,2
Lewis O'Brien,ENG,MF,24,Middlesbrough,EFL,17.5,40,24,15,19,6,16,32,50.0,16,28,9,19,17,57,24,0
Lewis Travis,ENG,"MF,DF",25,Blackburn,EFL,13.2,40,25,13,21,6,18,38,47.4,20,20,9,11,23,63,13,0
Lewis Travis,ENG,MF,25,Ipswich Town,EFL,3.7,18,13,6,9,3,6,12,50.0,6,4,1,3,3,21,4,0
Lewis Warrington,ENG,MF,20,Plymouth Argyle,EFL,0.6,0,0,0,0,0,0,0,0.0,0,0,0,0,0,0,1,0
Lex Lobinger,GER,FW,24,Osnabrück,2. Bundesliga,3.0,2,2,1,1,0,1,2,50.0,1,2,0,2,0,2,3,0
Lex Lobinger,GER,"FW,MF",24,Kaiserslautern,2. Bundesliga,1.2,0,0,0,0,0,0,1,0.0,1,1,1,0,0,0,2,0
Liam Cooper,SCO,DF,31,Leeds United,EFL,7.8,10,8,6,4,0,7,11,63.6,4,12,7,5,14,24,29,0
Liam Cullen,WAL,"FW,MF",24,Swansea City,EFL,26.4,32,17,9,17,6,17,37,45.9,20,24,5,19,11,43,38,1
Liam Delap,ENG,FW,20,Hull City,EFL,24.5,15,7,7,5,3,6,19,31.6,13,10,1,9,6,21,12,0
Liam Fraser,CAN,MF,24,FC Dallas,MLS,4.1,6,5,1,2,3,4,7,57.1,3,6,3,3,6,12,4,0
Liam Gibbs,ENG,"MF,FW",20,Norwich City,EFL,6.2,10,6,3,4,3,2,5,40.0,3,6,1,5,3,13,4,0
Liam Henderson,SCO,MF,27,Palermo,Serie B,13.5,17,9,3,9,5,7,16,43.8,9,8,0,8,8,25,14,0
Liam Kelly,SCO,MF,33,Coventry City,EFL,9.9,29,15,14,14,1,14,25,56.0,11,11,4,7,10,39,14,0
Liam Kerrigan,IRL,"MF,DF",23,Como,Serie B,1.7,4,4,1,1,2,0,1,0.0,1,4,1,3,2,6,2,0
Liam Kitching,ENG,DF,23,Coventry City,EFL,24.8,32,16,23,8,1,15,33,45.5,18,30,20,10,35,67,100,1
Liam Lindsay,SCO,DF,27,Preston,EFL,45.7,62,48,37,21,4,35,54,64.8,19,80,56,24,70,132,250,4
Liam Millar,CAN,"DF,MF",23,Preston,EFL,28.3,50,27,27,17,6,23,60,38.3,37,40,2,38,24,74,36,0
Liam Palmer,SCO,"DF,MF",31,Sheffield Weds,EFL,26.6,47,29,26,16,5,25,44,56.8,19,31,13,18,30,77,62,0
Liam Walsh,ENG,"MF,FW",25,Swansea City,EFL,6.3,12,6,6,4,2,2,6,33.3,4,10,1,9,5,17,2,0
Lilian Raolisoa,FRA,"FW,DF",23,Angers,Ligue 2,17.6,38,30,19,13,6,21,39,53.8,18,14,0,14,17,55,27,0
Lino Sousa,ENG,"DF,MF",18,Plymouth Argyle,EFL,3.0,4,4,2,1,1,4,5,80.0,1,5,0,5,1,5,10,0
Lino Tempelmann,GER,MF,24,Schalke 04,2. Bundesliga,12.4,22,19,11,4,7,9,14,64.3,5,15,4,11,10,32,9,1
Linus Gechter,GER,DF,19,Hertha BSC,2. Bundesliga,11.4,15,6,13,2,0,9,14,64.3,5,20,13,7,19,34,41,1
Lionel Messi,ARG,"FW,MF",35,Inter Miami,MLS,4.1,1,1,0,1,0,0,2,0.0,2,0,0,0,1,2,0,0
Lionel Mpasi,COD,GK,28,Rodez Aveyron,Ligue 2,18.0,1,1,1,0,0,1,3,33.3,2,0,0,0,0,1,8,0
Lisandro Magallán,ARG,DF,29,UNAM,Liga MX,28.3,48,32,27,21,0,17,28,60.7,11,36,25,11,36,84,107,0
Lisandru Tramoni,FRA,"FW,DF",20,Pisa,Serie B,11.1,22,17,10,7,5,11,22,50.0,11,9,1,8,6,28,6,0
Lluis López,ESP,DF,27,Zaragoza,Segunda Division,14.6,18,11,12,6,0,6,11,54.5,5,13,5,8,12,30,61,1
Logan Delaurier Chaubet,FRA,"MF,FW",21,Quevilly-Rouen,Ligue 2,19.7,39,27,11,17,11,20,44,45.5,24,21,0,21,10,49,7,0
Logan Ndenbe,BEL,DF,22,Sporting KC,MLS,17.1,24,15,14,7,3,10,24,41.7,14,14,2,12,24,48,24,0
Lohann Doucet,FRA,MF,20,Paris FC,Ligue 2,19.8,36,22,12,22,2,20,37,54.1,17,14,3,11,15,51,22,0
Loic Badiashile,FRA,GK,26,Burgos,Segunda Division,1.0,0,0,0,0,0,0,0,0.0,0,0,0,0,0,0,0,0
Loick Ayina,CGO,"DF,MF",20,Huddersfield,EFL,0.9,0,0,0,0,0,0,0,0.0,0,3,3,0,1,1,4,0
Lois Diony,FRA,FW,30,Angers,Ligue 2,33.4,9,9,1,5,3,5,12,41.7,7,4,0,4,2,11,3,0
Lorenzo Amatucci,ITA,MF,19,Ternana,Serie B,13.4,43,21,21,17,5,21,45,46.7,24,23,8,15,20,63,15,0
Lorenzo Andrenacci,ITA,GK,28,Brescia,Serie B,8.5,1,1,1,0,0,1,1,100.0,0,0,0,0,0,1,1,0
Lorenzo Busato,ITA,DF,19,Venezia,Serie B,0.4,1,1,0,1,0,1,1,100.0,0,0,0,0,1,2,2,0
Lorenzo Carissoni,ITA,DF,26,Cittadella,Serie B,30.5,66,46,34,24,8,46,74,62.2,28,65,10,55,35,101,49,0
Lorenzo Cosimi,ITA,DF,19,Ascoli,Serie B,0.1,0,0,0,0,0,0,0,0.0,0,0,0,0,0,0,0,0
Lorenzo Di Stefano,ITA,"MF,FW",20,Modena,Serie B,1.9,2,0,0,1,1,0,0,0.0,0,0,0,0,0,2,1,0
Lorenzo Di Stefano,ITA,FW,20,Calcio Lecco 1912,Serie B,6.9,7,5,0,7,0,4,7,57.1,3,5,1,4,3,10,8,0
Lorenzo Dickmann,ITA,DF,26,Brescia,Serie B,35.3,63,36,40,19,4,35,65,53.8,30,33,7,26,36,99,77,0
Lorenzo Faravelli,ARG,MF,30,Cruz Azul,Liga MX,15.4,32,22,5,21,6,13,45,28.9,32,6,0,6,9,41,2,0
Lorenzo Insigne,ITA,"FW,MF",31,Toronto FC,MLS,16.9,10,7,5,3,2,3,21,14.3,18,7,0,7,13,23,1,0
Lorenzo Libutti,ITA,DF,25,Reggiana,Serie B,11.1,16,13,10,4,2,10,15,66.7,5,3,1,2,10,26,53,0
Lorenzo Lonardi,ITA,MF,24,Südtirol,Serie B,4.7,21,17,12,7,2,12,25,48.0,13,7,4,3,8,29,10,0
Lorenzo Lucchesi,ITA,DF,20,Ternana,Serie B,23.9,49,36,27,21,1,22,33,66.7,11,30,16,14,38,87,90,0
Lorenzo Pinzauti,ITA,FW,28,Calcio Lecco 1912,Serie B,0.8,3,2,1,2,0,1,1,100.0,0,0,0,0,0,3,0,0
Lorenzo Rajot,FRA,MF,25,Rodez Aveyron,Ligue 2,28.8,27,20,8,14,5,18,52,34.6,34,21,5,16,13,40,13,0
Loris Bacchetti,ITA,DF,30,FeralpiSalò,Serie B,7.8,9,6,6,1,2,4,5,80.0,1,6,5,1,8,17,15,0
Louey Ben Farhat,GER,MF,17,Karlsruher,2. Bundesliga,0.1,0,0,0,0,0,0,2,0.0,2,1,0,1,0,0,0,0
Louis Mafouta,CTA,"FW,MF",29,Amiens,Ligue 2,33.0,12,6,6,5,1,4,20,20.0,16,20,6,14,12,24,25,0
Louis Mouton,FRA,MF,21,Pau FC,Ligue 2,18.7,73,44,35,25,13,27,74,36.5,47,20,2,18,17,90,27,1
Louis Schaub,AUT,"MF,FW",28,Hannover 96,2. Bundesliga,19.0,30,15,12,11,7,12,36,33.3,24,24,2,22,10,40,14,0
Loup Gueho,FRA,"DF,MF",19,Bastia,Ligue 2,0.2,0,0,0,0,0,0,0,0.0,0,1,1,0,0,0,1,0
Loïc Bessile,TOG,DF,24,Dunkerque,Ligue 2,2.5,5,4,4,1,0,3,3,100.0,0,3,2,1,7,12,9,0
Loïc N'Gatta,FRA,DF,19,Auxerre,Ligue 2,1.2,10,7,8,1,1,5,8,62.5,3,2,1,1,0,10,1,0
Loïc Nestor,FRA,DF,34,Grenoble,Ligue 2,15.3,13,4,10,3,0,8,18,44.4,10,20,9,11,22,35,72,0
Loïc Williams,ESP,DF,22,Tenerife,Segunda Division,15.3,29,18,16,13,0,8,18,44.4,10,21,16,5,13,42,58,0
Loïs Martins,FRA,"MF,DF",19,Stade Laval,Ligue 2,0.2,0,0,0,0,0,0,0,0.0,0,0,0,0,1,1,0,0
Luc Castaignos,NED,FW,30,Magdeburg,2. Bundesliga,9.2,0,0,0,0,0,0,1,0.0,1,1,0,1,0,0,7,0
Luc Ihorst,GER,FW,23,Braunschweig,2. Bundesliga,1.8,2,0,1,0,1,1,1,100.0,0,1,0,1,0,2,1,0
Luca Böggemann,GER,GK,19,Osnabrück,2. Bundesliga,0.1,0,0,0,0,0,0,0,0.0,0,0,0,0,0,0,0,0
Luca Ceppitelli,ITA,DF,33,FeralpiSalò,Serie B,28.9,50,33,34,15,1,22,36,61.1,14,39,29,10,40,90,143,1
Luca Cigarini,ITA,MF,37,Reggiana,Serie B,11.6,25,12,12,12,1,10,28,35.7,18,7,0,7,12,37,14,0
Luca D'Andrea,ITA,"MF,FW",18,Catanzaro,Serie B,8.1,9,8,4,4,1,6,13,46.2,7,4,0,4,3,12,4,0
Luca Dürholtz,GER,"MF,FW",29,Elversberg,2. Bundesliga,5.2,8,5,5,2,1,6,13,46.2,7,4,0,4,3,11,5,0
Luca Fiordilino,ITA,MF,27,FeralpiSalò,Serie B,29.3,63,40,35,27,1,30,56,53.6,26,40,13,27,32,95,41,1
Luca Ghiringhelli,ITA,DF,31,Südtirol,Serie B,2.7,9,3,7,2,0,3,7,42.9,4,3,2,1,7,16,15,0
Luca Giudici,ITA,"MF,FW",31,FeralpiSalò,Serie B,1.6,8,3,4,3,1,1,1,100.0,0,2,1,1,1,9,2,0
Luca Giudici,ITA,"DF,FW",31,Calcio Lecco 1912,Serie B,4.6,10,5,7,3,0,6,11,54.5,5,7,1,6,7,17,11,0
Luca Lezzerini,ITA,GK,28,Brescia,Serie B,25.0,1,1,1,0,0,1,1,100.0,0,1,0,1,1,2,9,1
Luca Magnino,ITA,MF,25,Modena,Serie B,29.4,49,30,25,17,7,24,52,46.2,28,38,5,33,35,84,38,3
Luca Maniero,ITA,GK,28,Cittadella,Serie B,3.0,0,0,0,0,0,0,0,0.0,0,0,0,0,0,0,1,0
Luca Marrone,ITA,DF,33,Cremonese,Serie B,2.0,2,0,2,0,0,2,2,100.0,0,3,2,1,1,3,7,0
Luca Marrone,ITA,DF,33,Calcio Lecco 1912,Serie B,6.2,5,5,4,1,0,3,3,100.0,0,5,3,2,4,9,22,1
Luca Moro,ITA,"FW,MF",22,Spezia,Serie B,11.2,5,3,1,2,2,2,5,40.0,3,11,2,9,1,6,7,0
Luca Pandolfi,ITA,FW,25,Cittadella,Serie B,18.2,11,6,3,3,5,5,12,41.7,7,4,2,2,5,16,17,0
Luca Petrasso,CAN,"DF,FW",22,Orlando City,MLS,4.8,8,5,3,3,2,4,6,66.7,2,4,1,3,3,11,6,0
Luca Ravanelli,ITA,DF,26,Cremonese,Serie B,24.2,48,30,31,12,5,22,31,71.0,9,35,19,16,24,72,111,1
Luca Schnellbacher,GER,FW,29,Elversberg,2. Bundesliga,24.3,9,6,1,6,2,4,8,50.0,4,12,0,12,4,13,17,0
Luca Strizzolo,ITA,"FW,MF",31,Modena,Serie B,10.8,6,4,1,3,2,3,6,50.0,3,10,3,7,1,7,9,0
Luca Tremolada,ITA,"MF,FW",31,Modena,Serie B,17.4,14,7,5,5,4,9,25,36.0,16,7,0,7,4,18,6,0
Luca Valzania,ITA,MF,27,Ascoli,Serie B,9.2,14,10,4,9,1,7,18,38.9,11,9,2,7,10,24,11,1
Luca Verna,ITA,MF,30,Catanzaro,Serie B,20.1,11,7,3,7,1,4,9,44.4,5,11,5,6,15,26,16,0
Luca Vido,ITA,"FW,MF",26,Reggiana,Serie B,0.4,0,0,0,0,0,0,0,0.0,0,0,0,0,0,0,0,0
Luca Vignali,ITA,"DF,MF",27,Como,Serie B,3.0,4,3,4,0,0,3,3,100.0,0,1,0,1,3,7,10,0
Luca Vignali,ITA,"DF,MF",27,Spezia,Serie B,8.4,17,9,8,7,2,8,13,61.5,5,7,1,6,6,23,15,0
Luca Zanimacchia,ITA,DF,25,Cremonese,Serie B,26.1,33,24,20,8,5,20,42,47.6,22,21,2,19,17,50,29,0
Luca Zidane,FRA,GK,26,Eibar,Segunda Division,42.0,2,2,2,0,0,2,3,66.7,1,0,0,0,0,2,14,4
Lucas Ahijado,ESP,DF,29,Oviedo,Segunda Division,7.7,20,16,6,11,3,12,21,57.1,9,12,4,8,7,27,13,0
Lucas Anacker,BRA,GK,27,Alcorcón,Segunda Division,13.0,0,0,0,0,0,0,0,0.0,0,0,0,0,1,1,2,2
Lucas Andersen,DEN,MF,28,QPR,EFL,10.1,14,9,5,7,2,8,16,50.0,8,12,0,12,11,25,8,0
Lucas Bartlett,USA,DF,25,St. Louis,MLS,11.9,18,11,13,5,0,14,22,63.6,8,24,9,15,25,43,51,0
Lucas Boyé,ARG,FW,28,Elche,Segunda Division,2.4,1,0,0,1,0,1,3,33.3,2,4,1,3,0,1,4,0
Lucas Buadés,FRA,"DF,MF",25,Rodez Aveyron,Ligue 2,18.1,43,22,19,18,6,24,40,60.0,16,18,0,18,18,61,36,1
Lucas Calegari,BRA,DF,20,LA Galaxy,MLS,21.5,42,29,27,10,5,24,41,58.5,17,26,10,16,23,65,35,1
Lucas Cavallini,CAN,FW,30,Puebla,Liga MX,9.5,6,4,2,3,1,2,4,50.0,2,4,1,3,2,8,9,0
Lucas Cavallini,CAN,"FW,MF",30,Tijuana,Liga MX,4.2,5,3,3,1,1,2,3,66.7,1,2,0,2,0,5,2,0
Lucas Da Cunha,FRA,"MF,FW",22,Como,Serie B,28.9,44,30,17,14,13,22,56,39.3,34,38,3,35,10,54,21,1
Lucas Di Yorio,ARG,FW,26,Pachuca,Liga MX,11.3,16,9,0,11,5,5,13,38.5,8,11,2,9,3,19,9,0
Lucas Maronnier,FRA,DF,23,Guingamp,Ligue 2,12.4,29,19,14,8,7,19,34,55.9,15,7,0,7,17,46,30,0
Lucas Merolla,ARG,DF,28,Mazatlán,Liga MX,3.1,5,2,4,1,0,2,4,50.0,2,6,4,2,5,10,22,0
Lucas Oliveira,BRA,MF,28,Valladolid,Segunda Division,8.4,15,11,5,6,4,8,16,50.0,8,13,2,11,11,26,25,0
Lucas Oliveira Rosa,BRA,"DF,MF",24,Valladolid,Segunda Division,18.3,53,37,21,24,8,29,48,60.4,19,17,3,14,23,76,41,0
Lucas Ricoy,ESP,"DF,MF",21,Burgos,Segunda Division,0.3,1,0,0,1,0,1,1,100.0,0,0,0,0,0,1,0,0
Lucas Rodríguez,ARG,MF,26,Tijuana,Liga MX,23.4,45,23,14,23,8,21,34,61.8,13,20,1,19,16,61,4,0
Lucas Romero,ARG,MF,29,León,Liga MX,10.8,23,18,4,16,3,10,26,38.5,16,10,2,8,7,30,9,0
Lucas Terrer,ESP,MF,19,Zaragoza,Segunda Division,1.7,3,2,1,1,1,2,2,100.0,0,0,0,0,1,4,0,0
Lucas Woudenberg,NED,DF,29,Valenciennes,Ligue 2,28.4,39,21,26,10,3,25,52,48.1,27,23,10,13,36,75,100,0
Lucas Zelarayán,ARM,"MF,FW",30,Crew,MLS,18.9,21,9,6,12,3,6,27,22.2,21,10,0,10,7,28,8,0
Lucas de los Santos,URU,"MF,FW",22,Puebla,Liga MX,1.9,5,2,3,1,1,1,3,33.3,2,4,0,4,0,5,12,1
Luciano Acosta,ARG,MF,28,FC Cincinnati,MLS,28.9,36,19,18,9,9,13,41,31.7,28,22,1,21,18,54,3,1
Luderic Etondé,FRA,"FW,MF",22,Dunkerque,Ligue 2,1.4,0,0,0,0,0,0,0,0.0,0,2,1,1,0,0,0,0
Ludovit Reis,NED,"MF,DF",23,Hamburger SV,2. Bundesliga,19.9,58,37,23,26,9,25,52,48.1,27,33,5,28,27,85,32,1
Luey Giles,WAL,DF,16,Cardiff City,EFL,0.3,0,0,0,0,0,0,1,0.0,1,0,0,0,0,0,1,0
Luigi Canotto,ITA,"FW,DF",29,Cosenza,Serie B,7.7,5,4,4,0,1,3,8,37.5,5,8,0,8,1,6,4,0
Luis Abram,PER,DF,26,Atlanta Utd,MLS,16.2,12,9,9,2,1,8,13,61.5,5,24,11,13,16,28,52,0
Luis Alfonso Rodríguez,MEX,DF,32,Pachuca,Liga MX,4.4,16,10,8,5,3,10,15,66.7,5,3,0,3,5,21,10,0
Luis Alfonso Rodríguez,MEX,DF,32,FC Juárez,Liga MX,15.6,28,18,14,14,0,11,27,40.7,16,17,8,9,23,51,35,0
Luis Amarilla,PAR,FW,27,Mazatlán,Liga MX,23.6,23,13,11,10,2,7,24,29.2,17,13,1,12,5,28,33,0
Luis Amarilla,PAR,FW,27,Minnesota Utd,MLS,8.2,5,3,1,3,1,1,11,9.1,10,3,0,3,0,5,8,0
Luis Barraza,USA,GK,26,NYCFC,MLS,24.0,0,0,0,0,0,0,0,0.0,0,0,0,0,1,1,12,1
Luis Binks,ENG,DF,21,Coventry City,EFL,14.8,26,15,14,11,1,10,15,66.7,5,13,7,6,19,45,67,0
Luis Cárdenas,MEX,GK,29,Monterrey,Liga MX,2.0,0,0,0,0,0,0,0,0.0,0,1,0,1,0,0,3,0
Luis Díaz,CRC,FW,24,Rapids,MLS,1.0,2,1,2,0,0,1,2,50.0,1,0,0,0,0,2,0,0
Luis Díaz,CRC,"DF,MF",24,Crew,MLS,0.9,1,1,0,1,0,0,0,0.0,0,0,0,0,0,1,1,0
Luis Enrique Quiñones,COL,"FW,MF",32,UANL,Liga MX,18.8,38,23,12,23,3,13,43,30.2,30,22,3,19,12,50,16,0
Luis Espinoza,MEX,"MF,DF",19,Santos,Liga MX,1.2,0,0,0,0,0,0,2,0.0,2,5,1,4,2,2,1,0
Luis Fernando Fuentes,MEX,DF,36,América,Liga MX,14.5,29,15,17,12,0,17,27,63.0,10,19,3,16,10,39,31,0
Luis García,MEX,"MF,DF",30,Puebla,Liga MX,9.7,9,5,7,2,0,6,19,31.6,13,6,1,5,6,15,8,0
Luis Gómez,MEX,MF,16,Santos,Liga MX,0.1,1,1,0,1,0,1,1,100.0,0,0,0,0,0,1,0,0
Luis Iturbide,MEX,DF,21,Cruz Azul,Liga MX,0.5,0,0,0,0,0,0,0,0.0,0,0,0,0,3,3,2,0
Luis López,ESP,GK,23,CD Mirandés,Segunda Division,7.0,0,0,0,0,0,0,1,0.0,1,0,0,0,0,0,3,0
Luis Muñoz,ESP,"MF,FW",27,Cartagena,Segunda Division,26.0,29,20,9,16,4,10,33,30.3,23,32,5,27,18,47,17,0
Luis Olivas,MEX,DF,23,Mazatlán,Liga MX,15.2,21,13,14,5,2,12,20,60.0,8,25,14,11,19,40,54,1
Luis Perea,ESP,MF,26,Leganés,Segunda Division,9.1,18,11,9,9,0,9,25,36.0,16,14,8,6,3,21,25,0
Luis Pérez,ESP,DF,29,Valladolid,Segunda Division,39.7,60,37,33,20,7,32,48,66.7,16,40,15,25,41,101,82,1
Luis Quintero,COL,"FW,MF",19,Amorebieta,Segunda Division,4.1,4,4,2,2,0,2,8,25.0,6,4,0,4,5,9,2,0
Luis Ricardo Reyes,MEX,DF,32,Atlas,Liga MX,21.5,50,32,26,16,8,23,37,62.2,14,15,6,9,26,76,48,0
Luis Romo,MEX,MF,28,Monterrey,Liga MX,21.8,39,21,6,24,9,15,40,37.5,25,29,7,22,16,55,19,1
Luis Semedo,POR,"FW,MF",19,Sunderland,EFL,5.6,11,8,3,4,4,4,4,100.0,0,2,1,1,0,11,3,0
Luis Sinisterra,COL,MF,24,Leeds United,EFL,1.9,1,1,0,0,1,1,4,25.0,3,4,0,4,0,1,0,0
Luis Sánchez,MEX,DF,23,Mazatlán,Liga MX,4.7,3,2,3,0,0,0,1,0.0,1,5,2,3,5,8,23,1
Luis Sánchez,MEX,DF,23,Pachuca,Liga MX,0.7,1,1,0,0,1,1,1,100.0,0,1,1,0,2,3,2,0
Luis Vega,MEX,MF,19,Santos,Liga MX,0.0,0,0,0,0,0,0,0,0.0,0,0,0,0,0,0,0,0
Luis Ángel Malagón,MEX,GK,26,América,Liga MX,28.5,0,0,0,0,0,0,1,0.0,1,0,0,0,0,0,7,1
Luismi,ESP,"MF,FW",23,Tenerife,Segunda Division,22.2,29,14,13,10,6,18,42,42.9,24,13,0,13,7,36,7,0
Luismi,ESP,MF,32,Oviedo,Segunda Division,17.5,32,19,16,14,2,17,35,48.6,18,25,14,11,20,52,33,0
Luiz Araújo,BRA,FW,26,Atlanta Utd,MLS,14.1,20,12,7,12,1,7,20,35.0,13,7,0,7,8,28,1,0
Luka Bogdan,CRO,DF,27,Ternana,Serie B,1.0,2,2,0,2,0,0,1,0.0,1,2,1,1,4,6,3,0
Luka Gavran,CAN,GK,22,Toronto FC,MLS,4.0,0,0,0,0,0,0,0,0.0,0,0,0,0,0,0,2,0
Luka Ilić,SRB,"MF,FW",24,Troyes,Ligue 2,15.6,15,11,5,8,2,8,30,26.7,22,17,3,14,5,20,21,0
Luka Krajnc,SVN,DF,28,Catanzaro,Serie B,11.8,9,6,3,5,1,4,12,33.3,8,6,3,3,11,20,48,0
Luka Lochoshvili,GEO,DF,25,Cremonese,Serie B,18.8,30,22,16,8,6,15,22,68.2,7,24,6,18,31,61,64,1
Lukas Engel,DEN,DF,24,Middlesbrough,EFL,27.5,68,41,43,18,7,41,75,54.7,34,44,11,33,51,119,75,2
Lukas Hinterseer,AUT,"MF,DF",32,Hansa Rostock,2. Bundesliga,0.3,0,0,0,0,0,0,0,0.0,0,0,0,0,0,0,0,0
Lukas Jutkiewicz,ENG,"FW,MF",34,Birmingham City,EFL,6.3,6,2,0,4,2,0,7,0.0,7,10,2,8,1,7,9,0
Lukas Kunze,GER,MF,25,Osnabrück,2. Bundesliga,12.9,40,24,13,23,4,31,53,58.5,22,19,5,14,13,53,15,0
Lukas MacNaughton,CAN,DF,27,Nashville,MLS,11.9,11,8,8,3,0,4,10,40.0,6,10,7,3,30,41,49,1
Lukas MacNaughton,CAN,DF,27,Toronto FC,MLS,2.0,3,1,2,1,0,2,2,100.0,0,2,2,0,2,5,6,1
Lukas Mondele,BEL,MF,19,Modena,Serie B,0.2,1,0,0,1,0,1,1,100.0,0,1,0,1,1,2,4,0
Lukas Mühl,GER,DF,26,Spezia,Serie B,11.6,33,17,20,12,1,14,21,66.7,7,9,4,5,19,52,57,1
Lukas Petkov,BUL,"FW,MF",22,Greuther Fürth,2. Bundesliga,11.1,23,13,3,13,7,15,31,48.4,16,17,1,16,4,27,7,0
Lukas Pinckert,GER,DF,23,Elversberg,2. Bundesliga,9.5,26,17,17,9,0,14,23,60.9,9,21,7,14,8,34,51,0
Lukas Schleimer,GER,"MF,FW",23,Nürnberg,2. Bundesliga,21.5,21,14,7,12,2,7,21,33.3,14,34,3,31,2,23,20,0
Luke Ayling,ENG,DF,31,Middlesbrough,EFL,18.2,31,21,22,4,5,15,39,38.5,24,15,3,12,16,47,39,0
Luke Ayling,ENG,DF,31,Leeds United,EFL,8.3,30,21,16,11,3,16,32,50.0,16,10,0,10,10,40,19,0
Luke Brennan,USA,MF,17,Atlanta Utd,MLS,0.0,0,0,0,0,0,0,0,0.0,0,0,0,0,0,0,0,0
Luke Cundle,ENG,"MF,FW",21,Plymouth Argyle,EFL,13.7,23,21,8,12,3,14,23,60.9,9,15,4,11,8,31,9,0
Luke Cundle,ENG,MF,21,Stoke City,EFL,10.9,22,9,10,9,3,13,25,52.0,12,17,4,13,9,31,7,0
Luke Haakenson,USA,"MF,FW",25,Nashville,MLS,3.0,5,2,2,2,1,2,7,28.6,5,2,1,1,2,7,2,0
Luke McNally,IRL,DF,23,Stoke City,EFL,35.5,68,48,41,25,2,35,65,53.8,30,52,32,20,47,115,185,0
Luke O'Nien,ENG,DF,28,Sunderland,EFL,43.0,65,39,37,26,2,31,52,59.6,21,39,21,18,63,128,132,0
Luke Thomas,ENG,DF,22,Middlesbrough,EFL,7.3,24,16,15,6,3,16,26,61.5,10,16,2,14,7,31,15,1
Luke Woolfenden,ENG,DF,24,Ipswich Town,EFL,40.1,37,26,30,6,1,18,26,69.2,8,50,30,20,46,83,152,2
Luquinhas,BRA,"MF,FW",26,NY Red Bulls,MLS,22.2,28,15,4,15,9,12,32,37.5,20,24,1,23,14,42,2,0
Luís Caicedo,COL,MF,26,Dynamo FC,MLS,13.5,20,13,12,7,1,11,26,42.3,15,19,6,13,17,37,24,0
Luís Cervantes,MEX,DF,22,León,Liga MX,6.5,30,24,17,9,4,19,29,65.5,10,9,2,7,8,38,9,0
Luís Martins,POR,DF,30,Vancouver W'caps,MLS,18.0,35,23,17,14,4,21,34,61.8,13,8,2,6,25,60,37,1
Lynden Gooch,USA,"MF,FW",27,Sunderland,EFL,0.1,0,0,0,0,0,0,1,0.0,1,0,0,0,0,0,0,0
Lynden Gooch,USA,"DF,FW",27,Stoke City,EFL,19.0,44,29,25,14,5,23,42,54.8,19,21,2,19,21,65,42,0
Lyndon Dykes,SCO,"FW,MF",27,QPR,EFL,30.4,35,29,7,21,7,12,23,52.2,11,27,4,23,13,48,43,0
László Bénes,SVK,"MF,FW",25,Hamburger SV,2. Bundesliga,25.4,13,9,5,5,3,4,14,28.6,10,19,2,17,11,24,12,0
Léo Bonatini,BRA,FW,29,Atlético,Liga MX,19.5,4,1,2,1,1,2,11,18.2,9,12,4,8,5,9,11,0
Léo Chú,BRA,FW,22,Seattle,MLS,22.8,33,20,11,14,8,6,30,20.0,24,10,0,10,11,44,6,0
Léo Pétrot,FRA,DF,26,Saint-Étienne,Ligue 2,29.5,63,45,34,23,6,41,59,69.5,18,32,13,19,35,98,120,0
Maarten Paes,NED,GK,24,FC Dallas,MLS,29.1,3,1,3,0,0,3,3,100.0,0,0,0,0,0,3,18,2
Macaulay Gillesphey,ENG,DF,27,Plymouth Argyle,EFL,2.4,4,3,3,1,0,4,8,50.0,4,2,1,1,2,6,7,0
Machop Malual,SSD,"FW,MF",24,Atlanta Utd,MLS,5.2,7,4,2,5,0,2,2,100.0,0,9,1,8,3,10,0,0
Mads Frøkjær-Jensen,DEN,"MF,FW",24,Preston,EFL,28.5,49,25,14,24,11,16,44,36.4,28,42,0,42,31,80,14,2
Mads Hermansen,DEN,GK,23,Leicester City,EFL,44.0,1,1,1,0,0,1,2,50.0,1,0,0,0,0,1,17,6
Magnus Kofod Andersen,DEN,MF,24,Venezia,Serie B,8.1,16,9,7,7,2,8,8,100.0,0,8,1,7,8,24,15,0
Mahame Siby,MLI,MF,27,Bastia,Ligue 2,4.2,8,6,2,5,1,4,8,50.0,4,2,0,2,3,11,8,0
Mahlon Romeo,ATG,DF,27,Cardiff City,EFL,8.5,18,10,10,6,2,14,22,63.6,8,9,3,6,11,29,23,0
Mahmoud Bentayg,MAR,"DF,FW",23,Saint-Étienne,Ligue 2,6.3,18,13,9,5,4,9,15,60.0,6,7,4,3,5,23,9,1
Maikel Chang,CUB,"MF,FW",31,RSL,MLS,11.3,16,8,6,6,4,8,19,42.1,11,13,0,13,5,21,10,0
Maikel Mesa,ESP,"MF,FW",33,Zaragoza,Segunda Division,33.3,21,13,4,17,0,9,29,31.0,20,24,4,20,13,34,15,0
Makabi Lilepo,COD,"FW,MF",26,Valenciennes,Ligue 2,18.1,15,9,3,10,2,5,16,31.3,11,5,1,4,7,22,17,0
Malcolm Edjouma,FRA,MF,26,Bari,Serie B,11.5,41,25,20,17,4,21,36,58.3,15,10,4,6,25,66,15,0
Malcom Bokélé,CMR,DF,23,Bordeaux,Ligue 2,21.0,20,12,15,4,1,9,14,64.3,5,21,8,13,31,51,90,0
Malik Pinto,USA,MF,20,FC Cincinnati,MLS,4.4,11,4,5,5,1,6,17,35.3,11,10,4,6,1,12,6,0
Malik Tchokounté,FRA,FW,34,Stade Laval,Ligue 2,30.3,21,7,5,8,8,9,18,50.0,9,18,4,14,6,27,30,1
Mallik Wilks,ENG,"FW,MF",24,Sheffield Weds,EFL,3.1,5,3,2,2,1,2,6,33.3,4,4,0,4,2,7,1,0
Malte Amundsen,DEN,DF,24,Crew,MLS,21.0,39,25,21,18,0,22,40,55.0,18,28,11,17,45,84,66,3
Mamadou Camara,MLI,"MF,FW",22,Quevilly-Rouen,Ligue 2,24.4,21,15,6,11,4,6,20,30.0,14,23,1,22,16,37,4,1
Mamadou Cellou,GUI,MF,22,Cartagena,Segunda Division,0.0,0,0,0,0,0,0,0,0.0,0,0,0,0,0,0,0,0
Mamadou Coulibaly,SEN,MF,24,Palermo,Serie B,8.3,21,15,10,9,2,3,9,33.3,6,12,2,10,12,33,18,0
Mamadou Diarra,SEN,DF,25,Grenoble,Ligue 2,33.0,45,29,34,10,1,25,37,67.6,12,44,23,21,49,94,81,3
Mamadou Fall,SEN,DF,20,LAFC,MLS,1.0,1,0,1,0,0,0,2,0.0,2,0,0,0,2,3,3,0
Mamadou Fofana,FRA,MF,22,Amiens,Ligue 2,3.6,8,4,1,4,3,5,14,35.7,9,2,0,2,13,21,2,0
Mamadou Fofana,MLI,DF,25,Amiens,Ligue 2,32.8,62,29,48,14,0,30,50,60.0,20,41,24,17,38,100,143,2
Mamadou Samassa,MLI,GK,33,Stade Laval,Ligue 2,36.0,1,1,1,0,0,1,1,100.0,0,1,0,1,3,4,18,2
Mamadou Sylla,SEN,FW,30,Valladolid,Segunda Division,24.8,9,6,2,5,2,4,10,40.0,6,18,4,14,2,11,25,0
Mamadou Sylla,FRA,DF,28,US Concarneau,Ligue 2,2.0,3,3,2,1,0,1,1,100.0,0,2,2,0,3,6,6,0
Mamadu Silla,FRA,FW,16,Ajaccio,Ligue 2,0.3,0,0,0,0,0,0,0,0.0,0,1,0,1,0,0,0,0
Mamady Bangré,BFA,"FW,MF",22,Troyes,Ligue 2,5.7,13,5,3,7,3,6,12,50.0,6,3,0,3,2,15,2,0
Manga Foe Ondoa,FRA,MF,17,Valenciennes,Ligue 2,12.1,10,11,3,4,3,5,11,45.5,6,4,1,3,8,18,14,0
Manolis Saliakas,GRE,"MF,DF",26,St. Pauli,2. Bundesliga,29.5,48,28,25,21,2,27,58,46.6,31,43,8,35,20,68,42,1
Manolo Portanova,ITA,"MF,DF",23,Reggiana,Serie B,27.3,66,39,30,28,8,27,67,40.3,40,50,6,44,16,82,27,0
Mantilla,ESP,DF,24,Racing Sant,Segunda Division,23.0,27,17,15,10,2,19,30,63.3,11,31,18,13,19,46,70,0
Manu Hernando,ESP,DF,25,Amorebieta,Segunda Division,21.3,32,20,23,7,2,18,27,66.7,9,20,15,5,31,63,101,1
Manu Hernando,ESP,DF,25,Racing Sant,Segunda Division,18.0,23,17,18,5,0,8,13,61.5,5,23,16,7,26,49,106,1
Manu Justo,ESP,"FW,MF",28,Racing Ferrol,Segunda Division,4.0,3,3,1,2,0,3,8,37.5,5,4,1,3,2,5,1,0
Manu Vallejo,ESP,"FW,MF",27,Zaragoza,Segunda Division,10.3,18,13,8,5,5,13,28,46.4,15,14,0,14,7,25,8,0
Manuel Castro,URU,"MF,FW",27,FC Juárez,Liga MX,7.1,6,5,3,3,0,4,11,36.4,7,4,0,4,5,11,7,0
Manuel De Luca,ITA,FW,25,Sampdoria,Serie B,21.8,18,11,4,10,4,8,17,47.1,9,6,2,4,0,18,16,0
Manuel Feil,GER,"FW,MF",28,Elversberg,2. Bundesliga,23.9,49,28,21,17,11,23,53,43.4,30,28,4,24,11,60,28,0
Manuel Fuster,ESP,"MF,FW",26,Albacete,Segunda Division,38.5,40,22,17,18,5,19,73,26.0,54,31,3,28,15,55,23,0
Manuel Marras,ITA,"FW,DF",30,Cosenza,Serie B,24.2,58,41,28,25,5,34,81,42.0,47,28,1,27,24,82,34,1
Manuel Perez,FRA,MF,32,Grenoble,Ligue 2,1.6,3,2,2,1,0,0,0,0.0,0,0,0,0,2,5,3,0
Manuel Pozo,ESP,FW,22,Valladolid,Segunda Division,0.7,1,0,0,0,1,0,0,0.0,0,2,0,2,0,1,2,0
Manuel Rico,ESP,MF,21,Huesca,Segunda Division,1.2,5,5,4,1,0,2,5,40.0,3,0,0,0,0,5,1,0
Marc Aguado,ESP,MF,24,Zaragoza,Segunda Division,26.8,69,48,30,33,6,33,52,63.5,19,47,8,39,44,113,41,0
Marc Albrighton,ENG,FW,33,Leicester City,EFL,1.4,5,4,1,3,1,3,5,60.0,2,2,0,2,2,7,3,0
Marc Martínez,ESP,GK,34,Cartagena,Segunda Division,21.0,0,0,0,0,0,0,1,0.0,1,0,0,0,0,0,6,1
Marc Mateu,ESP,"DF,MF",34,Eldense,Segunda Division,36.5,53,34,25,25,3,23,47,48.9,24,21,8,13,31,84,82,1
Marc Roberts,ENG,DF,33,Birmingham City,EFL,9.2,8,4,6,2,0,3,7,42.9,4,11,6,5,9,17,39,1
Marc-Oliver Kempf,GER,DF,28,Hertha BSC,2. Bundesliga,20.4,22,13,17,5,0,12,20,60.0,8,33,23,10,30,52,132,2
Marc-Olivier Doué,FRA,"FW,MF",23,Eldense,Segunda Division,1.4,3,1,1,2,0,2,2,100.0,0,3,1,2,1,4,1,0
Marcel Beifus,GER,DF,20,Karlsruher,2. Bundesliga,13.5,19,16,15,4,0,9,14,64.3,5,10,5,5,7,26,44,1
Marcel Büchel,LIE,MF,32,Ascoli,Serie B,0.4,0,0,0,0,0,0,0,0.0,0,0,0,0,0,0,3,0
Marcel Correia,POR,DF,34,Elversberg,2. Bundesliga,1.6,5,3,1,2,2,2,2,100.0,0,4,2,2,2,7,11,0
Marcel Engelhardt,GER,GK,30,Holstein Kiel,2. Bundesliga,1.0,0,0,0,0,0,0,0,0.0,0,0,0,0,0,0,2,0
Marcel Franke,GER,DF,30,Karlsruher,2. Bundesliga,30.0,21,11,12,8,1,12,14,85.7,2,28,24,4,22,43,126,4
Marcel Halstenberg,GER,DF,31,Hannover 96,2. Bundesliga,31.5,37,21,25,11,1,17,29,58.6,12,32,21,11,29,66,130,2
Marcel Hartel,GER,"MF,FW",27,St. Pauli,2. Bundesliga,32.9,21,10,2,15,4,12,33,36.4,21,23,2,21,18,39,24,0
Marcel Hoffmeier,GER,DF,24,Paderborn 07,2. Bundesliga,29.1,44,24,28,14,2,21,34,61.8,13,38,22,16,23,67,64,1
Marcel Oakley,ENG,DF,20,Birmingham City,EFL,0.3,0,0,0,0,0,0,1,0.0,1,0,0,0,0,0,0,0
Marcel Ruiz,MEX,"MF,FW",22,Toluca,Liga MX,27.8,80,46,24,48,8,31,57,54.4,26,20,7,13,21,101,32,0
Marcel Sobottka,GER,MF,29,Düsseldorf,2. Bundesliga,7.1,15,7,11,3,1,6,12,50.0,6,7,0,7,5,20,7,0
Marcelino Núñez,CHI,MF,23,Norwich City,EFL,25.1,67,33,24,38,5,31,69,44.9,38,29,5,24,10,77,31,0
Marcello Falzerano,ITA,"DF,MF",32,Ascoli,Serie B,26.3,59,42,39,16,4,25,46,54.3,21,30,6,24,28,87,40,0
Marcelo Flores,MEX,"FW,MF",19,UANL,Liga MX,8.6,14,11,6,6,2,11,15,73.3,4,7,0,7,6,20,6,0
Marcelo Silva,URU,DF,33,RSL,MLS,16.0,19,10,15,4,0,14,26,53.8,12,18,11,7,20,39,50,0
Marciano Tchami,GNB,"FW,MF",20,Alcorcón,Segunda Division,3.7,7,4,2,3,2,4,7,57.1,3,4,0,4,3,10,7,0
Marcin Kamiński,POL,DF,31,Schalke 04,2. Bundesliga,29.4,28,15,15,12,1,11,18,61.1,7,30,17,13,27,55,99,1
Marcin Listkowski,POL,"MF,FW",25,Calcio Lecco 1912,Serie B,3.6,4,3,1,1,2,3,5,60.0,2,4,1,3,4,8,1,0
Marco Angulo,ECU,MF,20,FC Cincinnati,MLS,8.7,20,15,10,8,2,9,16,56.3,7,12,1,11,14,34,5,2
Marco Capuano,ITA,DF,31,Ternana,Serie B,25.1,55,37,40,15,0,29,40,72.5,11,51,35,16,26,81,134,2
Marco Curto,ITA,DF,24,Como,Serie B,22.1,24,15,18,5,1,13,28,46.4,15,34,17,17,20,44,45,3
Marco D'Alessandro,ITA,"FW,DF",32,Pisa,Serie B,16.8,13,8,5,7,1,4,13,30.8,9,8,2,6,9,22,22,0
Marco Delle Monache,ITA,"MF,FW",18,Sampdoria,Serie B,1.6,1,1,0,1,0,0,2,0.0,2,2,0,2,1,2,0,0
Marco Esteban,ESP,DF,18,Oviedo,Segunda Division,0.5,4,2,1,2,1,1,1,100.0,0,0,0,0,0,4,2,0
Marco Farfan,USA,DF,24,FC Dallas,MLS,29.8,48,26,34,10,4,33,60,55.0,27,33,12,21,29,77,54,0
Marco Frigerio,ITA,MF,22,Calcio Lecco 1912,Serie B,2.3,7,3,2,3,2,2,2,100.0,0,1,0,1,6,13,5,0
Marco García,MEX,MF,23,Querétaro,Liga MX,3.2,6,3,3,3,0,1,10,10.0,9,2,0,2,1,7,3,0
Marco González,MEX,MF,21,Querétaro,Liga MX,0.0,1,0,1,0,0,0,1,0.0,1,0,0,0,0,1,0,0
Marco Hernández,MEX,MF,18,UNAM,Liga MX,0.3,1,0,0,1,0,0,0,0.0,0,0,0,0,1,2,0,0
Marco Komenda,CRO,DF,26,Holstein Kiel,2. Bundesliga,13.2,23,15,11,8,4,16,19,84.2,3,16,13,3,11,34,59,1
Marco Meyerhöfer,GER,DF,27,Greuther Fürth,2. Bundesliga,12.7,14,9,4,8,2,9,18,50.0,9,16,2,14,11,25,23,0
Marco Modolo,ITA,DF,34,Venezia,Serie B,6.3,3,3,2,1,0,3,5,60.0,2,4,4,0,6,9,26,1
Marco Nasti,ITA,FW,19,Bari,Serie B,24.5,13,8,4,4,5,3,13,23.1,10,18,1,17,2,15,12,0
Marco Oliva,ITA,MF,18,Modena,Serie B,0.0,0,0,0,0,0,0,0,0.0,0,0,0,0,0,0,0,0
Marco Olivieri,ITA,"FW,MF",24,Venezia,Serie B,3.7,0,0,0,0,0,0,1,0.0,1,1,0,1,1,1,1,0
Marco Pissardo,ITA,GK,25,Bari,Serie B,5.3,0,0,0,0,0,0,0,0.0,0,0,0,0,1,1,1,0
Marco Pledl,GER,MF,22,Paderborn 07,2. Bundesliga,0.7,2,1,0,2,0,1,1,100.0,0,0,0,0,0,2,0,0
Marco Pompetti,ITA,MF,23,Catanzaro,Serie B,15.6,19,13,10,9,0,10,19,52.6,9,9,3,6,16,35,25,3
Marco Richter,GER,"MF,FW",25,Hertha BSC,2. Bundesliga,2.8,6,2,2,3,1,5,6,83.3,1,3,0,3,2,8,0,1
Marco Sala,ITA,"DF,MF",24,Como,Serie B,20.4,45,31,24,17,4,26,44,59.1,18,34,6,28,23,68,53,0
Marco Sangalli,ESP,"DF,FW",32,Racing Sant,Segunda Division,15.1,37,29,20,15,2,19,43,44.2,24,9,3,6,18,55,27,1
Marco Sau,ITA,"FW,MF",35,FeralpiSalò,Serie B,2.6,2,1,1,0,1,1,5,20.0,4,0,0,0,1,3,0,0
Marco Schuster,GER,"DF,MF",27,Paderborn 07,2. Bundesliga,7.4,13,8,7,4,2,8,13,61.5,5,7,3,4,9,22,30,0
Marco Thiede,GER,DF,31,Karlsruher,2. Bundesliga,7.0,14,8,7,6,1,9,15,60.0,6,9,4,5,2,16,10,0
Marcos André,BRA,FW,27,Valladolid,Segunda Division,6.2,4,2,1,0,3,3,12,25.0,9,6,3,3,1,5,3,0
Marcos Luna,ESP,DF,21,Zaragoza,Segunda Division,1.9,3,3,3,0,0,2,5,40.0,3,1,1,0,3,6,7,0
Marcos Navarro,ESP,DF,20,Levante,Segunda Division,0.6,2,2,1,1,0,1,1,100.0,0,0,0,0,1,3,4,0
Marcos Sánchez,ESP,DF,20,Villarreal B,Segunda Division,0.5,1,1,1,0,0,1,1,100.0,0,0,0,0,0,1,1,0
Marcus Forss,FIN,FW,24,Middlesbrough,EFL,12.4,16,11,3,7,6,9,16,56.3,7,12,1,11,7,23,5,0
Marcus Harness,ENG,"FW,MF",27,Ipswich Town,EFL,10.9,25,19,7,8,10,12,32,37.5,20,25,2,23,8,33,6,0
Marcus Mathisen,DEN,DF,27,Wehen,2. Bundesliga,30.4,72,39,48,22,2,21,42,50.0,21,62,41,21,48,120,148,3
Maren Haile-Selassie,SUI,"FW,DF",23,Fire,MLS,21.2,29,19,7,15,7,12,23,52.2,11,13,1,12,18,47,15,0
Marin Šverko,CRO,DF,25,Venezia,Serie B,27.5,41,28,21,14,6,24,31,77.4,7,31,19,12,32,73,100,1
Marino Hinestroza,COL,"MF,FW",21,Pachuca,Liga MX,7.7,9,6,2,6,1,4,12,33.3,8,10,0,10,3,12,3,0
Marinos Tzionis,CYP,"FW,MF",21,Sporting KC,MLS,8.1,21,11,4,11,6,8,21,38.1,13,12,2,10,3,24,4,0
Mario García,ESP,DF,20,Racing Sant,Segunda Division,14.8,31,14,22,5,4,14,25,56.0,11,16,4,12,22,53,43,0
Mario Gargiulo,ITA,MF,27,Modena,Serie B,0.6,1,1,1,0,0,0,0,0.0,0,2,0,2,2,3,0,0
Mario Gaspar,ESP,"DF,MF",33,Elche,Segunda Division,30.0,39,24,11,22,6,21,35,60.0,14,29,10,19,33,72,84,0
Mario González,ESP,FW,26,LAFC,MLS,4.3,1,0,0,0,1,0,0,0.0,0,2,0,2,0,1,3,0
Mario González,ESP,FW,28,Sporting Gijón,Segunda Division,9.4,6,5,1,5,0,3,4,75.0,1,4,0,4,0,6,8,0
Mario Hernández,ESP,DF,25,Oviedo,Segunda Division,2.3,4,3,2,2,0,3,7,42.9,4,1,0,1,0,4,3,0
Mario Ierardi,ITA,DF,25,Calcio Lecco 1912,Serie B,7.7,15,10,10,5,0,8,12,66.7,4,7,0,7,6,21,35,0
Mario Osuna,MEX,"MF,FW",34,FC Juárez,Liga MX,3.1,5,4,1,4,0,1,8,12.5,7,3,0,3,5,10,8,0
Mario Sampirisi,ITA,DF,30,Reggiana,Serie B,23.6,18,11,8,9,1,10,17,58.8,7,21,10,11,24,42,70,0
Mario Sesé,ESP,"MF,DF",21,Oviedo,Segunda Division,1.0,1,1,1,0,0,1,2,50.0,1,1,0,1,0,1,0,0
Mario Soriano,ESP,MF,22,Eibar,Segunda Division,33.7,47,28,12,25,10,18,50,36.0,32,28,2,26,10,57,13,0
Mario Šitum,CRO,DF,31,Catanzaro,Serie B,22.4,24,12,14,8,2,17,19,89.5,2,20,9,11,21,45,59,0
Marius Courcoul,FRA,MF,16,Angers,Ligue 2,0.2,0,0,0,0,0,0,0,0.0,0,0,0,0,0,0,0,0
Marius Gersbeck,GER,GK,28,Hertha BSC,2. Bundesliga,4.0,0,0,0,0,0,0,0,0.0,0,0,0,0,0,0,2,1
Marius Marin,ROU,MF,24,Pisa,Serie B,31.0,77,52,38,29,10,34,86,39.5,52,62,13,49,33,110,65,1
Marius Müller,GER,GK,30,Schalke 04,2. Bundesliga,20.5,0,0,0,0,0,0,2,0.0,2,0,0,0,1,1,18,1
Marius Noubissi,CMR,"FW,DF",26,Valenciennes,Ligue 2,0.3,1,0,1,0,0,0,0,0.0,0,0,0,0,0,1,0,0
Marius Ros,FRA,"DF,MF",21,Pau FC,Ligue 2,0.2,2,1,2,0,0,0,1,0.0,1,0,0,0,0,2,0,0
Mark McGuinness,IRL,DF,22,Cardiff City,EFL,28.8,31,19,24,7,0,16,41,39.0,25,28,21,7,38,69,123,2
Mark Sykes,IRL,"FW,MF",25,Bristol City,EFL,28.7,40,23,11,15,14,16,31,51.6,15,20,6,14,20,60,43,0
Mark Travers,IRL,GK,24,Stoke City,EFL,13.0,0,0,0,0,0,0,0,0.0,0,0,0,0,0,0,3,0
Mark-Anthony Kaye,CAN,MF,28,Toronto FC,MLS,20.4,66,54,34,28,4,36,67,53.7,31,21,6,15,28,94,33,1
Mark-Anthony Kaye,CAN,MF,28,NE Revolution,MLS,8.7,30,16,12,13,5,11,29,37.9,18,13,2,11,11,41,18,0
Marko Ilić,SRB,GK,24,Rapids,MLS,13.0,1,0,1,0,0,1,2,50.0,1,0,0,0,0,1,9,1
Marko Ivezić,SRB,"DF,MF",21,Holstein Kiel,2. Bundesliga,21.1,39,25,22,15,2,21,46,45.7,25,37,12,25,28,67,49,1
Marko Pajač,CRO,DF,30,Reggiana,Serie B,3.6,3,2,1,1,1,1,5,20.0,4,2,0,2,4,7,5,0
Markus Kolke,GER,GK,32,Hansa Rostock,2. Bundesliga,32.7,0,0,0,0,0,0,3,0.0,3,0,0,0,0,0,10,2
Marky Delgado,USA,MF,27,LA Galaxy,MLS,25.7,55,33,19,30,6,26,65,40.0,39,46,10,36,36,91,26,0
Marlon Mustapha,AUT,FW,22,Como,Serie B,2.0,3,3,1,1,1,1,1,100.0,0,3,0,3,1,4,2,0
Marlon Mustapha,AUT,FW,22,Düsseldorf,2. Bundesliga,3.3,3,2,1,2,0,1,2,50.0,1,4,0,4,1,4,2,0
Marlon Ritter,GER,"MF,FW",28,Kaiserslautern,2. Bundesliga,26.1,22,12,10,10,2,15,30,50.0,15,27,6,21,11,33,24,0
Marlon Vargas,SLV,MF,22,Rapids,MLS,0.1,0,0,0,0,0,0,0,0.0,0,0,0,0,0,0,0,0
Marten Winkler,GER,FW,20,Hertha BSC,2. Bundesliga,17.2,28,17,13,12,3,17,36,47.2,19,21,2,19,10,38,15,0
Martin Adeline,FRA,MF,19,Annecy,Ligue 2,17.7,43,22,9,20,14,28,57,49.1,29,30,7,23,18,61,26,0
Martin Angha,SUI,DF,29,Wehen,2. Bundesliga,22.4,46,27,29,13,4,27,38,71.1,11,31,15,16,16,62,70,0
Martin Braithwaite,DEN,FW,33,Espanyol,Segunda Division,37.1,12,9,2,5,5,2,9,22.2,7,30,4,26,6,18,19,0
Martin Ens,GER,DF,21,Paderborn 07,2. Bundesliga,3.5,1,0,1,0,0,1,2,50.0,1,6,1,5,2,3,14,0
Martí Vilà,ESP,DF,25,FC Andorra,Segunda Division,6.9,12,10,4,7,1,7,11,63.6,4,3,0,3,8,20,7,0
Martín Barragán,MEX,FW,32,Puebla,Liga MX,13.6,9,3,3,3,3,4,8,50.0,4,13,2,11,3,12,8,0
Martín Cáceres,URU,DF,35,LA Galaxy,MLS,14.5,5,3,5,0,0,2,10,20.0,8,13,9,4,10,15,48,1
Martín Ojeda,ARG,"FW,MF",24,Orlando City,MLS,19.5,22,17,7,10,5,8,33,24.2,25,30,0,30,13,35,23,0
Martín Río,ARG,"MF,FW",22,Querétaro,Liga MX,0.6,1,1,0,0,1,1,1,100.0,0,2,0,2,2,3,1,0
Marvin Baudry,CGO,DF,33,Stade Laval,Ligue 2,25.2,41,22,25,14,2,22,27,81.5,5,32,19,13,16,57,119,0
Marvin De Lima,FRA,"DF,FW",19,Bordeaux,Ligue 2,6.3,9,3,5,3,1,5,14,35.7,9,5,1,4,4,13,13,0
Marvin Johnson,ENG,"DF,MF",32,Sheffield Weds,EFL,26.2,39,27,15,18,6,18,41,43.9,23,33,10,23,35,74,39,0
Marvin Loría,CRC,"FW,MF",25,Portland Timbers,MLS,8.4,7,5,6,1,0,3,10,30.0,7,9,0,9,13,20,1,0
Marvin Schulz,GER,"DF,MF",28,Holstein Kiel,2. Bundesliga,14.7,43,31,30,12,1,29,54,53.7,25,17,7,10,16,59,17,0
Marvin Wanitzek,GER,"MF,FW",30,Karlsruher,2. Bundesliga,31.4,59,32,27,28,4,24,51,47.1,27,28,3,25,24,83,43,2
Marvin-Lee Rittmüller,GER,"DF,FW",24,Braunschweig,2. Bundesliga,22.4,26,14,17,7,2,19,29,65.5,10,22,2,20,10,36,39,0
Masaya Okugawa,JPN,"FW,DF",27,Hamburger SV,2. Bundesliga,1.2,5,3,2,2,1,1,3,33.3,2,6,1,5,1,6,0,0
Mascarenhas,POR,"FW,MF",24,Oviedo,Segunda Division,16.3,19,12,9,9,1,8,20,40.0,12,18,3,15,2,21,14,0
Mason Burstow,ENG,FW,19,Sunderland,EFL,9.9,6,3,2,3,1,1,7,14.3,6,4,1,3,0,6,5,0
Mason Holgate,ENG,DF,26,Southampton,EFL,3.2,9,6,6,3,0,3,4,75.0,1,2,1,1,6,15,14,0
Mason Stajduhar,USA,GK,25,Orlando City,MLS,4.0,0,0,0,0,0,0,0,0.0,0,0,0,0,0,0,2,1
Mason Toye,USA,FW,24,CF Montréal,MLS,7.5,2,1,0,1,1,1,1,100.0,0,3,0,3,2,4,3,0
Massimiliano Mangraviti,ITA,DF,25,Brescia,Serie B,23.3,16,12,9,6,1,9,15,60.0,6,32,22,10,9,25,86,0
Massimo Bertagnoli,ITA,MF,24,Brescia,Serie B,16.9,47,31,23,20,4,19,47,40.4,28,39,8,31,22,69,27,1
Massimo Coda,ITA,FW,34,Cremonese,Serie B,26.4,10,6,1,4,5,6,11,54.5,5,9,1,8,4,14,26,0
Massimo Luongo,AUS,MF,30,Ipswich Town,EFL,35.1,91,65,25,52,14,43,77,55.8,34,44,17,27,54,145,32,0
Massimo Zilli,ITA,FW,21,Cosenza,Serie B,1.2,0,0,0,0,0,0,1,0.0,1,4,1,3,0,0,0,0
Matai Akinmboni,USA,DF,16,D.C. United,MLS,2.0,1,1,0,1,0,1,1,100.0,0,2,2,0,1,2,6,0
Mateo Chávez,MEX,DF,19,Guadalajara,Liga MX,8.3,45,30,23,19,3,27,39,69.2,12,19,0,19,13,58,16,1
Mateo García,ARG,"MF,FW",26,Atlas,Liga MX,16.4,41,27,15,17,9,23,38,60.5,15,35,0,35,8,49,5,0
Mateo Joseph,ESP,"FW,MF",19,Leeds United,EFL,2.6,2,1,0,1,1,1,1,100.0,0,4,0,4,1,3,3,0
Mateo Klimowicz,GER,"FW,MF",23,Atlético,Liga MX,14.3,38,22,11,24,3,13,24,54.2,11,16,1,15,7,45,6,0
Mateo Levy,MEX,"FW,MF",16,Cruz Azul,Liga MX,1.3,3,2,0,2,1,1,2,50.0,1,3,0,3,0,3,1,0
Mateo Vázquez,MEX,DF,20,UNAM,Liga MX,1.4,0,0,0,0,0,0,0,0.0,0,3,2,1,1,1,1,0
Mateusz Bogusz,POL,"MF,FW",21,LAFC,MLS,19.3,35,24,12,16,7,12,36,33.3,24,12,0,12,6,41,14,0
Mateusz Klich,POL,"MF,FW",32,D.C. United,MLS,30.2,48,36,14,24,10,21,59,35.6,38,34,4,30,14,62,11,1
Mateusz Praszelik,POL,MF,22,Cosenza,Serie B,18.1,31,15,9,21,1,16,22,72.7,6,9,4,5,19,50,24,0
Matheo Raab,GER,GK,24,Hamburger SV,2. Bundesliga,14.0,0,0,0,0,0,0,0,0.0,0,0,0,0,0,0,6,0
Matheus Aiás,BRA,MF,27,Racing Sant,Segunda Division,0.1,0,0,0,0,0,0,0,0.0,0,1,0,1,0,0,0,0
Matheus Martins,BRA,"FW,MF",20,Watford,EFL,19.6,28,21,10,13,5,8,24,33.3,16,15,1,14,7,35,3,1
Matheus Pereira da Silva,BRA,MF,26,Eibar,Segunda Division,37.5,57,27,20,32,5,26,57,45.6,31,53,15,38,42,99,51,0
Matheus Rossetto,BRA,MF,26,Atlanta Utd,MLS,20.3,54,32,21,27,6,18,39,46.2,21,19,2,17,17,71,23,1
Mathias Autret,FRA,"MF,FW",32,Caen,Ligue 2,22.4,32,19,9,16,7,16,37,43.2,21,19,2,17,17,49,11,0
Mathias De Amorim,FRA,MF,18,Bordeaux,Ligue 2,1.5,5,3,2,2,1,1,3,33.3,2,1,0,1,2,7,1,0
Mathias Oyewusi,NGA,"FW,MF",24,Valenciennes,Ligue 2,7.9,6,3,1,3,2,5,9,55.6,4,6,1,5,3,9,5,0
Mathieu Cafaro,FRA,"MF,FW",26,Saint-Étienne,Ligue 2,26.6,30,21,15,10,5,13,44,29.5,31,16,3,13,18,48,7,0
Mathieu Choiniere,CAN,"MF,DF",23,CF Montréal,MLS,27.0,60,38,30,25,5,23,54,42.6,31,38,9,29,26,86,32,0
Mathieu Michel,FRA,GK,31,Ajaccio,Ligue 2,21.0,0,0,0,0,0,0,0,0.0,0,0,0,0,0,0,3,0
Mathis Amougou,FRA,MF,17,Saint-Étienne,Ligue 2,0.2,0,0,0,0,0,0,0,0.0,0,0,0,0,1,1,0,0
Mathis Hamdi,FRA,DF,19,Troyes,Ligue 2,1.9,6,5,6,0,0,4,6,66.7,2,4,1,3,4,10,18,0
Mathis Lachuer,FRA,MF,23,CD Mirandés,Segunda Division,12.8,34,17,14,16,4,14,24,58.3,10,21,6,15,10,44,17,0
Mathis Touho,FRA,"MF,FW",18,Amiens,Ligue 2,1.6,2,2,1,1,0,1,3,33.3,2,1,0,1,1,3,0,0
Mathys Angély,FRA,DF,16,Bordeaux,Ligue 2,1.3,7,4,6,1,0,3,5,60.0,2,1,0,1,1,8,5,0
Mathys Tourraine,FRA,DF,22,Grenoble,Ligue 2,26.6,109,67,69,34,6,66,108,61.1,42,39,10,29,53,162,47,0
Mathías Laborda,URU,DF,23,Vancouver W'caps,MLS,17.1,41,23,30,9,2,19,44,43.2,25,9,5,4,23,64,61,0
Matias Antonini Lui,BRA,DF,25,Catanzaro,Serie B,12.8,11,4,8,3,0,4,7,57.1,3,20,16,4,10,21,53,0
Matija Šarkić,MNE,GK,26,Millwall,EFL,32.0,0,0,0,0,0,0,1,0.0,1,0,0,0,1,1,23,2
Matko Miljevic,USA,"MF,FW",21,CF Montréal,MLS,1.5,2,1,0,1,1,0,3,0.0,3,0,0,0,1,3,0,0
Mato Jajalo,BIH,MF,35,Venezia,Serie B,3.4,10,6,5,4,1,3,5,60.0,2,6,3,3,6,16,3,0
Mats Lemmens,BEL,DF,21,Calcio Lecco 1912,Serie B,12.9,34,26,24,7,3,15,19,78.9,4,19,9,10,21,55,44,1
Mats Møller Dæhli,NOR,MF,28,Nürnberg,2. Bundesliga,4.4,6,5,3,1,2,1,5,20.0,4,4,1,3,4,10,3,0
Matt Butcher,ENG,MF,26,Plymouth Argyle,EFL,3.8,2,1,0,1,1,1,4,25.0,3,9,5,4,4,6,8,1
Matt Crooks,ENG,"MF,FW",29,Middlesbrough,EFL,17.0,29,15,7,17,5,12,27,44.4,15,20,3,17,11,40,10,0
Matt Freese,USA,GK,24,NYCFC,MLS,10.0,0,0,0,0,0,0,0,0.0,0,0,0,0,0,0,1,0
Matt Grimes,ENG,MF,28,Swansea City,EFL,46.0,79,46,25,43,11,42,75,56.0,33,42,21,21,38,117,57,1
Matt Hedges,USA,DF,32,Austin,MLS,3.4,2,1,1,1,0,0,2,0.0,2,4,3,1,3,5,14,0
Matt Hedges,USA,DF,32,Toronto FC,MLS,11.9,18,11,14,3,1,10,17,58.8,7,13,7,6,18,36,57,0
Matt Ingram,ENG,GK,29,Hull City,EFL,9.1,0,0,0,0,0,0,0,0.0,0,0,0,0,0,0,7,0
Matt Miazga,USA,DF,27,FC Cincinnati,MLS,26.5,25,17,18,7,0,17,20,85.0,3,33,26,7,36,61,136,1
Matt Nocita,USA,DF,22,NY Red Bulls,MLS,0.3,2,2,2,0,0,0,1,0.0,1,0,0,0,2,4,1,0
Matt Phillips,SCO,"DF,FW",32,West Brom,EFL,17.0,26,13,12,9,5,16,25,64.0,9,17,2,15,14,40,21,0
Matt Polster,USA,"MF,DF",29,NE Revolution,MLS,30.4,54,30,23,29,2,31,65,47.7,34,23,9,14,45,99,44,3
Matteo Angeli,ITA,DF,20,Cittadella,Serie B,13.3,29,20,15,11,3,12,17,70.6,5,19,11,8,20,49,43,0
Matteo Battistini,ITA,DF,29,Calcio Lecco 1912,Serie B,7.8,17,9,12,3,2,5,11,45.5,6,9,3,6,14,31,37,1
Matteo Bianchetti,ITA,DF,30,Cremonese,Serie B,30.5,34,20,19,13,2,22,29,75.9,7,46,27,19,32,66,90,1
Matteo Brunori,ITA,FW,28,Palermo,Serie B,33.2,14,9,4,7,3,7,13,53.8,6,13,5,8,1,15,23,0
Matteo Cotali,ITA,DF,26,Modena,Serie B,18.6,30,15,22,4,4,15,31,48.4,16,23,8,15,27,57,35,0
Matteo Ferro,ITA,"MF,FW",19,Brescia,Serie B,1.5,2,0,1,1,0,1,4,25.0,3,3,0,3,0,2,1,0
Matteo Ricci,ITA,MF,29,Sampdoria,Serie B,7.9,17,9,7,7,3,13,21,61.9,8,7,1,6,6,23,7,0
Matteo Rover,ITA,"MF,FW",24,Südtirol,Serie B,8.2,8,6,1,5,2,1,4,25.0,3,15,4,11,7,15,13,0
Matteo Solini,ITA,DF,30,Como,Serie B,2.0,1,0,0,1,0,0,0,0.0,0,0,0,0,4,5,4,0
Matteo Stoppa,ITA,"MF,FW",22,Catanzaro,Serie B,7.3,3,3,2,1,0,2,6,33.3,4,2,0,2,0,3,7,0
Matteo Stoppa,ITA,FW,22,Sampdoria,Serie B,0.1,0,0,0,0,0,0,1,0.0,1,0,0,0,0,0,0,0
Mattes Hansen,GER,MF,19,Paderborn 07,2. Bundesliga,13.1,28,15,10,14,4,15,28,53.6,13,20,2,18,16,44,18,1
Matthew Clarke,ENG,DF,26,Middlesbrough,EFL,20.2,30,23,20,9,1,22,32,68.8,10,30,20,10,35,65,92,0
Matthew Godden,ENG,FW,32,Coventry City,EFL,22.7,10,7,2,6,2,5,13,38.5,8,15,3,12,3,13,20,0
Matthew Hoppe,USA,"FW,MF",21,SJ Earthquakes,MLS,4.7,7,5,4,1,2,3,10,30.0,7,3,0,3,1,8,1,0
Matthew Pollock,ENG,DF,21,Watford,EFL,10.7,23,11,15,8,0,13,20,65.0,7,21,14,7,15,38,71,0
Matthew Real,USA,"DF,MF",23,Philadelphia,MLS,5.5,14,7,7,5,2,9,12,75.0,3,13,5,8,3,17,7,0
Matthew Sorinola,ENG,"DF,MF",22,Plymouth Argyle,EFL,5.8,16,6,6,8,2,7,12,58.3,5,11,2,9,2,18,15,0
Matthias Braunöder,AUT,MF,21,Como,Serie B,9.7,24,7,10,9,5,6,15,40.0,9,16,3,13,12,36,7,0
Matthias Zimmermann,GER,DF,31,Düsseldorf,2. Bundesliga,23.3,56,39,38,16,2,28,52,53.8,24,30,10,20,29,85,67,0
Matthieu Huard,FRA,"DF,MF",25,Brescia,Serie B,8.4,16,9,7,7,2,6,13,46.2,7,12,1,11,8,24,15,0
Matthis Riou,FRA,DF,22,Guingamp,Ligue 2,11.5,11,6,6,5,0,4,5,80.0,1,5,4,1,23,34,29,0
Matthéo Xantippe,FRA,DF,21,Grenoble,Ligue 2,8.8,28,16,12,15,1,15,28,53.6,13,7,1,6,17,45,16,0
Mattia Aramu,ITA,"MF,FW",28,Bari,Serie B,9.7,9,7,4,4,1,3,11,27.3,8,6,1,5,6,15,7,0
Mattia Compagnon,ITA,FW,21,FeralpiSalò,Serie B,17.4,6,1,1,3,2,3,9,33.3,6,7,0,7,6,12,2,0
Mattia Felici,ITA,"DF,FW",22,FeralpiSalò,Serie B,29.5,35,27,18,8,9,19,35,54.3,16,20,1,19,22,57,37,0
Mattia Maita,ITA,MF,30,Bari,Serie B,20.7,54,37,27,20,7,26,57,45.6,31,29,4,25,19,73,18,0
Mattia Proietti,ITA,MF,31,Ternana,Serie B,1.3,2,1,2,0,0,1,2,50.0,1,2,2,0,3,5,2,0
Mattia Sala,ITA,FW,18,Pisa,Serie B,0.1,1,1,1,0,0,0,0,0.0,0,1,0,1,0,1,0,0
Mattia Tonetto,ITA,"DF,FW",22,FeralpiSalò,Serie B,8.7,31,22,21,10,0,15,22,68.2,7,11,5,6,14,45,20,0
Mattia Tordini,ITA,"FW,MF",21,Calcio Lecco 1912,Serie B,2.1,1,1,0,1,0,0,3,0.0,3,1,0,1,0,1,2,0
Mattia Valoti,ITA,"MF,FW",29,Pisa,Serie B,23.4,37,26,13,16,8,13,38,34.2,25,28,2,26,13,50,23,2
Mattia Viviani,ITA,MF,22,Cosenza,Serie B,5.0,20,11,4,13,3,9,20,45.0,11,10,1,9,5,25,8,0
Mattia Zennaro,ITA,MF,22,FeralpiSalò,Serie B,17.4,27,20,11,15,1,13,33,39.4,20,21,3,18,16,43,18,0
Matty Jacob,ENG,DF,22,Hull City,EFL,8.9,20,13,8,9,3,13,18,72.2,5,14,8,6,9,29,37,0
Matty James,ENG,MF,32,Bristol City,EFL,32.1,55,31,22,31,2,33,70,47.1,37,26,7,19,29,84,37,0
Matty Pearson,ENG,DF,29,Huddersfield,EFL,36.0,50,28,28,21,1,19,42,45.2,23,54,30,24,39,89,162,0
Mattéo Tramoni,FRA,"MF,FW",23,Pisa,Serie B,2.9,7,6,1,4,2,5,8,62.5,3,5,0,5,5,12,2,0
Matéo Loubatieres,FRA,MF,19,Bastia,Ligue 2,2.0,4,2,1,3,0,3,3,100.0,0,0,0,0,0,4,0,0
Matías Dituro,ARG,GK,37,Elche,Segunda Division,21.0,0,0,0,0,0,0,0,0.0,0,0,0,0,1,1,5,2
Matías Pellegrini,ARG,"FW,MF",22,NYCFC,MLS,12.8,24,15,11,10,3,11,37,29.7,26,23,1,22,7,31,10,1
Maurice Multhaup,GER,"FW,DF",26,Braunschweig,2. Bundesliga,3.6,2,1,2,0,0,0,4,0.0,4,3,0,3,1,3,3,0
Maurice Neubauer,GER,DF,27,Elversberg,2. Bundesliga,30.0,64,41,38,23,3,32,51,62.7,19,47,10,37,35,99,80,0
Mauricio Cuevas,USA,DF,19,LA Galaxy,MLS,4.7,8,5,3,5,0,4,15,26.7,11,2,0,2,5,13,13,0
Mauricio Isais,MEX,DF,22,Toluca,Liga MX,7.1,10,8,7,3,0,6,14,42.9,8,11,3,8,7,17,21,0
Mauricio Pereyra,URU,MF,32,Orlando City,MLS,23.5,40,28,15,19,6,23,52,44.2,29,11,2,9,11,51,8,1
Mauricio Pineda,USA,"DF,MF",25,Fire,MLS,17.4,36,19,25,9,2,21,33,63.6,12,31,10,21,27,63,56,0
Maurides,BRA,FW,29,St. Pauli,2. Bundesliga,0.7,0,0,0,0,0,0,1,0.0,1,0,0,0,0,0,0,0
Mauro Laínez,MEX,"MF,FW",27,Querétaro,Liga MX,2.2,3,0,2,1,0,2,3,66.7,1,1,1,0,0,3,2,0
Mauro Laínez,MEX,FW,27,América,Liga MX,0.3,0,0,0,0,0,0,0,0.0,0,0,0,0,0,0,0,0
Mauro Manotas,COL,"FW,MF",28,Atlas,Liga MX,2.3,1,1,0,1,0,1,3,33.3,2,0,0,0,0,1,0,0
Mauro Verzelletti,ITA,DF,19,FeralpiSalò,Serie B,0.1,0,0,0,0,0,0,0,0.0,0,0,0,0,1,1,0,0
Mauro Vigorito,ITA,GK,33,Como,Serie B,0.2,0,0,0,0,0,0,0,0.0,0,0,0,0,0,0,0,0
Mauro Zaleta,MEX,MF,21,Cruz Azul,Liga MX,0.4,3,2,0,3,0,2,4,50.0,2,3,1,2,0,3,0,0
Max,BRA,"MF,FW",21,Rapids,MLS,7.4,18,11,11,4,3,10,19,52.6,9,12,0,12,7,25,12,0
Max Besuschkow,GER,MF,26,Hannover 96,2. Bundesliga,1.0,2,2,1,1,0,2,2,100.0,0,0,0,0,2,4,2,0
Max Christiansen,GER,MF,26,Hannover 96,2. Bundesliga,8.0,21,8,11,7,3,7,19,36.8,12,15,4,11,10,31,11,1
Max Kruse,GER,"FW,MF",35,Paderborn 07,2. Bundesliga,2.2,2,2,1,0,1,1,1,100.0,0,0,0,0,0,2,0,0
Max O'Leary,IRL,GK,26,Bristol City,EFL,46.0,0,0,0,0,0,0,1,0.0,1,1,0,1,2,2,27,4
Max Reinthaler,ITA,DF,28,Wehen,2. Bundesliga,0.5,0,0,0,0,0,0,1,0.0,1,2,2,0,1,1,4,0
Max Weiß,GER,GK,19,Karlsruher,2. Bundesliga,2.0,0,0,0,0,0,0,0,0.0,0,0,0,0,0,0,0,0
Maxence Rivera,FRA,"FW,DF",21,Saint-Étienne,Ligue 2,4.8,14,8,4,6,4,8,12,66.7,4,4,0,4,3,17,3,0
Maxime Barthelmé,FRA,MF,34,Guingamp,Ligue 2,0.2,0,0,0,0,0,0,0,0.0,0,1,0,1,0,0,0,0
Maxime Chanot,LUX,DF,33,NYCFC,MLS,19.0,26,16,21,5,0,19,30,63.3,11,17,8,9,27,53,94,1
Maxime Chanot,LUX,DF,33,Ajaccio,Ligue 2,20.5,27,15,22,4,1,21,33,63.6,12,31,24,7,22,49,84,2
Maxime Crépeau,CAN,GK,28,LAFC,MLS,7.0,0,0,0,0,0,0,0,0.0,0,0,0,0,0,0,3,0
Maxime Do Couto Teixeira,FRA,"MF,FW",26,Amiens,Ligue 2,9.9,26,17,16,7,3,10,27,37.0,17,13,0,13,5,31,4,0
Maxime Etuin,FRA,"MF,DF",27,US Concarneau,Ligue 2,29.1,49,28,24,22,3,30,42,71.4,12,23,10,13,24,73,38,1
Maxime Hautbois,FRA,GK,32,Stade Laval,Ligue 2,2.0,0,0,0,0,0,0,0,0.0,0,0,0,0,0,0,1,0
Maxime Leverbe,FRA,DF,26,Pisa,Serie B,10.8,5,2,5,0,0,5,10,50.0,5,16,10,6,14,19,52,0
Maxime Sivis,FRA,DF,25,Guingamp,Ligue 2,33.4,69,49,33,25,11,37,68,54.4,31,31,11,20,44,113,99,0
Maximilian Arfsten,USA,"DF,MF",21,Crew,MLS,3.1,7,3,4,3,0,5,9,55.6,4,0,0,0,7,14,2,0
Maximilian Dietz,USA,DF,21,Greuther Fürth,2. Bundesliga,25.6,36,22,22,11,3,27,47,57.4,20,37,14,23,26,62,86,0
Maximilian Rohr,GER,"DF,MF",28,Paderborn 07,2. Bundesliga,2.6,14,9,12,2,0,8,13,61.5,5,6,2,4,7,21,12,0
Maximilian Thalhammer,GER,"MF,DF",26,Osnabrück,2. Bundesliga,9.2,18,9,10,7,1,13,20,65.0,7,8,1,7,27,45,31,0
Maximilian Ullmann,AUT,DF,27,Venezia,Serie B,1.3,3,1,2,1,0,1,2,50.0,1,2,0,2,2,5,5,0
Maximiliano Araújo,URU,"DF,FW",23,Toluca,Liga MX,23.3,32,21,18,12,2,20,41,48.8,21,35,4,31,16,48,19,0
Maximiliano Meza,ARG,"MF,FW",30,Monterrey,Liga MX,22.3,40,29,21,12,7,18,47,38.3,29,15,0,15,15,55,21,0
Maximiliano Moralez,ARG,"MF,FW",35,NYCFC,MLS,3.5,5,3,1,3,1,2,6,33.3,4,4,1,3,3,8,0,0
Maximiliano Silvera,URU,FW,25,Necaxa,Liga MX,1.2,1,1,0,1,0,1,1,100.0,0,1,0,1,2,3,0,0
Maximiliano Urruti,ARG,FW,31,Austin,MLS,10.8,16,9,4,8,4,9,23,39.1,14,5,2,3,4,20,1,0
Maxwell Gyamfi,GER,DF,23,Osnabrück,2. Bundesliga,30.6,39,27,24,14,1,24,40,60.0,16,50,38,12,26,65,119,3
Maya Yoshida,JPN,DF,34,LA Galaxy,MLS,12.0,10,9,6,3,1,4,10,40.0,6,16,10,6,26,36,50,0
Mayron George,CRC,"FW,MF",29,Pau FC,Ligue 2,2.4,0,0,0,0,0,0,1,0.0,1,0,0,0,0,0,8,0
McKinze Gaines,USA,"FW,MF",24,Charlotte,MLS,8.2,8,5,4,1,3,1,9,11.1,8,4,1,3,2,10,2,0
Mehdi Chahiri,MAR,"FW,MF",27,Pau FC,Ligue 2,8.6,17,10,1,10,6,9,14,64.3,5,9,0,9,2,19,1,0
Mehdi Jeannin,ALG,GK,32,Pau FC,Ligue 2,2.0,0,0,0,0,0,0,0,0.0,0,0,0,0,0,0,1,0
Mehdi Léris,ALG,"FW,MF",25,Stoke City,EFL,17.6,36,18,10,14,12,13,37,35.1,24,30,6,24,14,50,25,0
Mehdi Merghem,FRA,"MF,FW",26,Guingamp,Ligue 2,28.5,72,49,18,36,18,31,68,45.6,37,36,2,34,21,93,4,0
Mehdi Puch Herrantz,FRA,MF,19,Ajaccio,Ligue 2,3.6,15,9,5,6,4,5,14,35.7,9,2,0,2,2,17,4,1
Mehdi Tahrat,ALG,DF,33,Troyes,Ligue 2,22.3,21,15,15,6,0,13,19,68.4,6,24,15,9,28,49,122,0
Melvin Zinga,FRA,GK,21,Angers,Ligue 2,5.0,0,0,0,0,0,0,0,0.0,0,1,0,1,0,0,1,0
Memo Rodriguez,USA,"MF,FW",27,LA Galaxy,MLS,7.4,13,7,8,1,4,6,16,37.5,10,5,3,2,2,15,1,0
Memo Rodriguez,USA,"FW,MF",27,Austin,MLS,2.7,7,5,5,0,2,3,6,50.0,3,1,0,1,2,9,6,0
Mender García,COL,"FW,MF",24,Minnesota Utd,MLS,11.4,12,7,4,4,4,4,12,33.3,8,12,0,12,4,16,1,0
Micael,BRA,DF,22,Dynamo FC,MLS,21.9,38,25,28,7,3,18,24,75.0,6,31,17,14,28,66,125,2
Michael Baldisimo,PHI,MF,22,SJ Earthquakes,MLS,3.3,11,6,4,7,0,5,14,35.7,9,7,2,5,5,16,8,0
Michael Barrios,COL,"FW,MF",31,LA Galaxy,MLS,1.3,3,3,0,1,2,2,2,100.0,0,1,0,1,0,3,1,0
Michael Barrios,COL,"FW,MF",31,Rapids,MLS,9.3,5,3,3,2,0,4,12,33.3,8,7,0,7,5,10,2,0
Michael Boxall,NZL,DF,34,Minnesota Utd,MLS,31.7,42,24,28,11,3,17,24,70.8,7,53,31,22,48,90,138,2
Michael Bradley,USA,"MF,DF",35,Toronto FC,MLS,16.0,20,17,14,6,0,14,23,60.9,9,12,3,9,19,39,53,1
Michael Cooper,ENG,GK,23,Plymouth Argyle,EFL,19.0,0,0,0,0,0,0,0,0.0,0,0,0,0,1,1,10,0
Michael Frey,SUI,FW,29,QPR,EFL,4.1,8,5,0,5,3,0,1,0.0,1,5,0,5,2,10,3,0
Michael Halliday,USA,DF,20,Orlando City,MLS,9.5,20,10,15,4,1,12,20,60.0,8,17,3,14,9,29,33,0
Michael Ihiekwe,ENG,DF,30,Sheffield Weds,EFL,21.4,14,9,12,2,0,10,20,50.0,10,28,25,3,24,38,105,2
Michael Johnston,IRL,FW,24,West Brom,EFL,12.9,12,7,5,2,5,6,20,30.0,14,11,3,8,4,16,7,1
Michael Langer,AUT,GK,38,Schalke 04,2. Bundesliga,2.5,0,0,0,0,0,0,1,0.0,1,0,0,0,0,0,0,0
Michael Obafemi,IRL,FW,23,Millwall,EFL,10.2,6,2,2,0,4,2,5,40.0,3,3,0,3,1,7,0,0
Michael Rose,SCO,DF,27,Stoke City,EFL,34.9,40,25,23,16,1,20,36,55.6,16,42,26,16,44,84,134,3
Michael Santos,URU,FW,30,FC Juárez,Liga MX,13.2,6,3,2,3,1,1,7,14.3,6,11,1,10,0,6,6,0
Michael Smith,ENG,"FW,MF",31,Sheffield Weds,EFL,13.7,9,4,3,5,1,4,13,30.8,9,12,1,11,1,10,19,0
Michael Svoboda,AUT,DF,24,Venezia,Serie B,16.1,12,8,9,3,0,8,20,40.0,12,22,12,10,16,28,54,0
Michael Venturi,ITA,DF,24,Cosenza,Serie B,28.4,46,30,25,19,2,15,39,38.5,24,38,22,16,40,86,147,2
Michał Helik,POL,DF,27,Huddersfield,EFL,40.3,56,32,35,21,0,18,35,51.4,17,61,42,19,75,131,228,1
Michał Karbownik,POL,DF,22,Hertha BSC,2. Bundesliga,22.7,33,21,18,8,7,17,28,60.7,11,26,5,21,21,54,40,0
Michele Avella,ITA,GK,23,Brescia,Serie B,4.5,0,0,0,0,0,0,0,0.0,0,0,0,0,0,0,2,0
Michele Besaggio,ITA,MF,21,Brescia,Serie B,12.8,37,25,21,14,2,18,43,41.9,25,21,4,17,3,40,29,0
Michele Camporese,ITA,DF,31,Cosenza,Serie B,19.0,12,7,8,3,1,5,6,83.3,1,26,19,7,21,33,104,0
Michele Camporese,ITA,DF,31,FeralpiSalò,Serie B,1.5,1,1,1,0,0,1,1,100.0,0,1,0,1,0,1,6,0
Michele Castagnetti,ITA,MF,33,Cremonese,Serie B,29.3,67,33,27,34,6,37,76,48.7,39,23,4,19,29,96,47,0
Michele Collocolo,ITA,MF,23,Cremonese,Serie B,19.0,36,19,12,17,7,7,19,36.8,12,21,4,17,20,56,23,0
Mickael Malsa,MTQ,MF,28,Valladolid,Segunda Division,0.1,1,1,0,0,1,1,1,100.0,0,1,0,1,0,1,0,0
Mickael Nade,FRA,DF,24,Saint-Étienne,Ligue 2,21.0,47,26,33,13,1,21,29,72.4,8,22,11,11,37,84,51,0
Mickaël Alphonse,GLP,"DF,FW",34,Ajaccio,Ligue 2,1.6,2,0,0,0,2,1,2,50.0,1,2,0,2,2,4,4,0
Mickaël Barreto,FRA,MF,32,Ajaccio,Ligue 2,13.4,19,12,5,11,3,9,26,34.6,17,17,0,17,10,29,7,0
Mickaël Cuisance,FRA,MF,23,Osnabrück,2. Bundesliga,22.5,53,38,19,26,8,29,61,47.5,32,28,3,25,20,73,5,0
Mickaël Le Bihan,FRA,"FW,MF",33,Caen,Ligue 2,15.2,16,11,3,6,7,6,25,24.0,19,12,2,10,15,31,11,0
Mickel Miller,ENG,"DF,MF",27,Plymouth Argyle,EFL,19.5,46,34,29,13,4,24,47,51.1,23,23,3,20,26,72,57,0
Migouel Alfarela,FRA,"FW,MF",25,Bastia,Ligue 2,27.8,20,15,2,7,11,6,28,21.4,22,28,0,28,12,32,4,0
Miguel,ESP,DF,27,FC Andorra,Segunda Division,8.6,11,5,5,4,2,7,12,58.3,5,11,3,8,3,14,16,0
Miguel,ESP,FW,24,Leganés,Segunda Division,24.8,11,8,5,4,2,6,27,22.2,21,21,1,20,7,18,20,0
Miguel Araujo,PER,DF,28,Portland Timbers,MLS,1.9,4,2,1,2,1,2,2,100.0,0,1,1,0,2,6,1,0
Miguel Atienza,ESP,MF,25,Burgos,Segunda Division,28.3,47,30,25,20,2,28,57,49.1,29,42,15,27,47,94,71,0
Miguel Baeza,ESP,"MF,FW",24,CD Mirandés,Segunda Division,3.6,4,3,2,2,0,1,8,12.5,7,1,0,1,6,10,3,0
Miguel Barbieri,ARG,DF,29,Querétaro,Liga MX,21.8,42,29,27,14,1,18,29,62.1,11,24,15,9,51,93,138,0
Miguel Berry,ESP,FW,25,Atlanta Utd,MLS,11.5,9,5,6,2,1,4,8,50.0,4,4,0,4,2,11,4,0
Miguel Jiménez Ponce,MEX,GK,33,Guadalajara,Liga MX,15.8,1,0,1,0,0,1,1,100.0,0,0,0,0,0,1,5,0
Miguel Juan Llambrich,ESP,DF,28,Eldense,Segunda Division,1.1,3,3,0,2,1,2,5,40.0,3,1,0,1,0,3,2,0
Miguel Layún,MEX,"DF,FW",35,América,Liga MX,5.8,8,5,7,1,0,8,17,47.1,9,2,1,1,5,13,4,0
Miguel Loureiro,ESP,DF,27,Huesca,Segunda Division,36.6,95,69,52,33,10,55,83,66.3,28,36,14,22,48,143,158,1
Miguel Marí,ESP,MF,26,Eldense,Segunda Division,0.5,2,1,0,2,0,0,2,0.0,2,0,0,0,0,2,0,0
Miguel Navarro,VEN,DF,23,Fire,MLS,21.9,45,30,29,13,3,22,34,64.7,12,38,7,31,45,90,66,1
Miguel Perez,USA,MF,17,St. Louis,MLS,6.8,23,12,13,6,4,13,28,46.4,15,12,1,11,10,33,9,0
Miguel Rodríguez,MEX,"DF,FW",20,Pachuca,Liga MX,24.7,49,38,25,17,7,24,41,58.5,17,31,1,30,27,76,46,0
Miguel Sansores,MEX,"FW,MF",32,Puebla,Liga MX,10.9,17,13,5,11,1,6,12,50.0,6,11,4,7,9,26,9,0
Miguel Sansores,MEX,"FW,MF",32,Mazatlán,Liga MX,0.8,2,0,1,1,0,0,2,0.0,2,1,0,1,0,2,2,0
Miguel Tapias,MEX,DF,26,Minnesota Utd,MLS,31.8,41,31,35,6,0,27,44,61.4,17,39,30,9,37,78,160,0
Miguel Trauco,PER,DF,30,SJ Earthquakes,MLS,22.3,32,28,18,10,4,16,40,40.0,24,13,3,10,21,53,33,0
Miguel Veloso,POR,MF,37,Pisa,Serie B,15.8,31,17,16,14,1,17,37,45.9,20,13,3,10,16,47,32,0
Mikael Ellertsson,ISL,"MF,DF",21,Venezia,Serie B,18.7,28,20,11,12,5,13,33,39.4,20,31,3,28,14,42,24,1
Mikael Marques,SWE,MF,21,Minnesota Utd,MLS,0.1,0,0,0,0,0,0,0,0.0,0,0,0,0,0,0,1,0
Mikael Uhre,DEN,FW,28,Philadelphia,MLS,23.8,23,13,3,15,5,6,20,30.0,14,17,0,17,9,32,19,0
Mikel Rico,ESP,"MF,FW",39,Cartagena,Segunda Division,11.0,10,5,3,6,1,8,22,36.4,14,12,4,8,4,14,8,1
Mikkel Kirkeskov,DEN,"DF,FW",31,Holstein Kiel,2. Bundesliga,0.8,2,2,2,0,0,1,3,33.3,2,1,1,0,1,3,3,0
Milan van Ewijk,NED,DF,22,Coventry City,EFL,34.4,89,64,48,31,10,37,61,60.7,24,39,7,32,51,140,68,1
Miles Robinson,USA,DF,25,Atlanta Utd,MLS,26.3,36,24,23,10,3,15,26,57.7,11,26,19,7,25,61,99,0
Mileta Rajovic,DEN,FW,24,Watford,EFL,20.6,8,4,2,1,5,4,11,36.4,7,10,5,5,4,12,16,0
Million Manhoef,NED,FW,21,Stoke City,EFL,9.1,10,9,5,2,3,2,13,15.4,11,6,0,6,4,14,7,0
Miloš Degenek,AUS,DF,28,Crew,MLS,9.5,16,10,10,6,0,7,12,58.3,5,15,13,2,15,31,37,1
Milutin Osmajić,MNE,FW,24,Preston,EFL,19.4,10,7,1,6,3,5,10,50.0,5,12,0,12,2,12,9,0
Mirko Antonucci,ITA,"MF,FW",24,Cosenza,Serie B,9.3,9,6,5,4,0,3,7,42.9,4,5,0,5,4,13,8,0
Mirko Antonucci,ITA,"FW,MF",24,Spezia,Serie B,13.9,14,6,5,4,5,9,13,69.2,4,5,0,5,8,22,3,0
Mirko Pigliacelli,ITA,GK,30,Palermo,Serie B,36.0,0,0,0,0,0,0,0,0.0,0,0,0,0,0,0,25,1
Miro Muheim,SUI,DF,25,Hamburger SV,2. Bundesliga,24.5,55,39,34,15,6,34,59,57.6,25,38,9,29,23,78,67,0
Misael Domínguez,MEX,"MF,DF",23,Necaxa,Liga MX,1.2,1,0,0,0,1,0,0,0.0,0,3,0,3,0,1,0,0
Misael Domínguez,MEX,MF,23,Querétaro,Liga MX,0.2,0,0,0,0,0,0,0,0.0,0,0,0,0,0,0,0,0
Missael Rodriguez,USA,FW,19,Fire,MLS,0.2,3,1,3,0,0,2,3,66.7,1,0,0,0,0,3,1,0
Mitja Ilenič,SVN,DF,18,NYCFC,MLS,13.2,26,16,10,12,4,19,32,59.4,13,18,3,15,7,33,26,0
Mohamed Benoit Dao,FRA,FW,16,Paris FC,Ligue 2,0.0,0,0,0,0,0,0,0,0.0,0,0,0,0,0,0,0,0
Mohamed Bouldini,MAR,FW,28,Levante,Segunda Division,23.0,25,17,6,13,6,12,27,44.4,15,20,1,19,7,32,34,0
Mohamed Boumaaoui,FRA,FW,18,Bastia,Ligue 2,0.2,0,0,0,0,0,0,0,0.0,0,0,0,0,0,0,0,0
Mohamed El Hankouri,MAR,"MF,DF",26,Magdeburg,2. Bundesliga,14.6,10,5,8,1,1,7,11,63.6,4,9,2,7,7,17,22,1
Mohamed Fares,ALG,"DF,MF",27,Brescia,Serie B,6.6,10,6,7,3,0,4,10,40.0,6,10,1,9,8,18,29,0
Mohamed Farsi,CAN,"DF,MF",23,Crew,MLS,24.0,30,21,17,7,6,16,25,64.0,9,31,5,26,16,46,32,0
Mohamed Hafid,MAR,"MF,FW",18,Caen,Ligue 2,1.2,1,1,1,0,0,1,5,20.0,4,4,0,4,3,4,2,0
Mohamed Jaouab,MAR,DF,21,Amiens,Ligue 2,10.9,27,20,17,10,0,17,26,65.4,9,8,2,6,17,44,45,0
Mohamed Kaba,FRA,MF,21,Valenciennes,Ligue 2,1.0,3,2,1,2,0,2,5,40.0,3,1,1,0,0,3,0,0
Mohamed Koné,CIV,GK,21,Dunkerque,Ligue 2,14.8,2,1,2,0,0,1,2,50.0,1,0,0,0,0,2,8,0
Mohamed Lamine Diaby,FRA,FW,22,Paris FC,Ligue 2,9.3,5,5,1,4,0,2,5,40.0,3,6,1,5,1,6,7,0
Mohamed Ouhatti,MAR,"MF,FW",22,Amiens,Ligue 2,2.1,9,5,3,3,3,4,8,50.0,4,7,0,7,6,15,0,0
Mohamed Sbai,FRA,"FW,MF",22,Grenoble,Ligue 2,19.8,25,17,7,12,6,10,21,47.6,11,8,0,8,8,33,9,2
Mohamed Souboul,MAR,DF,21,Bastia,Ligue 2,1.4,3,2,3,0,0,2,3,66.7,1,2,0,2,1,4,3,0
Mohamed Toure,AUS,"FW,MF",19,Paris FC,Ligue 2,1.8,1,1,0,0,1,0,0,0.0,0,0,0,0,1,2,0,0
Mohamed Youssouf,COM,DF,35,Ajaccio,Ligue 2,30.6,64,41,41,19,4,39,60,65.0,21,31,8,23,79,143,55,0
Mohammed Djetei,CMR,DF,29,Albacete,Segunda Division,21.5,16,11,12,4,0,8,11,72.7,3,23,18,5,31,47,106,3
Mohanad Jeahze,IRQ,DF,25,D.C. United,MLS,4.0,9,5,3,6,0,7,13,53.8,6,0,0,0,4,13,2,0
Moise Mahop,CMR,DF,23,Annecy,Ligue 2,19.2,42,25,13,18,11,21,37,56.8,16,26,1,25,23,65,41,0
Moises,BRA,"MF,FW",26,Cruz Azul,Liga MX,9.5,4,2,2,1,1,3,8,37.5,5,5,0,5,1,5,2,0
Moises Castillo,COL,DF,22,FC Juárez,Liga MX,23.5,51,29,37,12,2,29,39,74.4,10,23,14,9,44,95,93,1
Moisés Delgado,ESP,DF,30,Racing Ferrol,Segunda Division,25.4,59,33,31,24,4,28,52,53.8,24,24,5,19,41,100,61,0
Monchu,ESP,MF,24,Valladolid,Segunda Division,40.6,54,28,16,27,11,24,53,45.3,29,49,8,41,17,71,37,0
Monju Momuluh,GER,DF,21,Hannover 96,2. Bundesliga,0.2,1,0,1,0,0,0,1,0.0,1,2,0,2,1,2,2,0
Mons Bassouamina,CGO,"MF,FW",25,Pau FC,Ligue 2,20.3,13,8,5,5,3,5,8,62.5,3,10,0,10,2,15,5,0
Monsef Bakrar,ALG,FW,22,NYCFC,MLS,8.4,2,0,0,2,0,0,1,0.0,1,2,0,2,2,4,4,0
Montell Ndikom,GER,FW,18,Hannover 96,2. Bundesliga,0.2,0,0,0,0,0,0,0,0.0,0,1,0,1,0,0,0,0
Morgan Fox,WAL,DF,29,QPR,EFL,12.8,25,16,12,11,2,11,14,78.6,3,9,9,0,12,37,57,0
Morgan Rogers,ENG,"MF,FW",21,Middlesbrough,EFL,14.5,28,20,7,15,6,11,18,61.1,7,11,2,9,3,31,13,1
Morgan Whittaker,ENG,"FW,MF",22,Plymouth Argyle,EFL,44.1,46,28,15,22,9,19,73,26.0,54,41,1,40,16,62,23,0
Moritz Flotho,GER,FW,21,Paderborn 07,2. Bundesliga,0.7,0,0,0,0,0,0,0,0.0,0,1,0,1,0,0,0,0
Moritz Heyer,GER,DF,28,Hamburger SV,2. Bundesliga,7.2,15,8,11,4,0,8,15,53.3,7,15,5,10,8,23,25,1
Morro,ESP,GK,23,Villarreal B,Segunda Division,9.0,1,0,1,0,0,1,1,100.0,0,0,0,0,0,1,3,1
Moses Nyeman,USA,MF,19,RSL,MLS,0.3,1,0,1,0,0,0,1,0.0,1,1,0,1,0,1,0,0
Mouhamadou Sarr,SEN,GK,26,Cremonese,Serie B,12.0,0,0,0,0,0,0,0,0.0,0,0,0,0,0,0,3,0
Mouhamed Diop,SEN,"MF,DF",22,Troyes,Ligue 2,23.8,37,30,25,8,4,19,47,40.4,28,29,7,22,18,55,29,0
Mounaim El Idrissy,FRA,"FW,MF",24,Ajaccio,Ligue 2,1.0,1,1,0,1,0,0,0,0.0,0,1,0,1,1,2,0,0
Mounir Chouiar,FRA,"FW,MF",24,Amiens,Ligue 2,8.0,17,12,11,2,4,7,14,50.0,7,11,0,11,3,20,6,0
Mourad El Ghezouani,MAR,FW,26,Elche,Segunda Division,24.8,19,12,5,10,4,9,28,32.1,19,17,2,15,1,20,31,0
Moussa Guel,CIV,"MF,FW",24,Dunkerque,Ligue 2,1.3,1,0,1,0,0,0,0,0.0,0,0,0,0,1,2,0,0
Moussa Soumano,FRA,"FW,MF",18,Ajaccio,Ligue 2,10.5,9,7,2,2,5,3,7,42.9,4,6,1,5,4,13,11,0
Moussa Sylla,MLI,"FW,MF",23,Pau FC,Ligue 2,32.0,27,19,10,12,5,14,33,42.4,19,20,1,19,16,43,13,0
Moustapha Mbow,SEN,DF,23,Paris FC,Ligue 2,37.0,63,41,46,16,1,39,46,84.8,7,52,28,24,56,119,146,1
Moutir Chajia,BEL,"FW,MF",25,Como,Serie B,9.8,4,2,1,2,1,3,7,42.9,4,7,1,6,2,6,0,0
Moïse Bombito,CAN,DF,22,Rapids,MLS,8.3,19,10,13,5,1,16,17,94.1,1,9,2,7,11,30,38,0
Muhamed Djamanca,GNB,"FW,MF",25,Reggiana,Serie B,6.5,6,4,3,2,1,3,7,42.9,4,8,1,7,1,7,0,0
Muhammed Damar,GER,MF,19,Hannover 96,2. Bundesliga,0.7,1,0,0,0,1,0,0,0.0,0,3,1,2,1,2,0,0
Mumo,ESP,MF,29,Burgos,Segunda Division,18.7,41,24,16,19,6,23,52,44.2,29,30,7,23,14,55,26,0
Murray Wallace,SCO,DF,30,Millwall,EFL,23.0,47,32,33,12,2,28,48,58.3,20,32,12,20,32,79,72,0
Mustapha Bundu,SLE,"FW,MF",26,Plymouth Argyle,EFL,10.7,6,6,2,2,2,1,6,16.7,5,6,0,6,3,9,8,0
Mykola Kukharevych,UKR,"FW,MF",22,Swansea City,EFL,1.6,5,2,2,2,1,0,1,0.0,1,2,0,2,1,6,6,0
Márton Dárdai,HUN,"MF,DF",21,Hertha BSC,2. Bundesliga,25.2,40,25,21,17,2,18,38,47.4,20,41,22,19,41,81,76,1
Nacho,ESP,DF,35,Tenerife,Segunda Division,19.6,41,25,23,15,3,32,51,62.7,19,23,7,16,11,52,40,0
Nacho,ESP,"FW,MF",31,Racing Ferrol,Segunda Division,7.9,17,12,3,7,7,11,13,84.6,2,6,0,6,4,21,5,0
Nacho Gil,ESP,"FW,DF",27,NE Revolution,MLS,5.8,10,7,1,7,2,2,7,28.6,5,3,1,2,4,14,3,0
Nacho Martin,ESP,MF,22,Sporting Gijón,Segunda Division,11.1,32,13,10,19,3,14,28,50.0,14,21,4,17,7,39,9,0
Nacho Monsalve,ESP,DF,30,Eldense,Segunda Division,2.9,5,3,1,4,0,1,1,100.0,0,3,2,1,5,10,9,0
Nacho Méndez,ESP,MF,26,Sporting Gijón,Segunda Division,31.1,55,41,29,20,6,28,81,34.6,53,38,7,31,27,82,23,0
Nader El-Jindaoui,GER,FW,26,Hertha BSC,2. Bundesliga,0.3,0,0,0,0,0,0,0,0.0,0,1,0,1,0,0,0,0
Nadjib Cisse,MLI,DF,22,Quevilly-Rouen,Ligue 2,15.9,28,18,20,4,4,20,27,74.1,7,23,10,13,30,58,43,1
Nahki Wells,BER,FW,33,Bristol City,EFL,16.9,16,12,5,9,2,4,19,21.1,15,12,0,12,4,20,2,0
Nahuel Estévez,ARG,MF,27,Parma,Serie B,25.6,42,23,19,20,3,22,44,50.0,22,20,7,13,48,90,58,1
Nahuel Guzmán,ARG,GK,37,UANL,Liga MX,24.0,0,0,0,0,0,0,1,0.0,1,2,0,2,1,1,17,6
Naim García,ESP,"MF,FW",22,Leganés,Segunda Division,3.0,7,3,1,3,3,4,6,66.7,2,4,2,2,3,10,5,0
Nassim Chadli,FRA,"MF,FW",22,US Concarneau,Ligue 2,16.5,38,24,17,16,5,15,34,44.1,19,13,1,12,2,40,4,0
Natan Girma,SUI,"MF,FW",21,Reggiana,Serie B,17.2,35,19,14,18,3,15,36,41.7,21,30,3,27,11,46,17,0
Natanael Ntolla,FRA,"FW,MF",24,Grenoble,Ligue 2,7.5,15,10,5,10,0,7,15,46.7,8,6,0,6,4,19,3,0
Nathan Bishop,ENG,GK,23,Sunderland,EFL,1.0,0,0,0,0,0,0,0,0.0,0,0,0,0,0,0,0,0
Nathan Broadhead,WAL,FW,25,Ipswich Town,EFL,25.5,32,24,7,15,10,19,52,36.5,33,35,4,31,8,40,8,0
Nathan Buayi Kiala,FRA,"MF,DF",19,Auxerre,Ligue 2,0.4,1,1,0,1,0,0,0,0.0,0,1,1,0,1,2,1,0
Nathan Byrne,ENG,DF,30,Charlotte,MLS,28.9,41,27,25,15,1,27,56,48.2,29,29,6,23,20,61,56,1
Nathan Fogaça,BRA,FW,23,Portland Timbers,MLS,6.3,4,4,2,1,1,0,7,0.0,7,5,0,5,1,5,3,0
Nathan Harriel,USA,DF,21,Philadelphia,MLS,18.6,42,34,20,14,8,23,39,59.0,16,33,5,28,44,86,49,1
Nathan Lowe,ENG,FW,17,Stoke City,EFL,4.3,2,1,0,0,2,0,0,0.0,0,0,0,0,0,2,5,0
Nathan Ordaz,SLV,FW,19,LAFC,MLS,2.9,4,1,1,1,2,0,2,0.0,2,4,0,4,0,4,1,0
Nathan Silva,BRA,DF,26,UNAM,Liga MX,30.5,54,35,40,14,0,37,54,68.5,17,54,31,23,30,84,134,1
Nathan Tella,NGA,FW,24,Southampton,EFL,3.0,7,4,1,4,2,5,11,45.5,6,5,0,5,3,10,2,0
Nathan Wood-Gordon,ENG,DF,21,Swansea City,EFL,23.4,24,12,13,11,0,16,21,76.2,5,27,21,6,20,44,70,0
Nathan-Dylan Saliba,CAN,MF,18,CF Montréal,MLS,19.7,49,27,14,27,8,21,46,45.7,25,26,5,21,16,65,11,0
Nathanael Mbuku,FRA,"MF,FW",21,Saint-Étienne,Ligue 2,10.3,22,14,6,10,6,5,7,71.4,2,7,0,7,6,28,3,0
Nathaniel Brown,GER,DF,20,Nürnberg,2. Bundesliga,26.7,85,56,56,24,5,37,67,55.2,30,36,2,34,24,109,57,0
Nathaniel Chalobah,ENG,MF,28,West Brom,EFL,10.0,19,12,9,7,3,11,14,78.6,3,10,4,6,10,29,15,0
Nathaniel Phillips,ENG,DF,26,Cardiff City,EFL,17.0,26,16,17,7,2,17,20,85.0,3,27,24,3,13,39,79,1
Nazariy Rusyn,UKR,FW,24,Sunderland,EFL,8.8,9,3,2,3,4,2,6,33.3,4,11,1,10,1,10,1,0
Naïs Djouahra,FRA,"MF,FW",24,Leganés,Segunda Division,11.1,19,11,7,9,3,9,24,37.5,15,31,2,29,4,23,6,0
Nectarios Triantis,AUS,DF,20,Sunderland,EFL,1.0,1,0,1,0,0,0,0,0.0,0,0,0,0,1,2,7,0
Nehemiah Fernandez,FRA,DF,18,Dunkerque,Ligue 2,11.6,18,13,9,7,2,9,15,60.0,6,16,9,7,24,42,43,1
Neil Etheridge,PHI,GK,33,Birmingham City,EFL,2.0,0,0,0,0,0,0,0,0.0,0,0,0,0,0,0,0,0
Nelson Deossa,COL,MF,23,Pachuca,Liga MX,8.6,12,9,6,4,2,5,19,26.3,14,14,1,13,14,26,11,0
Nelson Palacio,COL,MF,21,RSL,MLS,9.6,12,10,10,2,0,8,22,36.4,14,7,2,5,10,22,11,0
Nelson Quiñones,COL,"FW,MF",20,Dynamo FC,MLS,16.4,36,27,20,12,4,10,21,47.6,11,14,0,14,14,50,8,1
Nelson Sissoko,FRA,DF,26,Quevilly-Rouen,Ligue 2,24.4,35,20,22,11,2,23,39,59.0,16,20,3,17,50,85,63,0
Nemanja Radoja,SRB,MF,29,Sporting KC,MLS,19.0,33,21,10,21,2,23,42,54.8,19,14,2,12,29,62,5,0
Nfansu Njié,GAM,"FW,MF",18,Bordeaux,Ligue 2,0.5,0,0,0,0,0,0,0,0.0,0,0,0,0,0,0,0,0
Niall Ennis,ENG,FW,24,Stoke City,EFL,7.4,9,4,4,1,4,1,5,20.0,4,10,3,7,0,9,3,0
Niall Ennis,ENG,FW,24,Blackburn,EFL,3.8,5,3,2,2,1,3,5,60.0,2,1,0,1,0,5,2,0
Niall Huggins,WAL,DF,22,Sunderland,EFL,14.8,27,13,15,8,4,19,35,54.3,16,15,4,11,22,49,34,0
Niccolò Corrado,ITA,DF,23,Ternana,Serie B,13.2,15,10,8,6,1,9,16,56.3,7,14,2,12,13,28,20,0
Niccolò Corrado,ITA,"DF,MF",23,Modena,Serie B,11.7,16,9,6,9,1,9,16,56.3,7,18,5,13,6,22,14,0
Niccolò Pietra,ITA,"MF,DF",19,Spezia,Serie B,1.7,9,4,7,2,0,4,9,44.4,5,2,0,2,3,12,7,0
Nicholas Bonfanti,ITA,FW,21,Pisa,Serie B,8.7,3,1,0,2,1,2,6,33.3,4,4,1,3,0,3,9,0
Nicholas Bonfanti,ITA,FW,21,Modena,Serie B,4.5,1,1,0,1,0,0,1,0.0,1,2,0,2,0,1,4,0
Nicholas Gioacchini,USA,"FW,MF",22,St. Louis,MLS,23.3,24,15,7,11,6,5,15,33.3,10,28,4,24,10,34,14,0
Nicholas Gioacchini,USA,"FW,MF",23,Como,Serie B,2.2,4,3,1,1,2,2,3,66.7,1,2,1,1,0,4,1,0
Nicholas Ioannou,CYP,DF,27,Como,Serie B,17.3,26,12,15,8,3,17,26,65.4,9,22,5,17,9,35,54,0
Nicholas Opoku,GHA,DF,25,Amiens,Ligue 2,19.7,20,11,17,2,1,11,17,64.7,6,34,24,10,15,35,97,0
Nicholas Pierini,ITA,"FW,MF",24,Venezia,Serie B,23.5,13,4,5,4,4,7,14,50.0,7,17,3,14,3,16,15,1
Nicholas Saggionetto,ITA,DF,20,Cittadella,Serie B,0.0,0,0,0,0,0,0,0,0.0,0,1,0,1,0,0,0,0
Nicholas Siega,ITA,DF,32,Südtirol,Serie B,0.2,1,0,0,1,0,1,1,100.0,0,0,0,0,0,1,0,0
Nick Bätzner,GER,MF,23,Wehen,2. Bundesliga,17.2,21,12,10,7,4,6,27,22.2,21,28,2,26,8,29,12,0
Nick Hagglund,USA,DF,30,FC Cincinnati,MLS,23.9,28,18,16,10,2,14,24,58.3,10,24,12,12,32,60,114,0
Nick Lima,USA,DF,28,Austin,MLS,27.0,27,19,16,9,2,20,44,45.5,24,25,7,18,22,49,62,0
Nick Venema,NED,"FW,MF",24,Valenciennes,Ligue 2,11.1,5,4,0,2,3,2,9,22.2,7,9,1,8,4,9,1,0
Niclas Nadj,GER,"MF,FW",22,Paderborn 07,2. Bundesliga,2.5,9,6,2,7,0,3,3,100.0,0,2,0,2,2,11,1,0
Nico Antonitsch,AUT,DF,31,Elversberg,2. Bundesliga,1.0,4,1,2,2,0,2,3,66.7,1,0,0,0,2,6,8,0
Nico Benalcázar,USA,MF,21,NYCFC,MLS,0.1,0,0,0,0,0,0,0,0.0,0,1,1,0,1,1,0,0
Nico Neidhart,GER,"DF,MF",28,Hansa Rostock,2. Bundesliga,18.4,46,29,27,17,2,30,51,58.8,21,24,10,14,19,65,33,0
Nico Ratti,ITA,GK,30,FC Andorra,Segunda Division,26.0,0,0,0,0,0,0,0,0.0,0,0,0,0,0,0,17,5
Nico Ribaudo,ESP,"MF,FW",23,Espanyol,Segunda Division,14.8,15,8,5,6,4,8,20,40.0,12,4,0,4,4,19,5,0
Nico Rieble,GER,DF,27,Wehen,2. Bundesliga,7.5,18,12,15,3,0,13,24,54.2,11,14,4,10,12,30,18,0
Nicola Bellomo,ITA,"MF,FW",32,Bari,Serie B,3.8,10,4,4,6,0,6,11,54.5,5,2,1,1,1,11,3,0
Nicola Falasco,ITA,DF,29,Ascoli,Serie B,13.9,15,5,5,7,3,7,10,70.0,3,11,3,8,8,23,25,0
Nicola Murru,ITA,DF,28,Sampdoria,Serie B,19.9,25,11,14,8,3,13,18,72.2,5,22,9,13,31,56,56,0
Nicola Pavan,ITA,DF,30,Cittadella,Serie B,30.0,43,20,28,15,0,25,39,64.1,14,33,20,13,34,77,135,0
Nicola Rauti,ITA,FW,23,Südtirol,Serie B,11.2,22,13,8,9,5,7,11,63.6,4,12,1,11,8,30,6,0
Nicola Ravaglia,ITA,GK,34,Sampdoria,Serie B,1.0,0,0,0,0,0,0,0,0.0,0,0,0,0,0,0,0,0
Nicola Valente,ITA,"FW,DF",31,Palermo,Serie B,3.1,4,2,0,3,1,1,3,33.3,2,1,0,1,2,6,3,0
Nicolai Rapp,GER,MF,26,Karlsruher,2. Bundesliga,7.4,24,17,15,6,3,10,17,58.8,7,11,3,8,8,32,26,0
Nicolai Remberg,GER,"MF,FW",23,Holstein Kiel,2. Bundesliga,17.7,55,34,25,24,6,25,41,61.0,16,48,14,34,31,86,33,1
Nicolas Firmino,USA,MF,22,Atlanta Utd,MLS,0.0,1,1,0,1,0,0,0,0.0,0,0,0,0,0,1,0,0
Nicolas Galazzi,ITA,"MF,DF",22,Brescia,Serie B,19.6,20,9,5,13,2,16,44,36.4,28,23,1,22,13,33,21,0
Nicolas Gavory,FRA,DF,28,Düsseldorf,2. Bundesliga,16.5,19,15,11,6,2,9,18,50.0,9,17,6,11,10,29,52,0
Nicolas Kristof,GER,GK,23,Elversberg,2. Bundesliga,33.0,0,0,0,0,0,0,1,0.0,1,0,0,0,0,0,9,2
Nicolas Lemaître,FRA,GK,26,Troyes,Ligue 2,3.5,0,0,0,0,0,0,0,0.0,0,0,0,0,0,0,4,1
Nicolas Mercier,FRA,FW,20,Auxerre,Ligue 2,0.1,0,0,0,0,0,0,1,0.0,1,0,0,0,0,0,0,0
Nicolas Oliveira,GER,DF,19,Hamburger SV,2. Bundesliga,1.9,4,3,2,2,0,2,10,20.0,8,2,1,1,6,10,2,0
Nicolas de Préville,FRA,"FW,MF",32,Troyes,Ligue 2,6.6,4,3,2,0,2,3,8,37.5,5,3,1,2,2,6,8,0
Nicolo Tresoldi,GER,FW,18,Hannover 96,2. Bundesliga,21.9,13,11,1,10,2,7,14,50.0,7,25,4,21,2,15,16,0
Nicolás Benedetti,COL,"MF,FW",26,Mazatlán,Liga MX,5.9,8,5,4,3,1,4,10,40.0,6,3,0,3,1,9,0,0
Nicolás Castro,ARG,MF,23,Elche,Segunda Division,28.6,58,34,24,25,9,28,69,40.6,41,23,0,23,21,79,15,1
Nicolás Cordero,ARG,FW,24,Querétaro,Liga MX,7.5,9,4,2,4,3,6,14,42.9,8,5,1,4,3,12,15,0
Nicolás Díaz Huincales,CHI,DF,24,Tijuana,Liga MX,27.2,70,39,42,27,1,23,35,65.7,12,37,21,16,38,108,117,3
Nicolás Ezequiel Fernández,ARG,"MF,FW",24,Elche,Segunda Division,36.1,42,33,17,14,11,19,48,39.6,29,54,3,51,18,60,16,0
Nicolás Ibáñez,ARG,FW,28,UANL,Liga MX,16.2,12,4,1,6,5,5,11,45.5,6,10,1,9,4,16,10,0
Nicolás Lodeiro,URU,"MF,FW",33,Seattle,MLS,27.5,47,27,15,22,10,24,65,36.9,41,22,1,21,16,63,9,0
Nicolás López,URU,FW,29,UANL,Liga MX,0.8,3,2,2,0,1,1,1,100.0,0,1,0,1,0,3,0,0
Nicolás López,URU,"FW,MF",29,León,Liga MX,14.6,18,10,6,9,3,10,19,52.6,9,7,0,7,5,23,7,0
Nicolás Serrano,ESP,FW,21,Racing Ferrol,Segunda Division,11.3,13,12,5,5,3,9,17,52.9,8,15,0,15,6,19,3,0
Nicolás Stefanelli,ARG,"FW,MF",28,Inter Miami,MLS,14.8,20,14,6,10,4,10,32,31.3,22,13,1,12,11,31,2,0
Nicolò Bertola,ITA,DF,20,Spezia,Serie B,12.5,25,12,19,6,0,10,19,52.6,9,20,9,11,20,45,37,0
Nicolò Brighenti,ITA,DF,33,Catanzaro,Serie B,28.5,44,31,21,19,4,22,29,75.9,7,31,18,13,37,81,125,0
Nicolò Buso,ITA,FW,23,Calcio Lecco 1912,Serie B,26.7,32,20,15,10,7,14,31,45.2,17,24,0,24,10,42,16,0
Niels Nkounkou,FRA,DF,22,Saint-Étienne,Ligue 2,1.0,1,1,1,0,0,1,2,50.0,1,0,0,0,1,2,0,0
Nieto,ESP,"FW,DF",26,Elche,Segunda Division,4.0,4,0,1,1,2,0,2,0.0,2,3,0,3,0,4,0,0
Nieto,ESP,FW,26,FC Andorra,Segunda Division,9.6,2,2,0,1,1,0,3,0.0,3,7,1,6,1,3,6,0
Nigel Robertha,NED,"FW,MF",24,D.C. United,MLS,3.4,2,1,0,1,1,1,2,50.0,1,2,0,2,0,2,1,0
Nikita Iosifov,RUS,"FW,MF",23,CD Mirandés,Segunda Division,1.9,2,1,1,1,0,1,3,33.3,2,1,0,1,1,3,2,0
Niklas Castelle,GER,MF,20,Schalke 04,2. Bundesliga,0.1,0,0,0,0,0,0,0,0.0,0,1,0,1,0,0,0,0
Niklas Niehoff,GER,FW,18,Holstein Kiel,2. Bundesliga,0.6,0,0,0,0,0,0,0,0.0,0,1,0,1,1,1,2,0
Niklas Pyyhtiä,FIN,MF,19,Ternana,Serie B,18.9,31,21,8,15,8,10,22,45.5,12,22,5,17,14,45,20,0
Niklas Tauer,GER,DF,22,Schalke 04,2. Bundesliga,0.5,3,2,3,0,0,2,2,100.0,0,2,1,1,1,4,1,0
Niklas Tauer,GER,MF,22,Braunschweig,2. Bundesliga,6.2,18,9,7,8,3,11,20,55.0,9,11,2,9,7,25,7,0
Niklas Wiemann,GER,DF,24,Osnabrück,2. Bundesliga,20.6,27,16,20,5,2,22,36,61.1,14,31,19,12,39,66,102,1
Niko Gießelmann,GER,DF,31,Greuther Fürth,2. Bundesliga,7.5,11,8,7,4,0,9,14,64.3,5,6,0,6,8,19,19,0
Niko Kijewski,GER,DF,27,Braunschweig,2. Bundesliga,2.1,1,1,1,0,0,0,0,0.0,0,1,0,1,1,2,7,0
Niko Tsakiris,USA,MF,17,SJ Earthquakes,MLS,6.8,16,8,5,8,3,8,12,66.7,4,4,1,3,4,20,5,0
Nikola Jojić,SRB,MF,19,Stoke City,EFL,0.0,0,0,0,0,0,0,0,0.0,0,0,0,0,0,0,0,0
Nikola Maraš,SRB,DF,28,Levante,Segunda Division,7.5,13,10,6,7,0,5,10,50.0,5,6,2,4,3,16,32,0
Nikola Sekulov,ITA,DF,21,Cremonese,Serie B,0.2,1,1,0,1,0,0,0,0.0,0,0,0,0,0,1,0,0
Nikola Soldo,CRO,"DF,MF",22,Kaiserslautern,2. Bundesliga,9.5,23,13,13,10,0,9,15,60.0,6,21,15,6,17,40,39,1
Nikola Vasilj,BIH,GK,27,St. Pauli,2. Bundesliga,34.0,0,0,0,0,0,0,1,0.0,1,0,0,0,1,1,15,7
Nikola Šipčić,MNE,DF,29,Tenerife,Segunda Division,10.4,7,4,4,3,0,1,4,25.0,3,12,8,4,17,24,39,0
Nikolas Agrafiotis,NED,"FW,DF",23,Wehen,2. Bundesliga,4.8,4,2,1,2,1,1,4,25.0,3,6,2,4,1,5,3,0
Nils Fröling,SWE,"MF,FW",23,Hansa Rostock,2. Bundesliga,15.4,29,20,12,13,4,13,35,37.1,22,28,3,25,18,47,30,1
Nils-Jonathan Körber,GER,GK,26,Hansa Rostock,2. Bundesliga,1.3,0,0,0,0,0,0,0,0.0,0,0,0,0,0,0,1,0
Njabulo Blom,RSA,MF,23,St. Louis,MLS,21.3,45,19,22,15,8,18,47,38.3,29,30,5,25,49,94,22,0
Nkosi Tafari,USA,DF,25,FC Dallas,MLS,27.7,25,11,20,5,0,18,24,75.0,6,32,22,10,24,49,122,1
Noa Cervantés,ALG,FW,20,Troyes,Ligue 2,0.1,1,1,1,0,0,0,1,0.0,1,0,0,0,0,1,0,0
Noa Mupemba,FRA,"FW,MF",21,Stade Laval,Ligue 2,0.4,0,0,0,0,0,0,0,0.0,0,0,0,0,0,0,0,0
Noah Allen,USA,DF,18,Inter Miami,MLS,13.9,35,16,23,10,2,19,32,59.4,13,13,2,11,14,49,33,0
Noah Cadiou,FRA,MF,24,Quevilly-Rouen,Ligue 2,27.7,76,38,29,40,7,35,61,57.4,26,42,3,39,41,117,18,1
Noah Cobb,USA,DF,17,Atlanta Utd,MLS,2.2,2,1,1,1,0,1,2,50.0,1,2,1,1,0,2,9,0
Noah Fatar,FRA,MF,21,Angers,Ligue 2,0.4,0,0,0,0,0,0,1,0.0,1,1,0,1,1,1,0,0
Noah Guede-Nadje,FRA,FW,19,Angers,Ligue 2,0.5,0,0,0,0,0,0,1,0.0,1,0,0,0,0,0,0,0
Noah Katterbach,GER,DF,22,Hamburger SV,2. Bundesliga,2.5,12,4,8,3,1,7,10,70.0,3,2,1,1,6,18,4,0
Noah Mawene,ENG,MF,18,Preston,EFL,1.9,7,6,3,4,0,3,6,50.0,3,6,2,4,4,11,3,0
Noah Ohio,NED,FW,20,Hull City,EFL,2.7,0,0,0,0,0,0,0,0.0,0,5,0,5,1,1,2,0
Nobel Mendy,FRA,"FW,DF",18,Paris FC,Ligue 2,0.8,0,0,0,0,0,0,0,0.0,0,1,0,1,1,1,4,0
Noel Buck,ENG,"MF,FW",17,NE Revolution,MLS,19.5,53,32,20,26,7,30,61,49.2,31,26,4,22,18,71,16,0
Noel Caliskan,GER,MF,22,Portland Timbers,MLS,2.9,5,4,4,1,0,2,7,28.6,5,3,1,2,2,7,1,0
Noel Niemann,GER,"FW,MF",23,Osnabrück,2. Bundesliga,14.6,13,9,6,5,2,6,13,46.2,7,15,2,13,6,19,17,0
Noha Lemina,FRA,MF,18,Sampdoria,Serie B,0.2,1,1,1,0,0,0,0,0.0,0,0,0,0,0,1,0,0
Noha Ndombasi Nlandu,FRA,"FW,MF",22,US Concarneau,Ligue 2,10.4,9,6,2,3,4,3,7,42.9,4,9,1,8,1,10,3,0
Nolan Mbemba,CGO,MF,28,Grenoble,Ligue 2,6.5,15,8,7,8,0,4,15,26.7,11,7,4,3,12,27,6,1
Nolan Norris,USA,MF,17,FC Dallas,MLS,1.5,2,2,1,1,0,2,3,66.7,1,1,1,0,0,2,2,0
Nordine Kandil,FRA,"FW,MF",21,Annecy,Ligue 2,28.1,59,36,16,31,12,34,72,47.2,38,15,1,14,8,67,4,0
Norman Bassette,BEL,FW,18,Caen,Ligue 2,0.0,0,0,0,0,0,0,0,0.0,0,0,0,0,0,0,0,0
Nouha Dicko,MLI,FW,31,Paris FC,Ligue 2,13.4,16,13,4,8,4,3,6,50.0,3,11,0,11,2,18,0,0
Nouhou Tolo,CMR,DF,25,Seattle,MLS,22.8,50,41,35,13,2,36,52,69.2,16,26,6,20,21,71,77,0
Novak Mićović,SRB,GK,21,LA Galaxy,MLS,2.0,0,0,0,0,0,0,0,0.0,0,0,0,0,0,0,0,0
Noé Lebreton,FRA,MF,19,Caen,Ligue 2,19.4,61,43,26,30,5,20,39,51.3,19,49,10,39,36,97,41,0
Noé Sow,SEN,"DF,MF",24,Pau FC,Ligue 2,1.7,7,3,4,3,0,3,8,37.5,5,0,0,0,2,9,4,0
Nuno Santos,POR,MF,23,Charlotte,MLS,2.4,4,0,0,4,0,3,4,75.0,1,3,1,2,2,6,0,0
Nuno da Costa,CPV,FW,32,Auxerre,Ligue 2,2.0,6,3,1,5,0,1,2,50.0,1,1,0,1,1,7,1,0
Nunzio Lella,ITA,MF,23,Venezia,Serie B,9.1,13,6,4,5,4,2,4,50.0,2,11,1,10,4,17,12,0
Néstor Araujo,MEX,DF,31,América,Liga MX,5.9,7,4,3,4,0,3,4,75.0,1,3,3,0,13,20,36,0
Néstor Vidrio,MEX,DF,34,Mazatlán,Liga MX,3.2,5,3,5,0,0,4,6,66.7,2,6,3,3,3,8,23,0
Nícolas Andrade,BRA,GK,35,Pisa,Serie B,31.0,1,0,1,0,0,1,1,100.0,0,1,0,1,1,2,15,4
Nökkvi Þórisson,ISL,"FW,MF",23,St. Louis,MLS,3.0,8,1,4,3,1,2,6,33.3,4,7,0,7,3,11,2,0
Núñez,ESP,"DF,MF",23,Amorebieta,Segunda Division,35.0,55,34,33,20,2,31,53,58.5,22,28,13,15,34,89,66,0
O'Vonte Mullings,CAN,"MF,DF",22,NY Red Bulls,MLS,0.5,1,1,1,0,0,0,0,0.0,0,1,0,1,2,3,0,0
Obed Nkambadio,FRA,GK,20,Paris FC,Ligue 2,29.5,0,0,0,0,0,0,0,0.0,0,0,0,0,0,0,16,1
Obed Vargas,USA,MF,17,Seattle,MLS,14.7,36,22,14,17,5,16,36,44.4,20,18,3,15,17,53,12,0
Obinna Nwobodo,NGA,MF,26,FC Cincinnati,MLS,28.7,87,62,32,45,10,38,87,43.7,49,34,1,33,55,142,45,0
Oier Luengo,ESP,DF,26,Oviedo,Segunda Division,33.2,44,21,27,16,1,20,46,43.5,26,36,23,13,29,73,90,2
Okay Yokuşlu,TUR,MF,29,West Brom,EFL,35.8,66,43,25,35,6,36,57,63.2,21,31,15,16,48,114,74,2
Oladapo Afolayan,ENG,"FW,MF",25,St. Pauli,2. Bundesliga,24.5,25,16,11,7,7,8,25,32.0,17,25,4,21,10,35,16,1
Oliver Abildgaard,DEN,MF,27,Como,Serie B,20.7,28,13,13,11,4,13,22,59.1,9,24,14,10,73,101,70,0
Oliver Burke,SCO,"FW,MF",26,Birmingham City,EFL,11.2,12,8,3,7,2,8,14,57.1,6,4,1,3,7,19,11,0
Oliver Christensen,DEN,GK,24,Hertha BSC,2. Bundesliga,2.0,0,0,0,0,0,0,0,0.0,0,0,0,0,0,0,2,0
Oliver Cooper,WAL,"MF,FW",23,Swansea City,EFL,13.6,42,27,18,18,6,16,31,51.6,15,17,1,16,12,54,15,0
Oliver Hüsing,GER,DF,30,Hansa Rostock,2. Bundesliga,9.8,16,13,12,4,0,9,12,75.0,3,18,12,6,13,29,75,1
Oliver Larraz,USA,MF,21,Rapids,MLS,0.2,1,1,1,0,0,0,0,0.0,0,1,0,1,0,1,0,0
Oliver Rathbone,ENG,MF,26,Rotherham Utd,EFL,36.5,84,53,37,37,10,30,87,34.5,57,44,8,36,49,133,38,1
Oliver Turton,ENG,DF,30,Huddersfield,EFL,1.9,1,1,0,1,0,1,1,100.0,0,4,2,2,1,2,5,0
Olivier Mbaizo,CMR,DF,25,Philadelphia,MLS,20.4,26,15,13,12,1,8,26,30.8,18,13,2,11,23,49,27,2
Ollie Tanner,ENG,"FW,DF",21,Cardiff City,EFL,13.7,34,21,13,15,6,13,37,35.1,24,14,0,14,16,50,15,1
Omar Campos,MEX,DF,21,Santos,Liga MX,18.7,56,35,36,17,3,29,58,50.0,29,26,7,19,20,76,39,0
Omar El Hilali,MAR,DF,20,Espanyol,Segunda Division,31.9,90,57,60,26,4,48,72,66.7,24,51,16,35,35,125,75,0
Omar Fernández Frasica,COL,"MF,FW",30,León,Liga MX,4.0,3,2,2,1,0,1,8,12.5,7,8,0,8,3,6,2,0
Omar Gonzalez,USA,DF,34,NE Revolution,MLS,9.6,6,4,2,3,1,2,6,33.3,4,14,11,3,5,11,53,0
Omar Govea,MEX,MF,27,Monterrey,Liga MX,18.0,26,18,12,13,1,10,32,31.3,22,15,3,12,21,47,23,1
Omar Israel Mendoza,MEX,"DF,MF",34,Querétaro,Liga MX,22.0,42,26,31,10,1,27,50,54.0,23,26,11,15,45,87,55,0
Omar Megeed,GER,FW,17,Hamburger SV,2. Bundesliga,0.0,0,0,0,0,0,0,0,0.0,0,0,0,0,0,0,0,0
Omar Moreno,MEX,"FW,DF",18,Mazatlán,Liga MX,0.6,0,0,0,0,0,0,0,0.0,0,0,0,0,0,0,0,0
Omar Sadik,MAR,FW,20,Espanyol,Segunda Division,1.3,2,1,0,2,0,1,1,100.0,0,1,0,1,0,2,0,0
Omar Sissoko,FRA,FW,16,Paris FC,Ligue 2,0.1,0,0,0,0,0,0,0,0.0,0,0,0,0,0,0,0,0
Omari Hutchinson,ENG,"FW,MF",19,Ipswich Town,EFL,24.4,54,28,20,20,14,20,67,29.9,47,48,3,45,15,69,7,0
Omir Fernandez,USA,"MF,FW",23,NY Red Bulls,MLS,19.4,30,17,11,10,9,16,37,43.2,21,23,2,21,8,38,9,0
Onel Hernández,CUB,"FW,MF",30,Norwich City,EFL,13.2,32,14,15,11,6,12,35,34.3,23,23,1,22,13,45,7,0
Opa Sanganté,GNB,DF,32,Dunkerque,Ligue 2,32.9,46,30,37,7,2,23,31,74.2,8,44,23,21,33,79,122,1
Orestis Kiomourtzoglou,GER,"MF,DF",25,Greuther Fürth,2. Bundesliga,3.2,7,3,1,6,0,2,4,50.0,2,7,2,5,2,9,3,0
Oriol Rey,ESP,MF,26,Levante,Segunda Division,32.4,48,28,26,17,5,19,43,44.2,24,31,10,21,32,80,51,0
Oriol Rosell,ESP,MF,30,LA Galaxy,MLS,9.4,18,11,8,7,3,5,17,29.4,12,13,3,10,6,24,14,1
Orji Okwonkwo,NGA,FW,25,Reggiana,Serie B,1.7,2,2,0,1,1,1,1,100.0,0,2,0,2,0,2,1,0
Osaze Urhoghide,NED,DF,23,Amiens,Ligue 2,15.4,28,22,18,9,1,14,20,70.0,6,23,7,16,25,53,77,0
Oscar Estupiñan,COL,FW,26,Hull City,EFL,0.8,0,0,0,0,0,0,0,0.0,0,2,1,1,0,0,1,0
Oscar Jiménez,MEX,GK,34,América,Liga MX,5.5,1,0,1,0,0,1,1,100.0,0,0,0,0,0,1,1,0
Oscar Macías,MEX,MF,25,Atlético,Liga MX,0.5,1,1,0,1,0,0,3,0.0,3,2,0,2,0,1,0,0
Oscar Ureña,ESP,"MF,FW",21,Leganés,Segunda Division,5.2,9,5,3,5,1,2,6,33.3,4,3,2,1,0,9,5,0
Oscar Villa,MEX,DF,22,León,Liga MX,0.5,2,2,0,1,1,0,2,0.0,2,2,0,2,1,3,1,0
Osman Kakay,SLE,DF,25,QPR,EFL,17.5,33,22,17,13,3,13,23,56.5,10,16,6,10,12,45,46,0
Osvaldo Alonso,CUB,MF,37,Atlanta Utd,MLS,1.1,2,2,0,1,1,0,4,0.0,4,4,3,1,0,2,1,0
Osvaldo Rodríguez del Portal,MEX,DF,26,León,Liga MX,22.3,53,30,29,22,2,28,39,71.8,11,23,9,14,30,83,56,1
Oualid Mhamdi,MAR,DF,20,Greuther Fürth,2. Bundesliga,2.7,3,3,1,1,1,2,2,100.0,0,4,1,3,3,6,14,1
Oumar Diakhite,SEN,DF,29,Osnabrück,2. Bundesliga,16.5,22,14,18,4,0,14,20,70.0,6,22,9,13,12,34,110,2
Oumar Diakité,FRA,MF,20,Paris FC,Ligue 2,0.1,0,0,0,0,0,0,1,0.0,1,0,0,0,0,0,0,0
Oumar Ngom,MTN,MF,19,Pau FC,Ligue 2,4.8,13,7,5,6,2,5,13,38.5,8,9,3,6,6,19,9,0
Ousman jabang,USA,DF,21,CF Montréal,MLS,0.9,3,0,3,0,0,3,4,75.0,1,2,2,0,2,5,3,1
Ousmane Camara,GUI,FW,21,Auxerre,Ligue 2,2.7,6,3,1,3,2,1,3,33.3,2,3,0,3,0,6,1,0
Ousmane Camara,GUI,FW,21,Annecy,Ligue 2,11.9,21,13,2,9,10,8,21,38.1,13,24,2,22,4,25,6,0
Ousmane Camara,FRA,"MF,DF",20,Angers,Ligue 2,1.0,1,1,0,1,0,1,1,100.0,0,1,0,1,2,3,4,0
Ousmane Doumbia,CIV,MF,30,Fire,MLS,9.0,19,11,11,7,1,9,23,39.1,14,10,3,7,15,34,7,1
Ousmane Kanté,GUI,DF,33,Pau FC,Ligue 2,11.0,29,16,15,14,0,15,22,68.2,7,11,7,4,28,57,58,0
Oussama Haddadi,TUN,DF,31,Greuther Fürth,2. Bundesliga,16.2,28,16,13,11,4,12,26,46.2,14,17,1,16,16,44,33,2
Oussama Idrissi,MAR,"FW,MF",27,Pachuca,Liga MX,16.6,24,16,8,12,4,8,32,25.0,24,20,0,20,7,31,2,2
Ousseni Bouda,BFA,"FW,MF",22,SJ Earthquakes,MLS,1.7,2,0,0,1,1,0,0,0.0,0,2,1,1,2,4,0,0
Owen González,MEX,"FW,MF",20,Pachuca,Liga MX,2.4,1,0,1,0,0,0,1,0.0,1,3,0,3,1,2,0,0
Owen Géne,FRA,MF,20,Amiens,Ligue 2,24.2,73,53,37,25,11,38,86,44.2,48,62,11,51,31,104,43,0
Owen Martinez Jullien,FRA,MF,18,Ajaccio,Ligue 2,0.6,3,3,0,3,0,1,2,50.0,1,0,0,0,3,6,0,0
Owen Wolff,USA,MF,18,Austin,MLS,20.9,27,12,15,11,1,15,39,38.5,24,23,6,17,23,50,21,1
Ozan Tufan,TUR,"MF,FW",28,Hull City,EFL,23.6,26,20,7,11,8,8,20,40.0,12,28,2,26,7,33,16,0
Ozziel Herrera,MEX,"FW,MF",22,UANL,Liga MX,9.8,21,12,11,8,2,6,14,42.9,8,13,1,12,9,30,11,0
Pablo Barrera,MEX,"MF,FW",36,Querétaro,Liga MX,30.7,36,14,11,23,2,15,42,35.7,27,23,3,20,19,55,15,1
Pablo Bennevendo Peña,MEX,DF,23,UNAM,Liga MX,17.0,51,31,32,17,2,31,44,70.5,13,19,2,17,14,65,41,1
Pablo Bonilla,VEN,DF,23,Portland Timbers,MLS,0.8,2,2,0,1,1,2,4,50.0,2,2,1,1,0,2,2,0
Pablo Cortés,ESP,DF,20,Zaragoza,Segunda Division,0.0,0,0,0,0,0,0,0,0.0,0,0,0,0,0,0,0,0
Pablo Cuñat,ESP,GK,22,Amorebieta,Segunda Division,26.0,0,0,0,0,0,0,0,0.0,0,0,0,0,0,0,23,1
Pablo García,ESP,"DF,MF",24,Sporting Gijón,Segunda Division,9.5,23,15,15,5,3,16,25,64.0,9,13,4,9,12,35,22,0
Pablo González Díaz,MEX,MF,31,Puebla,Liga MX,26.6,62,46,31,29,2,26,48,54.2,22,30,18,12,62,124,61,1
Pablo Hernández,SPA,MF,23,Tenerife,Segunda Division,0.1,0,0,0,0,0,0,1,0.0,1,0,0,0,0,0,0,0
Pablo Insua,ESP,DF,30,Sporting Gijón,Segunda Division,29.0,47,25,32,13,2,25,44,56.8,19,31,20,11,36,83,123,0
Pablo Martínez,ESP,MF,26,Levante,Segunda Division,25.8,38,22,21,15,2,19,52,36.5,33,31,14,17,37,75,34,0
Pablo Monroy,MEX,DF,21,UNAM,Liga MX,15.7,26,18,15,10,1,7,28,25.0,21,10,0,10,11,37,29,0
Pablo Moreno,ESP,"MF,FW",22,FC Andorra,Segunda Division,2.8,2,2,0,1,1,1,3,33.3,2,1,0,1,2,4,2,0
Pablo Ortiz,MEX,DF,21,Querétaro,Liga MX,7.4,21,12,16,5,0,14,25,56.0,11,7,0,7,10,31,20,1
Pablo Pagis,FRA,"MF,FW",20,Stade Laval,Ligue 2,12.2,21,13,9,6,6,12,31,38.7,19,15,1,14,9,30,3,0
Pablo Ramon,ESP,DF,22,CD Mirandés,Segunda Division,33.1,52,31,34,14,4,31,42,73.8,11,45,25,20,48,100,119,1
Pablo Rodríguez,ESP,"FW,MF",21,Ascoli,Serie B,25.2,15,10,5,6,4,3,19,15.8,16,22,0,22,7,22,9,0
Pablo Ruíz,ARG,MF,24,RSL,MLS,15.3,42,28,22,20,0,25,56,44.6,31,23,3,20,15,57,8,2
Pablo Sisniega,MEX,GK,27,Charlotte,MLS,3.0,0,0,0,0,0,0,0,0.0,0,0,0,0,0,0,2,0
Pablo Tomeo,ESP,"MF,DF",24,CD Mirandés,Segunda Division,15.7,40,22,23,14,3,24,41,58.5,17,13,7,6,23,63,42,0
Pablo Íñiguez,ESP,DF,30,Villarreal B,Segunda Division,15.0,16,12,13,2,1,10,16,62.5,6,26,18,8,12,28,66,1
Paco Cortés,ESP,MF,16,Levante,Segunda Division,0.5,0,0,0,0,0,0,0,0.0,0,1,0,1,0,0,1,0
Paddy McNair,NIR,DF,28,Middlesbrough,EFL,19.5,14,8,8,4,2,8,16,50.0,8,19,12,7,11,25,40,0
Paik Seung-ho,KOR,MF,26,Birmingham City,EFL,14.6,27,15,10,13,4,12,26,46.2,14,20,4,16,5,32,27,1
Pajtim Kasami,SUI,MF,31,Sampdoria,Serie B,22.0,36,24,18,12,6,21,47,44.7,26,35,5,30,14,50,36,0
Palkó Dárdai,HUN,"MF,FW",24,Hertha BSC,2. Bundesliga,15.8,17,11,9,7,1,5,19,26.3,14,16,2,14,3,20,6,0
Panos Katseris,GRE,DF,22,Catanzaro,Serie B,11.1,20,16,14,5,1,12,21,57.1,9,10,2,8,11,31,26,0
Paolo Ghiglione,ITA,DF,26,Cremonese,Serie B,10.3,11,10,4,5,2,10,18,55.6,8,13,2,11,4,15,19,0
Paolo Rozzio,ITA,DF,31,Reggiana,Serie B,23.6,21,13,16,5,0,11,13,84.6,2,21,15,6,25,46,134,0
Paolo Yrizar,MEX,MF,25,Querétaro,Liga MX,0.2,2,1,1,1,0,0,1,0.0,1,0,0,0,0,2,0,0
Papa Ndiaga Yade,MTN,"MF,FW",23,Quevilly-Rouen,Ligue 2,16.6,29,17,9,14,6,10,27,37.0,17,23,0,23,8,37,10,0
Pape Ibnou Bâ,MTN,"FW,MF",30,US Concarneau,Ligue 2,26.4,7,5,1,4,2,2,11,18.2,9,8,2,6,1,8,16,0
Pape Massar Djitte,SEN,FW,20,Pau FC,Ligue 2,0.3,1,1,0,0,1,0,1,0.0,1,0,0,0,1,2,0,0
Pape Ousmane Sakho,SEN,MF,26,Quevilly-Rouen,Ligue 2,0.3,0,0,0,0,0,0,0,0.0,0,0,0,0,0,0,0,0
Pascal Klemens,GER,"MF,DF",18,Hertha BSC,2. Bundesliga,17.4,30,17,18,11,1,19,47,40.4,28,21,4,17,9,39,31,0
Pascal Struijk,NED,DF,23,Leeds United,EFL,22.1,31,22,15,14,2,15,21,71.4,6,24,12,12,19,50,73,1
Pascu,ESP,"FW,MF",21,Villarreal B,Segunda Division,27.7,13,6,3,6,4,6,17,35.3,11,29,6,23,3,16,30,0
Paterson Chato,GER,DF,26,Osnabrück,2. Bundesliga,0.6,0,0,0,0,0,0,0,0.0,0,1,1,0,1,1,0,0
Patricio Salas,MEX,"FW,DF",19,América,Liga MX,0.4,0,0,0,0,0,0,0,0.0,0,0,0,0,0,0,0,0
Patrick Agyemang,USA,FW,22,Charlotte,MLS,2.1,0,0,0,0,0,0,1,0.0,1,2,0,2,0,0,3,0
Patrick Bamford,ENG,"FW,MF",29,Leeds United,EFL,16.6,17,10,0,12,5,10,17,58.8,7,4,0,4,2,19,10,0
Patrick Bauer,GER,DF,30,Preston,EFL,0.7,0,0,0,0,0,0,0,0.0,0,2,1,1,0,0,4,0
Patrick Cutrone,ITA,FW,25,Como,Serie B,27.4,10,5,4,5,1,3,12,25.0,9,11,0,11,10,20,23,0
Patrick Drewes,GER,GK,30,Karlsruher,2. Bundesliga,32.0,1,1,1,0,0,1,1,100.0,0,1,0,1,0,1,6,5
Patrick Erras,GER,DF,28,Holstein Kiel,2. Bundesliga,23.0,20,13,14,6,0,7,11,63.6,4,30,26,4,17,37,111,0
Patrick Jones,WAL,"FW,MF",20,Huddersfield,EFL,1.8,3,2,2,0,1,1,2,50.0,1,3,0,3,2,5,0,0
Patrick Nuamah,ITA,MF,17,Brescia,Serie B,0.0,0,0,0,0,0,0,0,0.0,0,0,0,0,0,0,0,0
Patrick Roberts,ENG,"MF,FW",26,Sunderland,EFL,20.5,22,12,10,3,9,8,26,30.8,18,11,0,11,6,28,9,0
Patrick Schulte,USA,GK,21,Crew,MLS,31.0,0,0,0,0,0,0,1,0.0,1,0,0,0,0,0,7,2
Patrick Villa,MEX,DF,19,Puebla,Liga MX,0.7,2,2,0,2,0,0,0,0.0,0,1,0,1,0,2,3,0
Patrizio Masini,ITA,MF,22,Ascoli,Serie B,20.8,75,43,25,31,19,37,59,62.7,22,35,7,28,21,96,33,0
Patson Daka,ZAM,FW,24,Leicester City,EFL,12.1,12,8,2,4,6,3,6,50.0,3,8,1,7,2,14,8,0
Pau Cabanes,ESP,FW,19,Villarreal B,Segunda Division,0.3,0,0,0,0,0,0,1,0.0,1,0,0,0,0,0,0,0
Pau Navarro,ESP,"DF,MF",19,Villarreal B,Segunda Division,11.1,25,13,15,7,3,10,16,62.5,6,10,7,3,13,38,38,1
Pau Sans,ESP,"MF,FW",19,Zaragoza,Segunda Division,0.4,1,0,0,0,1,1,4,25.0,3,1,0,1,0,1,1,0
Paul Arriola,USA,"FW,MF",27,FC Dallas,MLS,18.4,22,16,7,11,4,11,28,39.3,17,9,1,8,10,32,9,0
Paul Bellón,MEX,DF,26,León,Liga MX,14.8,30,17,24,5,1,20,34,58.8,14,19,13,6,24,54,63,1
Paul Joly,FRA,DF,23,Auxerre,Ligue 2,30.3,98,71,46,45,7,61,113,54.0,52,50,2,48,68,166,66,0
Paul Lasne,FRA,MF,34,Paris FC,Ligue 2,1.6,7,5,3,4,0,2,4,50.0,2,1,0,1,5,12,1,0
Paul Marie,FRA,DF,27,SJ Earthquakes,MLS,22.3,65,37,41,17,7,37,80,46.3,43,41,7,34,26,91,47,0
Paul Nebel,GER,MF,20,Karlsruher,2. Bundesliga,30.8,50,28,16,23,11,18,46,39.1,28,32,7,25,24,74,26,0
Paul Rothrock,USA,FW,24,Seattle,MLS,0.5,3,3,1,1,1,0,0,0.0,0,0,0,0,0,3,0,0
Paul Seguin,GER,MF,28,Schalke 04,2. Bundesliga,25.4,39,30,17,17,5,16,45,35.6,29,20,6,14,21,60,30,0
Paul Smyth,NIR,"FW,MF",25,QPR,EFL,24.3,36,22,22,10,4,15,41,36.6,26,35,2,33,17,53,25,0
Paul Stock,GER,"MF,FW",26,Elversberg,2. Bundesliga,21.8,38,22,11,22,5,18,43,41.9,25,24,4,20,15,53,24,1
Paul Wanner,GER,"MF,FW",17,Elversberg,2. Bundesliga,18.8,38,27,13,14,11,18,36,50.0,18,25,0,25,3,41,15,0
Paulino,ESP,"FW,MF",26,Oviedo,Segunda Division,16.2,24,12,6,10,8,11,24,45.8,13,11,1,10,4,28,9,0
Paulino,ESP,MF,26,Pachuca,Liga MX,1.4,3,0,1,1,1,1,3,33.3,2,1,0,1,1,4,0,0
Pavel Pérez,MEX,FW,25,Guadalajara,Liga MX,12.1,30,16,10,14,6,12,26,46.2,14,8,1,7,4,34,7,0
Paxton Pomykal,USA,MF,23,FC Dallas,MLS,17.8,37,27,16,15,6,18,49,36.7,31,26,7,19,28,65,15,0
Pedro Alcalá,ESP,DF,35,Cartagena,Segunda Division,36.8,32,25,26,6,0,11,18,61.1,7,32,21,11,27,59,199,0
Pedro Aquino,PER,MF,28,Santos,Liga MX,18.8,56,40,21,34,1,28,53,52.8,25,25,10,15,23,79,42,0
Pedro Benito,ESP,FW,24,Albacete,Segunda Division,0.6,2,0,0,2,0,0,0,0.0,0,0,0,0,0,2,0,0
Pedro Bigas,ESP,DF,33,Elche,Segunda Division,34.8,25,13,23,2,0,15,27,55.6,12,33,26,7,34,59,127,2
Pedro Capó,ESP,"MF,DF",33,Eldense,Segunda Division,11.1,21,12,10,11,0,9,14,64.3,5,10,5,5,17,38,30,0
Pedro Díaz,ESP,MF,25,Bordeaux,Ligue 2,32.7,64,34,22,37,5,31,80,38.8,49,39,2,37,40,104,16,0
Pedro Gallese,PER,GK,32,Orlando City,MLS,30.0,1,1,1,0,0,0,0,0.0,0,1,0,1,0,1,10,1
Pedro Mendes,POR,FW,23,Ascoli,Serie B,24.5,8,4,1,3,4,5,11,45.5,6,15,5,10,11,19,25,0
Pedro Mosquera,ESP,MF,36,Alcorcón,Segunda Division,20.2,39,23,25,12,2,20,45,44.4,25,28,6,22,16,55,37,1
Pedro Pedraza,MEX,MF,23,Pachuca,Liga MX,16.2,64,35,23,34,7,34,62,54.8,28,28,5,23,29,93,11,0
Pedro Raul,BRA,"FW,MF",26,Toluca,Liga MX,6.6,1,1,0,0,1,1,7,14.3,6,5,2,3,0,1,6,0
Pedro Santos,POR,"DF,MF",34,D.C. United,MLS,16.7,56,40,34,20,2,35,65,53.8,30,22,2,20,10,66,23,1
Pedro Vite,ECU,"MF,FW",20,Vancouver W'caps,MLS,23.9,42,28,14,22,6,11,44,25.0,33,37,0,37,26,68,6,0
Pelle Boevink,NED,GK,25,Paderborn 07,2. Bundesliga,20.0,1,1,1,0,0,1,5,20.0,4,1,0,1,1,2,9,2
Peque,ESP,"MF,FW",21,Racing Sant,Segunda Division,31.5,59,33,16,31,12,21,49,42.9,28,35,4,31,9,68,15,0
Pere Milla,ESP,"FW,MF",31,Espanyol,Segunda Division,27.8,36,24,10,18,8,22,51,43.1,29,28,4,24,15,51,25,0
Pere Milla,ESP,FW,31,Elche,Segunda Division,0.1,0,0,0,0,0,0,0,0.0,0,0,0,0,0,0,0,0
Perry Ng,ENG,DF,27,Cardiff City,EFL,37.8,109,75,57,39,13,59,84,70.2,25,53,10,43,61,170,110,1
Peru Nolaskoain,ESP,MF,25,Eibar,Segunda Division,11.4,25,13,13,11,1,16,24,66.7,8,17,8,9,22,47,52,0
Petar Stojanović,SVN,"DF,FW",27,Sampdoria,Serie B,20.4,38,23,24,10,4,29,45,64.4,16,20,3,17,18,56,46,0
Peter Kioso,IRL,"DF,FW",24,Rotherham Utd,EFL,10.6,34,23,17,16,1,18,30,60.0,12,22,3,19,6,40,21,0
Peter Ouaneh,FRA,DF,25,Stade Laval,Ligue 2,13.8,20,13,10,6,4,10,27,37.0,17,19,7,12,27,47,59,0
Peter Pekarík,SVK,DF,36,Hertha BSC,2. Bundesliga,1.4,1,1,1,0,0,1,2,50.0,1,2,1,1,3,4,8,0
Peter Stroud,USA,MF,20,NY Red Bulls,MLS,11.3,30,24,8,22,0,16,28,57.1,12,17,2,15,21,51,3,0
Petko Hristov,BUL,DF,24,Spezia,Serie B,17.8,15,8,9,6,0,4,7,57.1,3,20,15,5,11,26,79,1
Phil Neumann,GER,DF,26,Hannover 96,2. Bundesliga,32.0,56,37,30,24,2,26,38,68.4,12,51,25,26,32,88,142,1
Philip Heise,GER,DF,32,Karlsruher,2. Bundesliga,20.6,29,16,19,7,3,20,32,62.5,12,13,6,7,15,44,43,0
Philip Quinton,USA,DF,23,Crew,MLS,10.4,10,4,7,2,1,5,14,35.7,9,8,5,3,18,28,33,0
Philipp Hercher,GER,"FW,DF",27,Kaiserslautern,2. Bundesliga,1.4,2,2,2,0,0,0,1,0.0,1,0,0,0,1,3,3,0
Philipp Klement,GER,MF,30,Kaiserslautern,2. Bundesliga,3.2,6,4,2,4,0,1,5,20.0,4,4,0,4,5,11,1,1
Philipp Kühn,GER,GK,30,Osnabrück,2. Bundesliga,18.9,0,0,0,0,0,0,0,0.0,0,0,0,0,0,0,7,0
Philipp Müller,GER,MF,19,Greuther Fürth,2. Bundesliga,2.1,6,5,2,2,2,2,3,66.7,1,5,0,5,1,7,7,0
Philipp Sander,GER,MF,25,Holstein Kiel,2. Bundesliga,23.0,43,27,18,21,4,13,34,38.2,21,25,4,21,28,71,34,2
Philipp Treu,GER,"MF,DF",22,St. Pauli,2. Bundesliga,16.6,38,21,16,20,2,23,36,63.9,13,29,5,24,14,52,37,1
Piero Quispe,PER,MF,21,UNAM,Liga MX,10.7,25,18,6,13,6,7,21,33.3,14,9,0,9,10,35,3,0
Pierre Ekwah Elimby,FRA,MF,21,Sunderland,EFL,33.5,58,30,22,28,8,32,60,53.3,28,45,10,35,36,94,38,0
Pierre Jouan,FRA,MF,21,US Concarneau,Ligue 2,0.1,0,0,0,0,0,0,2,0.0,2,0,0,0,0,0,0,0
Pierre Lemonnier,FRA,DF,30,Guingamp,Ligue 2,28.8,37,24,17,15,5,18,33,54.5,15,23,16,7,54,91,142,0
Pierre-Yves Hamel,FRA,"FW,MF",29,Paris FC,Ligue 2,13.8,12,8,3,9,0,3,15,20.0,12,10,2,8,6,18,24,0
Pierrick Capelle,FRA,MF,36,Angers,Ligue 2,33.0,65,37,23,36,6,23,76,30.3,53,40,4,36,47,112,49,0
Pietro Beruatto,ITA,DF,24,Pisa,Serie B,23.9,38,21,18,17,3,20,31,64.5,11,38,12,26,36,74,45,0
Pietro Candelari,ITA,"DF,MF",18,Spezia,Serie B,2.0,5,4,3,1,1,4,5,80.0,1,3,0,3,1,6,1,0
Pietro Ceccaroni,ITA,DF,27,Palermo,Serie B,27.9,33,23,16,15,2,11,22,50.0,11,40,25,15,30,63,121,1
Pietro Iemmello,ITA,FW,31,Catanzaro,Serie B,27.9,15,8,4,10,1,3,9,33.3,6,10,1,9,5,20,22,1
Pietro Martino,ITA,DF,25,Cosenza,Serie B,9.8,12,7,9,1,2,9,18,50.0,9,9,4,5,8,20,28,0
Pinchi,ESP,FW,28,Racing Ferrol,Segunda Division,10.2,22,13,9,10,3,8,20,40.0,12,25,2,23,8,30,7,0
Pipa,ESP,"DF,MF",25,West Brom,EFL,2.8,7,4,4,1,2,4,6,66.7,2,4,0,4,1,8,4,0
Piña,ESP,DF,29,Eldense,Segunda Division,26.0,16,8,11,4,1,6,8,75.0,2,20,14,6,24,40,126,1
Pol Lozano,ESP,MF,24,Espanyol,Segunda Division,17.0,33,17,16,15,2,23,37,62.2,14,26,4,22,11,44,20,1
Pol Moreno,ESP,DF,30,Racing Sant,Segunda Division,8.7,11,8,9,1,1,6,8,75.0,2,10,5,5,6,17,54,1
Pol Valentín,ESP,"DF,MF",26,Sheffield Weds,EFL,24.5,54,27,35,17,2,32,51,62.7,19,31,11,20,19,73,47,0
Preston Judd,USA,FW,23,LA Galaxy,MLS,7.1,2,1,0,1,1,1,4,25.0,3,3,1,2,1,3,5,0
Prince Osei Owusu,GER,FW,26,Toronto FC,MLS,2.9,3,2,1,2,0,2,2,100.0,0,1,0,1,1,4,6,0
Przemysław Płacheta,POL,FW,25,Swansea City,EFL,7.4,14,11,4,8,2,2,6,33.3,4,5,0,5,0,14,2,0
Przemysław Płacheta,POL,"FW,DF",25,Norwich City,EFL,5.1,6,5,2,3,1,3,8,37.5,5,6,0,6,1,7,8,1
Przemysław Szymiński,POL,DF,29,Reggiana,Serie B,13.3,15,8,14,1,0,7,8,87.5,1,12,9,3,19,34,53,0
Przemysław Wiśniewski,POL,DF,25,Spezia,Serie B,0.1,0,0,0,0,0,0,0,0.0,0,0,0,0,0,0,1,0
Quentin Daubin,FRA,MF,28,Caen,Ligue 2,24.8,95,63,32,56,7,45,78,57.7,33,27,2,25,32,127,36,0
Quentin Lecoeuche,FRA,DF,30,Zaragoza,Segunda Division,17.3,22,12,13,9,0,13,21,61.9,8,17,4,13,20,42,37,0
Quentin Westberg,USA,GK,36,Atlanta Utd,MLS,5.5,0,0,0,0,0,0,0,0.0,0,0,0,0,0,0,1,0
Quinn Sullivan,USA,"FW,MF",18,Philadelphia,MLS,7.7,7,5,1,6,0,2,9,22.2,7,8,0,8,6,13,4,0
Quique,ESP,FW,34,Eibar,Segunda Division,6.4,0,0,0,0,0,0,1,0.0,1,4,0,4,0,0,3,0
Rachid Kouda,ITA,"MF,FW",21,Spezia,Serie B,15.0,19,10,10,8,1,9,24,37.5,15,23,2,21,10,29,20,0
Radinio Balker,SUR,DF,24,Huddersfield,EFL,4.5,11,8,3,8,0,2,4,50.0,2,3,3,0,8,19,20,0
Rafa Tresaco,ESP,"MF,FW",23,Huesca,Segunda Division,3.2,4,2,1,2,1,3,11,27.3,8,4,0,4,4,8,2,0
Rafael Bauza,ESP,MF,19,Espanyol,Segunda Division,1.0,4,1,2,2,0,1,1,100.0,0,0,0,0,3,7,1,0
Rafael Carioca,BRA,MF,34,UANL,Liga MX,29.5,73,39,33,35,5,38,67,56.7,29,22,5,17,22,95,20,3
Rafael Czichos,GER,DF,32,Fire,MLS,27.9,48,34,33,13,2,24,39,61.5,15,35,18,17,44,92,103,1
Rafael Fernández,MEX,DF,22,Tijuana,Liga MX,13.7,30,12,15,10,5,13,29,44.8,16,16,8,8,10,40,49,1
Rafael Guerrero,MEX,DF,20,Cruz Azul,Liga MX,6.4,13,12,10,3,0,8,11,72.7,3,6,4,2,19,32,8,1
Rafael Navarro,BRA,FW,22,Rapids,MLS,9.8,7,6,0,6,1,0,8,0.0,8,8,2,6,5,12,7,0
Rafael Nuñez,DOM,"MF,DF",22,Elche,Segunda Division,2.1,2,1,1,0,1,2,5,40.0,3,5,0,5,0,2,0,0
Rafael Santos,BRA,DF,24,Orlando City,MLS,22.1,46,25,30,11,5,21,37,56.8,16,17,3,14,27,73,46,0
Rafał Strączek,POL,GK,24,Bordeaux,Ligue 2,16.0,2,1,2,0,0,2,3,66.7,1,1,0,1,0,2,5,4
Raffaele Cartano,ITA,DF,20,Brescia,Serie B,0.1,1,0,0,1,0,1,1,100.0,0,0,0,0,0,1,0,0
Raffaele Celia,ITA,DF,24,Ascoli,Serie B,7.3,10,6,3,6,1,5,11,45.5,6,7,0,7,8,18,15,1
Raffaele Maiello,ITA,MF,32,Bari,Serie B,11.0,25,12,14,11,0,5,16,31.3,11,10,2,8,23,48,27,0
Raffaele Pucino,ITA,DF,32,Bari,Serie B,14.5,15,12,8,6,1,11,14,78.6,3,9,6,3,18,33,37,0
Rafiki Said,COM,"FW,MF",23,Troyes,Ligue 2,27.5,36,27,14,13,9,16,35,45.7,19,24,3,21,21,57,29,0
Ragnar Ache,GER,FW,25,Kaiserslautern,2. Bundesliga,19.8,6,3,1,5,0,1,10,10.0,9,14,4,10,2,8,41,0
Raheem Conte,ENG,DF,20,Cardiff City,EFL,1.0,3,1,2,1,0,1,1,100.0,0,1,0,1,1,4,1,0
Raheem Edwards,CAN,DF,27,LA Galaxy,MLS,20.8,58,33,32,18,8,33,63,52.4,30,31,5,26,24,82,45,1
Rai Marchán,ESP,MF,30,Albacete,Segunda Division,6.3,18,13,9,9,0,4,9,44.4,5,12,2,10,6,24,10,0
Raimonds Krollis,LVA,"FW,MF",21,Spezia,Serie B,1.4,6,5,2,1,3,1,2,50.0,1,3,0,3,0,6,1,0
Ralf Fährmann,GER,GK,34,Schalke 04,2. Bundesliga,9.0,0,0,0,0,0,0,1,0.0,1,0,0,0,1,1,5,0
Ralph Orquin,USA,DF,20,FC Juárez,Liga MX,8.2,11,9,6,5,0,7,7,100.0,0,9,3,6,10,21,11,0
Ralph Priso-Mbongue,CAN,MF,20,Rapids,MLS,11.5,28,14,18,7,3,12,27,44.4,15,11,1,10,9,37,12,0
Ramiro Enrique,ARG,FW,21,Orlando City,MLS,11.5,12,6,5,3,4,3,6,50.0,3,7,0,7,4,16,13,0
Ramiro Franco,MEX,DF,19,Mazatlán,Liga MX,0.1,0,0,0,0,0,0,0,0.0,0,0,0,0,0,0,1,0
Ramiro Sordo,ARG,"MF,FW",23,Santos,Liga MX,4.6,7,5,4,3,0,2,6,33.3,4,3,0,3,2,9,6,0
Ramiro Árciga,MEX,"FW,MF",18,Mazatlán,Liga MX,4.1,19,11,11,7,1,6,13,46.2,7,11,0,11,7,26,1,0
Ramon,BRA,DF,23,Espanyol,Segunda Division,5.0,12,11,5,6,1,9,17,52.9,8,5,2,3,3,15,12,0
Ramón,ESP,GK,24,CD Mirandés,Segunda Division,35.0,1,0,1,0,0,1,3,33.3,2,0,0,0,1,2,10,2
Ramón Juárez,MEX,DF,22,América,Liga MX,16.3,26,16,18,7,1,9,14,64.3,5,23,17,6,21,47,78,0
Ramón Pasquel,MEX,GK,27,FC Juárez,Liga MX,0.7,0,0,0,0,0,0,0,0.0,0,0,0,0,0,0,0,0
Randall Leal,CRC,"MF,FW",26,Nashville,MLS,12.7,25,15,8,11,6,9,32,28.1,23,10,1,9,7,32,4,0
Ranko Veselinović,SRB,DF,23,Vancouver W'caps,MLS,31.4,29,22,23,5,1,21,33,63.6,12,36,27,9,33,62,155,3
Ransford Königsdörffer,GHA,"FW,MF",21,Hamburger SV,2. Bundesliga,16.4,18,8,7,7,4,12,22,54.5,10,20,2,18,5,23,16,1
Raoul Petretta,ITA,DF,25,Toronto FC,MLS,19.4,57,37,32,20,5,39,50,78.0,11,20,5,15,25,82,46,0
Raphael Kofler,ITA,"DF,MF",18,Südtirol,Serie B,8.4,17,9,11,6,0,9,16,56.3,7,14,7,7,17,34,23,0
Raphael Obermair,PHI,"DF,MF",27,Paderborn 07,2. Bundesliga,29.5,40,26,16,22,2,16,37,43.2,21,42,14,28,35,75,42,1
Raphael Odogwu,NGA,FW,32,Südtirol,Serie B,21.8,9,5,3,2,4,1,6,16.7,5,7,4,3,7,16,15,0
Raphaël Lipinski,FRA,"DF,FW",21,Rodez Aveyron,Ligue 2,12.5,36,26,15,16,5,17,30,56.7,13,13,3,10,12,48,33,0
Rarmani Edmonds-Green,ENG,"MF,DF",24,Huddersfield,EFL,6.7,12,5,6,6,0,7,9,77.8,2,7,4,3,7,19,13,0
Rasmus Alm,SWE,"MF,FW",27,St. Louis,MLS,12.2,19,12,8,9,2,9,24,37.5,15,20,0,20,5,24,6,0
Rav van den Berg,NED,DF,19,Middlesbrough,EFL,32.1,44,28,24,18,2,29,46,63.0,17,25,14,11,41,85,112,0
Ray Gaddis,USA,DF,33,FC Cincinnati,MLS,13.9,25,17,13,8,4,15,21,71.4,6,23,4,19,13,38,19,2
Rayan Ghrieb,FRA,"MF,FW",24,Dunkerque,Ligue 2,11.5,20,13,7,10,3,14,25,56.0,11,5,2,3,8,28,1,0
Rayan Kolli,ENG,"FW,MF",18,QPR,EFL,1.9,0,0,0,0,0,0,1,0.0,1,2,1,1,0,0,0,0
Rayan Lutin,COM,MF,20,Amiens,Ligue 2,1.9,11,6,3,3,5,5,8,62.5,3,4,1,3,1,12,1,0
Rayan Philippe,FRA,"FW,MF",22,Braunschweig,2. Bundesliga,18.7,12,6,3,5,4,4,17,23.5,13,12,1,11,6,18,7,0
Rayan Raveloson,MAD,MF,26,Auxerre,Ligue 2,31.3,45,29,18,23,4,19,42,45.2,23,31,7,24,40,85,31,1
Rayco Rodríguez Medina,ESP,"MF,FW",27,Amorebieta,Segunda Division,13.1,19,8,4,12,3,8,20,40.0,12,14,2,12,8,27,8,0
Raymundo Fulgencio,MEX,"FW,MF",23,Atlas,Liga MX,12.1,13,9,8,4,1,4,12,33.3,8,11,0,11,3,16,6,0
Raymundo Fulgencio,MEX,FW,23,UANL,Liga MX,5.4,3,3,3,0,0,1,6,16.7,5,3,0,3,1,4,2,0
Raymundo Rubio,MEX,"DF,FW",22,Cruz Azul,Liga MX,0.1,0,0,0,0,0,0,0,0.0,0,0,0,0,0,0,0,0
Raúl Camacho,MEX,"FW,DF",21,Mazatlán,Liga MX,2.1,0,0,0,0,0,0,2,0.0,2,4,0,4,0,0,6,0
Raúl Gudiño,MEX,GK,27,Necaxa,Liga MX,9.5,0,0,0,0,0,0,0,0.0,0,0,0,0,0,0,2,0
Raúl Guti,ESP,MF,27,Zaragoza,Segunda Division,0.6,3,2,2,1,0,2,2,100.0,0,0,0,0,1,4,0,0
Raúl Guti,ESP,"MF,FW",27,Elche,Segunda Division,4.4,5,2,3,1,1,3,11,27.3,8,4,3,1,7,12,0,0
Raúl Lizoain,ESP,GK,33,Cartagena,Segunda Division,19.0,0,0,0,0,0,0,2,0.0,2,0,0,0,0,0,9,1
Raúl López Gómez,MEX,DF,30,Santos,Liga MX,12.0,25,18,15,8,2,15,26,57.7,11,15,8,7,7,32,29,0
Raúl Martínez,MEX,DF,20,Guadalajara,Liga MX,3.1,4,2,2,2,0,1,2,50.0,1,5,3,2,3,7,15,0
Raúl Moro,ESP,"MF,FW",21,Valladolid,Segunda Division,17.1,8,4,3,5,0,1,15,6.7,14,5,0,5,5,13,7,0
Raúl Navarro,ESP,DF,30,Burgos,Segunda Division,12.3,23,17,15,6,2,9,15,60.0,6,20,5,15,13,36,28,0
Raúl Ruidíaz,PER,FW,32,Seattle,MLS,11.7,6,2,3,2,1,2,10,20.0,8,12,0,12,0,6,3,0
Raúl Sandoval,MEX,"MF,DF",23,Querétaro,Liga MX,22.1,22,9,11,9,2,10,22,45.5,12,20,5,15,12,34,35,0
Rebollo,ESP,GK,24,Zaragoza,Segunda Division,9.0,0,0,0,0,0,0,0,0.0,0,0,0,0,0,0,10,1
Reece James,ENG,"DF,MF",29,Sheffield Weds,EFL,3.4,6,4,4,2,0,4,10,40.0,6,4,1,3,4,10,4,0
Reed Baker-Whiting,USA,"DF,FW",17,Seattle,MLS,7.1,20,14,13,6,1,8,16,50.0,8,8,0,8,6,26,17,0
Regan Slater,ENG,"MF,DF",23,Hull City,EFL,30.9,37,21,21,12,4,21,44,47.7,23,30,14,16,13,50,43,2
Reggie Cannon,USA,DF,25,QPR,EFL,15.9,43,23,28,14,1,28,35,80.0,7,8,3,5,27,70,35,0
Renaud Ripart,FRA,"FW,MF",30,Troyes,Ligue 2,9.1,18,12,7,7,4,7,18,38.9,11,19,0,19,5,23,12,0
René López,MEX,DF,21,Pachuca,Liga MX,6.1,18,12,9,6,3,9,13,69.2,4,10,2,8,7,25,9,1
Rhys Healey,WAL,"FW,MF",28,Huddersfield,EFL,5.6,3,3,0,3,0,1,5,20.0,4,4,2,2,1,4,11,0
Rhys Healey,WAL,"MF,FW",28,Watford,EFL,2.3,3,1,0,2,1,1,2,50.0,1,1,1,0,1,4,3,0
Riad Nouri,FRA,"MF,FW",38,Ajaccio,Ligue 2,11.8,17,10,7,6,4,10,19,52.6,9,10,0,10,9,26,5,0
Ricardo Chávez Soto,MEX,DF,28,Atlético,Liga MX,28.0,64,39,38,17,9,34,53,64.2,19,31,13,18,35,99,83,1
Ricardo Coutinho,FRA,"FW,MF",17,Ajaccio,Ligue 2,0.2,0,0,0,0,0,0,1,0.0,1,0,0,0,0,0,1,0
Ricardo Gutiérrez,MEX,GK,26,Mazatlán,Liga MX,5.7,0,0,0,0,0,0,0,0.0,0,0,0,0,0,0,1,1
Ricardo Marín,MEX,FW,25,Guadalajara,Liga MX,22.6,22,9,3,10,9,5,16,31.3,11,17,0,17,8,30,5,0
Ricardo Monreal,MEX,"FW,MF",22,Necaxa,Liga MX,16.9,17,14,5,4,8,7,29,24.1,22,17,5,12,5,22,6,0
Ricardo Pereira,POR,"DF,MF",29,Leicester City,EFL,36.4,105,63,55,39,11,51,94,54.3,43,50,10,40,53,158,72,4
Ricardo Rentería,MEX,FW,21,Monterrey,Liga MX,0.1,0,0,0,0,0,0,0,0.0,0,0,0,0,0,0,1,0
Riccardo Ciervo,ITA,"MF,DF",21,Südtirol,Serie B,15.2,23,13,10,8,5,10,20,50.0,10,6,0,6,7,30,20,0
Riccardo Fiamozzi,ITA,"DF,MF",30,Reggiana,Serie B,23.0,14,8,6,8,0,7,17,41.2,10,20,8,12,15,29,47,2
Riccardo Fogliata,ITA,MF,19,Brescia,Serie B,5.9,17,11,5,9,3,7,12,58.3,5,10,1,9,5,22,4,0
Riccardo Gagliolo,SWE,MF,33,Ascoli,Serie B,0.0,0,0,0,0,0,0,0,0.0,0,0,0,0,1,1,0,0
Riccardo Gagno,ITA,GK,26,Modena,Serie B,21.4,0,0,0,0,0,0,1,0.0,1,1,0,1,0,0,8,2
Riccardo Melgrati,ITA,GK,29,Calcio Lecco 1912,Serie B,22.5,1,0,1,0,0,1,3,33.3,2,0,0,0,0,1,12,2
Riccardo Zoia,ITA,"DF,FW",21,Ternana,Serie B,0.2,0,0,0,0,0,0,0,0.0,0,1,0,1,1,1,1,0
Richard Sánchez,PAR,MF,27,América,Liga MX,16.4,19,12,9,8,2,12,33,36.4,21,25,3,22,7,26,15,0
Richie Laryea,CAN,"FW,DF",28,Vancouver W'caps,MLS,10.5,20,17,12,4,4,7,9,77.8,2,3,1,2,8,28,7,1
Richie Laryea,CAN,DF,28,Toronto FC,MLS,17.9,35,19,23,12,0,18,34,52.9,16,19,8,11,22,57,31,1
Richmond Tachie,GER,"FW,MF",24,Kaiserslautern,2. Bundesliga,19.6,11,7,2,6,3,7,19,36.8,12,34,2,32,4,15,9,0
Richy Ledezma,USA,"MF,FW",22,NYCFC,MLS,13.2,7,4,2,5,0,1,8,12.5,7,8,1,7,6,13,2,0
Rida Zouhir,CAN,"MF,FW",19,CF Montréal,MLS,2.5,5,3,1,2,2,1,3,33.3,2,1,0,1,2,7,2,0
Riki Rodríguez,ESP,MF,26,Albacete,Segunda Division,36.1,64,36,19,32,13,33,61,54.1,28,37,14,23,47,111,42,1
Riley McGree,AUS,"FW,MF",24,Middlesbrough,EFL,14.0,21,12,7,10,4,10,18,55.6,8,14,2,12,9,30,9,0
Riqui Puig,ESP,"MF,FW",23,LA Galaxy,MLS,28.1,19,13,5,8,6,12,26,46.2,14,13,1,12,12,31,2,0
Robbie Brady,IRL,"DF,MF",31,Preston,EFL,17.4,57,34,32,19,6,30,50,60.0,20,27,3,24,18,75,45,1
Robbie Robinson,USA,"FW,MF",24,Inter Miami,MLS,3.8,7,4,4,3,0,1,7,14.3,6,2,1,1,1,8,1,0
Rober,ESP,"DF,MF",29,Sporting Gijón,Segunda Division,35.5,64,37,49,13,2,38,60,63.3,22,48,29,19,48,112,115,1
Rober Correa,ESP,DF,31,Eibar,Segunda Division,1.6,2,1,2,0,0,2,2,100.0,0,1,0,1,3,5,9,0
Robert Castellanos,USA,DF,24,Sporting KC,MLS,7.8,7,7,5,2,0,5,8,62.5,3,10,9,1,9,16,45,0
Robert Dickie,ENG,DF,27,Bristol City,EFL,38.9,48,27,30,16,2,30,53,56.6,23,42,22,20,66,114,124,1
Robert Ergas,URU,"DF,FW",25,UNAM,Liga MX,8.2,24,17,13,11,0,8,18,44.4,10,11,1,10,9,33,11,0
Robert Glatzel,GER,FW,29,Hamburger SV,2. Bundesliga,29.4,11,7,1,4,6,4,9,44.4,5,15,4,11,3,14,13,0
Robert Ibáñez,ESP,"MF,FW",31,Levante,Segunda Division,4.0,12,6,7,2,3,7,10,70.0,3,6,1,5,3,15,8,0
Robert Ivanov,FIN,DF,28,Braunschweig,2. Bundesliga,23.9,30,22,18,10,2,15,28,53.6,13,44,27,17,46,76,122,2
Robert Kwasigroch,GER,GK,19,Hertha BSC,2. Bundesliga,1.0,0,0,0,0,0,0,0,0.0,0,0,0,0,0,0,0,1
Robert Leipertz,GER,"DF,FW",30,Paderborn 07,2. Bundesliga,7.0,9,4,3,3,3,4,13,30.8,9,5,1,4,3,12,6,0
Robert Morales,PAR,FW,24,Toluca,Liga MX,11.5,10,7,2,5,3,1,13,7.7,12,8,0,8,3,13,3,0
Robert Taylor,FIN,"FW,DF",28,Inter Miami,MLS,16.2,17,10,10,5,2,10,17,58.8,7,14,3,11,19,36,7,1
Robert Tesche,GER,MF,36,Osnabrück,2. Bundesliga,22.0,30,21,22,6,2,11,38,28.9,27,35,11,24,22,52,29,0
Robert Voloder,BIH,DF,21,Sporting KC,MLS,11.4,18,5,13,2,3,9,18,50.0,9,13,5,8,21,39,33,2
Robert Wagner,GER,MF,20,Greuther Fürth,2. Bundesliga,28.3,51,32,17,27,7,22,49,44.9,27,45,12,33,20,71,44,0
Roberto Alvarado,MEX,"FW,MF",24,Guadalajara,Liga MX,29.4,35,23,14,16,5,12,38,31.6,26,24,5,19,21,56,13,0
Roberto Inglese,ITA,"FW,MF",31,Calcio Lecco 1912,Serie B,5.5,3,3,2,0,1,1,5,20.0,4,7,0,7,0,3,5,0
Roberto Insigne,ITA,"FW,MF",29,Palermo,Serie B,13.2,16,11,6,3,7,10,21,47.6,11,8,1,7,5,21,7,0
Roberto López,ESP,"FW,MF",24,Tenerife,Segunda Division,31.7,26,14,6,16,4,20,39,51.3,19,22,3,19,10,36,17,0
Roberto Meraz,MEX,MF,23,Mazatlán,Liga MX,1.6,6,5,3,2,1,3,4,75.0,1,3,1,2,1,7,3,0
Roberto de la Rosa,MEX,"FW,MF",23,Pachuca,Liga MX,12.1,4,2,2,1,1,2,10,20.0,8,8,0,8,1,5,18,0
Robin Bormuth,GER,DF,27,Karlsruher,2. Bundesliga,18.8,19,12,13,5,1,13,17,76.5,4,22,18,4,15,34,82,1
Robin Fellhauer,GER,"MF,DF",25,Elversberg,2. Bundesliga,28.5,71,47,35,32,4,39,67,58.2,28,55,14,41,47,118,67,3
Robin Heußer,GER,MF,25,Wehen,2. Bundesliga,33.3,87,56,39,43,5,45,92,48.9,47,67,7,60,58,145,40,2
Robin Himmelmann,GER,GK,34,Kaiserslautern,2. Bundesliga,3.0,0,0,0,0,0,0,1,0.0,1,0,0,0,0,0,0,0
Robin Jansson,SWE,DF,31,Orlando City,MLS,32.0,24,12,16,6,2,20,29,69.0,9,42,31,11,23,47,92,0
Robin Krauße,GER,MF,29,Braunschweig,2. Bundesliga,24.0,36,17,21,14,1,17,47,36.2,30,23,3,20,25,61,27,4
Robin Legendre,FRA,"FW,MF",21,Quevilly-Rouen,Ligue 2,1.8,4,2,1,2,1,1,3,33.3,2,1,1,0,0,4,1,0
Robin Lod,FIN,"MF,FW",29,Minnesota Utd,MLS,10.0,18,10,8,8,2,4,21,19.0,17,9,1,8,6,24,10,1
Rodney Redes,PAR,"MF,FW",22,Austin,MLS,5.4,7,4,3,3,1,2,6,33.3,4,6,1,5,3,10,5,0
Rodolfo Cota,MEX,GK,36,León,Liga MX,32.0,1,0,1,0,0,1,5,20.0,4,0,0,0,0,1,14,3
Rodolfo Pizarro,MEX,"MF,FW",28,Inter Miami,MLS,10.3,19,7,6,5,8,10,17,58.8,7,11,1,10,4,23,2,0
Rodri,ESP,MF,21,Villarreal B,Segunda Division,20.6,36,18,22,10,4,16,29,55.2,13,15,2,13,9,45,29,1
Rodrigo Aguirre,URU,"FW,MF",28,Monterrey,Liga MX,5.4,5,4,0,4,1,1,4,25.0,3,4,0,4,4,9,1,0
Rodrigo Dourado,BRA,MF,29,Atlético,Liga MX,30.4,82,54,29,48,5,38,80,47.5,42,51,16,35,47,129,62,2
Rodrigo Godínez,MEX,DF,30,Tijuana,Liga MX,2.5,3,3,2,1,0,2,4,50.0,2,7,4,3,5,8,9,0
Rodrigo Huescas,MEX,"DF,FW",19,Cruz Azul,Liga MX,22.1,48,26,24,17,7,27,51,52.9,24,21,4,17,12,60,20,1
Rodrigo López,MEX,MF,21,Querétaro,Liga MX,1.6,4,3,1,2,1,1,4,25.0,3,3,0,3,1,5,0,0
Rodrigo López,MEX,"MF,FW",21,UNAM,Liga MX,10.4,17,12,6,9,2,6,24,25.0,18,9,2,7,3,20,9,0
Rodrigo Mendoza,ESP,MF,19,Elche,Segunda Division,11.3,14,8,7,6,1,6,15,40.0,9,11,1,10,15,29,16,0
Rodrigo Parra,MEX,DF,19,Tijuana,Liga MX,0.8,1,1,0,1,0,1,3,33.3,2,1,0,1,0,1,1,0
Rodrigo Schlegel,ARG,DF,25,Orlando City,MLS,21.9,34,14,20,9,5,20,34,58.8,14,23,15,8,24,58,92,1
Rodrigues,BRA,DF,25,SJ Earthquakes,MLS,33.3,72,46,56,15,1,48,74,64.9,26,43,27,16,58,130,152,1
Rogelio Cortéz Pineda,MEX,"MF,FW",19,Necaxa,Liga MX,3.3,13,7,6,6,1,6,16,37.5,10,10,4,6,2,15,2,0
Rogelio Funes Mori,MEX,FW,32,Monterrey,Liga MX,11.4,4,1,0,2,2,1,5,20.0,4,4,0,4,1,5,8,0
Rogelio Funes Mori,MEX,"FW,MF",32,UNAM,Liga MX,4.9,0,0,0,0,0,0,0,0.0,0,3,1,2,0,0,3,0
Roger Espinoza,HON,MF,36,Sporting KC,MLS,8.1,17,8,7,10,0,10,21,47.6,11,8,1,7,8,25,9,0
Roger Martínez,ESP,DF,20,Espanyol,Segunda Division,0.1,0,0,0,0,0,0,0,0.0,0,0,0,0,0,0,1,0
Roko Baturina,CRO,FW,23,Racing Sant,Segunda Division,2.7,1,1,0,1,0,0,1,0.0,1,1,0,1,0,1,1,0
Roko Jureškin,CRO,"MF,DF",22,Pisa,Serie B,1.2,4,2,1,1,2,1,2,50.0,1,1,0,1,0,4,2,0
Romain Esse,ENG,"MF,FW",18,Millwall,EFL,8.3,23,13,12,7,4,9,19,47.4,10,11,1,10,7,30,4,0
Romain Sans,FRA,DF,24,US Concarneau,Ligue 2,7.9,19,16,11,5,3,13,20,65.0,7,3,0,3,10,29,26,0
Romain Spano,FRA,MF,28,Annecy,Ligue 2,0.1,0,0,0,0,0,0,0,0.0,0,1,0,1,0,0,0,0
Romain Thomas,FRA,DF,35,Caen,Ligue 2,37.0,31,22,19,12,0,17,31,54.8,14,49,32,17,27,58,201,0
Romaine Mundle,ENG,"MF,FW",20,Sunderland,EFL,5.4,9,5,3,5,1,0,2,0.0,2,8,0,8,3,12,7,0
Romaine Sawyers,SKN,MF,31,Cardiff City,EFL,0.3,1,1,1,0,0,0,0,0.0,0,0,0,0,1,2,0,0
Roman Bürki,SUI,GK,32,St. Louis,MLS,33.0,1,1,1,0,0,1,3,33.3,2,0,0,0,0,1,17,2
Roman Celentano,USA,GK,22,FC Cincinnati,MLS,33.0,0,0,0,0,0,0,0,0.0,0,0,0,0,0,0,16,3
Romaric Yapi,FRA,DF,23,Bastia,Ligue 2,6.4,15,12,10,2,3,11,18,61.1,7,3,1,2,6,21,20,0
Romario Ibarra,ECU,"MF,FW",29,Oviedo,Segunda Division,1.5,2,1,2,0,0,1,2,50.0,1,3,0,3,2,4,0,0
Romell Quioto,HON,FW,31,CF Montréal,MLS,8.9,5,2,0,4,1,0,3,0.0,3,2,1,1,0,5,7,0
Romelle Donovan,ENG,FW,16,Birmingham City,EFL,1.4,2,2,0,2,0,2,6,33.3,4,4,0,4,1,3,1,0
Romeo Giovannini,ITA,MF,21,Modena,Serie B,0.3,4,4,2,2,0,1,1,100.0,0,0,0,0,0,4,1,0
Rominigue Kouamé,MLI,MF,26,Troyes,Ligue 2,3.1,11,6,5,6,0,4,6,66.7,2,2,0,2,6,17,1,0
Román Almanza,MEX,FW,17,León,Liga MX,0.0,0,0,0,0,0,0,0,0.0,0,0,0,0,0,0,0,0
Román Martínez,MEX,FW,20,América,Liga MX,1.5,0,0,0,0,0,0,0,0.0,0,2,1,1,0,0,0,0
Ron Schallenberg,GER,"MF,DF",24,Schalke 04,2. Bundesliga,23.5,76,46,23,51,2,36,71,50.7,35,42,7,35,46,122,61,0
Ron-Robert Zieler,GER,GK,34,Hannover 96,2. Bundesliga,34.0,1,0,1,0,0,1,1,100.0,0,0,0,0,1,2,18,1
Ron-Thorben Hoffmann,GER,GK,24,Braunschweig,2. Bundesliga,33.0,0,0,0,0,0,0,0,0.0,0,0,0,0,1,1,16,0
Ronald,BRA,FW,22,Swansea City,EFL,15.8,36,25,13,15,8,18,32,56.3,14,18,1,17,6,42,10,1
Ronald Donkor,MLI,"MF,DF",18,NY Red Bulls,MLS,0.5,3,2,0,3,0,0,0,0.0,0,0,0,0,1,4,0,0
Ronald Hernández,VEN,DF,25,Atlanta Utd,MLS,7.8,14,8,7,7,0,10,19,52.6,9,7,2,5,9,23,13,0
Ronaldo Cisneros,MEX,"FW,MF",26,Guadalajara,Liga MX,4.7,1,1,0,1,0,0,5,0.0,5,1,0,1,0,1,1,0
Ronaldo Prieto,MEX,DF,26,Santos,Liga MX,9.0,14,12,11,3,0,8,12,66.7,4,18,9,9,21,35,60,0
Ronaldo Vieira,ENG,MF,25,Sampdoria,Serie B,8.4,15,8,7,8,0,8,15,53.3,7,5,1,4,9,24,22,0
Roque Mesa,ESP,MF,35,Sporting Gijón,Segunda Division,14.3,32,22,11,18,3,17,33,51.5,16,20,8,12,14,46,16,2
Ross McCrorie,SCO,"DF,MF",25,Bristol City,EFL,13.1,16,12,6,7,3,9,21,42.9,12,12,1,11,7,23,17,0
Ross Stewart,SCO,FW,27,Southampton,EFL,0.3,1,0,0,0,1,0,1,0.0,1,1,1,0,0,1,1,0
Ruan,BRA,"DF,MF",27,D.C. United,MLS,15.8,35,19,20,12,3,14,28,50.0,14,8,2,6,10,45,22,1
Ruben Bover,ESP,MF,31,FC Andorra,Segunda Division,20.2,33,17,9,20,4,14,40,35.0,26,20,1,19,11,44,16,0
Ruben Pulido Peñas,ESP,DF,23,Huesca,Segunda Division,5.8,9,5,5,4,0,3,5,60.0,2,7,3,4,13,22,26,3
Rubin Colwill,WAL,"MF,FW",21,Cardiff City,EFL,17.7,41,19,7,23,11,25,44,56.8,19,25,0,25,14,55,7,1
Rubio Rubin,GUA,"FW,MF",26,RSL,MLS,14.4,6,4,0,5,1,0,5,0.0,5,6,1,5,4,10,6,0
Rubio Rubin,GUA,"FW,MF",27,Querétaro,Liga MX,1.1,0,0,0,0,0,0,1,0.0,1,1,0,1,0,0,0,0
Rubén,ESP,DF,23,CD Mirandés,Segunda Division,17.7,31,20,14,9,8,20,34,58.8,14,11,5,6,21,52,38,0
Rubén,ESP,"DF,FW",23,Espanyol,Segunda Division,1.4,6,5,2,2,2,4,5,80.0,1,1,0,1,0,6,3,0
Rubén González,ESP,DF,29,Racing Sant,Segunda Division,21.6,30,20,25,4,1,16,23,69.6,7,31,22,9,24,54,110,0
Rubén Gómez,ESP,GK,22,Villarreal B,Segunda Division,1.0,0,0,0,0,0,0,0,0.0,0,0,0,0,0,0,0,0
Rubén Yáñez,ESP,GK,30,Sporting Gijón,Segunda Division,37.9,1,1,1,0,0,1,2,50.0,1,1,0,1,0,1,15,6
Rudy Camacho,FRA,"DF,MF",31,CF Montréal,MLS,17.9,19,14,14,4,1,9,14,64.3,5,19,13,6,29,48,77,2
Rudy Camacho,FRA,DF,31,Crew,MLS,8.8,10,6,6,3,1,4,6,66.7,2,9,1,8,8,18,41,1
Rudy Kohon,FRA,DF,19,Troyes,Ligue 2,5.3,13,8,7,4,2,3,9,33.3,6,2,1,1,10,23,14,1
Russell Canouse,USA,MF,27,D.C. United,MLS,24.6,67,45,31,28,8,34,61,55.7,27,35,10,25,31,98,22,0
Russell Teibert,CAN,MF,30,Vancouver W'caps,MLS,1.7,1,0,0,1,0,0,2,0.0,2,3,0,3,1,2,1,0
Ryan Allsop,ENG,GK,31,Hull City,EFL,36.9,0,0,0,0,0,0,1,0.0,1,0,0,0,0,0,15,2
Ryan Andrews,ENG,"DF,MF",18,Watford,EFL,28.6,48,38,26,18,4,22,40,55.0,18,32,3,29,44,92,62,2
Ryan Edwards,AUS,"MF,FW",30,Amorebieta,Segunda Division,14.8,17,10,9,4,4,7,18,38.9,11,11,2,9,7,24,13,0
Ryan Fraser,SCO,"FW,MF",29,Southampton,EFL,18.1,16,8,7,4,5,9,13,69.2,4,10,2,8,2,18,17,0
Ryan Gauld,SCO,"FW,MF",27,Vancouver W'caps,MLS,29.2,64,39,15,30,19,16,46,34.8,30,37,2,35,16,80,15,0
Ryan Hardie,SCO,FW,26,Plymouth Argyle,EFL,31.5,10,4,1,4,5,2,13,15.4,11,22,4,18,7,17,13,0
Ryan Hedges,WAL,"FW,DF",28,Blackburn,EFL,10.9,26,16,8,13,5,9,20,45.0,11,21,3,18,6,32,15,0
Ryan Hollingshead,USA,DF,31,LAFC,MLS,26.1,73,51,38,23,12,41,72,56.9,31,36,8,28,43,116,53,0
Ryan John Giles,ENG,DF,23,Hull City,EFL,12.0,11,7,8,3,0,6,10,60.0,4,12,2,10,13,24,34,0
Ryan Ledson,ENG,MF,25,Preston,EFL,17.2,43,31,15,25,3,17,36,47.2,19,32,13,19,23,66,28,0
Ryan Leonard,ENG,DF,31,Millwall,EFL,30.1,89,55,68,20,1,55,85,64.7,30,36,10,26,35,124,87,0
Ryan Longman,ENG,"MF,FW",22,Millwall,EFL,19.2,42,28,19,13,10,23,33,69.7,10,15,3,12,13,55,24,0
Ryan Manning,IRL,DF,27,Southampton,EFL,30.5,56,41,28,21,7,29,50,58.0,21,19,5,14,24,80,52,1
Ryan Mmaee,MAR,FW,25,Stoke City,EFL,16.7,13,11,5,4,4,2,4,50.0,2,16,3,13,2,15,11,0
Ryan Porteous,SCO,DF,24,Watford,EFL,33.7,73,40,44,28,1,54,94,57.4,40,49,27,22,61,134,114,3
Ryan Raposo,CAN,"DF,FW",23,Vancouver W'caps,MLS,14.8,19,13,7,7,5,9,18,50.0,9,15,4,11,22,41,33,0
Ryan Sailor,USA,"DF,FW",24,Inter Miami,MLS,3.4,4,2,2,2,0,1,1,100.0,0,3,2,1,3,7,27,1
Ryan Spaulding,USA,DF,24,NE Revolution,MLS,6.9,5,3,2,2,1,2,3,66.7,1,9,0,9,5,10,17,0
Ryan Wintle,ENG,MF,26,Cardiff City,EFL,29.3,39,22,16,22,1,20,30,66.7,10,34,19,15,24,63,38,1
Régis Gurtner,FRA,GK,36,Amiens,Ligue 2,35.0,0,0,0,0,0,0,0,0.0,0,0,0,0,1,1,10,0
Rémi Cabral,FRA,DF,23,Rapids,MLS,0.1,1,0,0,0,1,0,1,0.0,1,0,0,0,0,1,0,0
Rémi Walter,FRA,MF,27,Sporting KC,MLS,30.4,33,26,8,18,7,15,48,31.3,33,20,8,12,34,67,31,1
Rémy Boissier,FRA,MF,29,Dunkerque,Ligue 2,15.7,28,17,11,17,0,12,27,44.4,15,12,4,8,28,56,27,0
Rémy Labeau Lascary,GLP,"FW,MF",20,Stade Laval,Ligue 2,23.6,53,28,19,26,8,17,48,35.4,31,27,0,27,17,70,8,0
Róbert Þorkelsson,ISL,DF,20,CF Montréal,MLS,2.5,7,5,7,0,0,3,7,42.9,4,5,0,5,3,10,4,0
Rúben Vezo,POR,DF,30,Levante,Segunda Division,15.9,31,16,19,10,2,17,21,81.0,4,17,9,8,22,53,75,0
Rúben Vinagre,POR,DF,24,Hull City,EFL,5.5,12,9,6,5,1,5,7,71.4,2,4,1,3,2,14,16,0
Rúnar Alex Rúnarsson,ISL,GK,28,Cardiff City,EFL,6.0,0,0,0,0,0,0,1,0.0,1,0,0,0,0,0,4,0
S. González,MEX,FW,20,Puebla,Liga MX,0.1,1,0,0,1,0,0,0,0.0,0,0,0,0,0,1,0,0
Saad Agouzoul,MAR,DF,25,Auxerre,Ligue 2,12.6,21,15,11,8,2,10,15,66.7,5,17,12,5,19,40,59,1
Saba Lobzhanidze,GEO,FW,28,Atlanta Utd,MLS,5.2,1,0,1,0,0,0,1,0.0,1,5,0,5,2,3,3,0
Sabin Merino,ESP,FW,32,Racing Ferrol,Segunda Division,12.3,6,4,0,5,1,0,7,0.0,7,3,1,2,1,7,6,0
Sacha Banse,BFA,MF,22,Valenciennes,Ligue 2,18.6,37,28,14,21,2,20,43,46.5,23,20,6,14,17,54,35,1
Saidou Sow,GUI,DF,21,Saint-Étienne,Ligue 2,0.5,2,2,0,2,0,0,1,0.0,1,0,0,0,1,3,0,0
Saikou Touray,GAM,MF,23,Grenoble,Ligue 2,8.5,15,8,9,5,1,7,20,35.0,13,9,2,7,7,22,14,0
Sait Tlaxcalteco,MEX,"MF,FW",20,Toluca,Liga MX,0.2,2,2,1,1,0,0,0,0.0,0,0,0,0,0,2,0,0
Sala,ESP,FW,21,Valladolid,Segunda Division,5.2,4,2,1,2,1,3,5,60.0,2,8,0,8,4,8,1,0
Salifo Caropitche,GNB,"MF,FW",22,Tenerife,Segunda Division,0.2,0,0,0,0,0,0,0,0.0,0,0,0,0,0,0,1,0
Salim Diakité,MLI,DF,23,Ternana,Serie B,17.9,23,13,8,10,5,17,22,77.3,5,24,16,8,29,52,56,0
Salim Diakité,MLI,DF,23,Palermo,Serie B,14.7,21,19,12,7,2,18,20,90.0,2,20,9,11,13,34,40,0
Salomon Abergel,FRA,DF,19,Ajaccio,Ligue 2,1.9,9,4,6,2,1,8,11,72.7,3,5,1,4,2,11,5,0
Salomón Rondón,VEN,FW,33,Pachuca,Liga MX,14.3,6,3,0,4,2,1,5,20.0,4,7,2,5,1,7,19,0
Salvador Mariscal,MEX,"MF,FW",20,Santos,Liga MX,6.5,18,10,12,6,0,6,13,46.2,7,7,3,4,16,34,20,0
Salvador Reyes Chávez,MEX,"DF,FW",25,América,Liga MX,12.5,26,17,12,12,2,20,31,64.5,11,13,1,12,15,41,23,0
Salvador Rodríguez,MEX,DF,21,Mazatlán,Liga MX,4.3,10,7,6,3,1,6,12,50.0,6,5,3,2,3,13,16,0
Salvatore Elia,ITA,DF,24,Spezia,Serie B,24.1,60,42,37,15,8,34,60,56.7,26,38,2,36,31,91,44,0
Salvatore Esposito,ITA,MF,22,Spezia,Serie B,34.7,68,46,22,39,7,30,59,50.8,29,62,17,45,53,121,77,1
Salvatore Molina,ITA,"DF,MF",31,Südtirol,Serie B,13.5,31,17,16,10,5,15,29,51.7,14,14,2,12,8,39,31,0
Salvi,ESP,"MF,FW",33,Espanyol,Segunda Division,9.4,8,2,2,3,3,4,9,44.4,5,7,2,5,1,9,16,0
Sam Adekugbe,CAN,"FW,DF",28,Vancouver W'caps,MLS,4.5,4,3,2,2,0,1,3,33.3,2,4,1,3,7,11,10,0
Sam Bell,ENG,"FW,DF",21,Bristol City,EFL,20.1,19,11,8,7,4,9,32,28.1,23,27,1,26,17,36,12,0
Sam Byram,ENG,DF,29,Leeds United,EFL,21.5,60,44,34,21,5,35,53,66.0,18,33,14,19,34,94,70,0
Sam Clucas,ENG,MF,32,Rotherham Utd,EFL,20.9,37,21,23,8,6,10,37,27.0,27,28,4,24,28,65,34,1
Sam Field,ENG,MF,25,QPR,EFL,38.5,72,47,23,40,9,41,66,62.1,25,62,18,44,63,135,94,0
Sam Gallagher,ENG,"FW,MF",27,Blackburn,EFL,19.1,16,7,4,10,2,5,12,41.7,7,32,5,27,10,26,40,0
Sam Greenwood,ENG,"FW,MF",21,Middlesbrough,EFL,24.4,47,32,11,24,12,16,45,35.6,29,19,3,16,9,56,15,0
Sam Greenwood,ENG,MF,21,Leeds United,EFL,0.1,0,0,0,0,0,0,0,0.0,0,0,0,0,0,0,0,0
Sam Junqua,USA,"DF,MF",26,FC Dallas,MLS,11.4,17,12,8,7,2,11,20,55.0,9,20,4,16,11,28,23,0
Sam McCallum,ENG,DF,22,Norwich City,EFL,16.4,32,22,22,10,0,19,35,54.3,16,17,6,11,45,77,62,1
Sam Morsy,EGY,MF,31,Ipswich Town,EFL,41.7,119,80,51,59,9,49,103,47.6,54,53,10,43,34,153,42,2
Sam Nicholson,SCO,"MF,DF",28,Rapids,MLS,16.6,13,9,6,4,3,4,18,22.2,14,17,4,13,13,26,27,0
Sam Nombe,ENG,"FW,MF",24,Rotherham Utd,EFL,25.2,21,11,6,9,6,7,32,21.9,25,19,3,16,5,26,17,0
Sam Sanna,FRA,MF,24,Stade Laval,Ligue 2,36.2,100,56,36,49,15,36,87,41.4,51,36,8,28,42,142,25,0
Sam Silvera,AUS,FW,22,Middlesbrough,EFL,15.2,15,11,1,8,6,10,22,45.5,12,10,0,10,8,23,10,0
Sam Surridge,ENG,FW,24,Nashville,MLS,5.5,3,3,1,2,0,0,2,0.0,2,1,0,1,0,3,8,0
Sambou Soumano,SEN,FW,22,Quevilly-Rouen,Ligue 2,29.8,16,10,2,8,6,5,12,41.7,7,21,1,20,3,19,8,0
Samir Chergui,FRA,DF,24,Paris FC,Ligue 2,16.1,19,12,13,6,0,9,11,81.8,2,15,11,4,23,42,31,0
Samir Santos,BRA,DF,28,UANL,Liga MX,22.4,38,21,28,10,0,20,30,66.7,10,31,21,10,30,68,68,0
Sammie Szmodics,IRL,"MF,FW",27,Blackburn,EFL,43.3,29,19,10,14,5,8,42,19.0,34,36,3,33,17,46,16,1
Samuel Adeniran,USA,FW,24,St. Louis,MLS,10.5,7,4,3,3,1,3,6,50.0,3,6,0,6,3,10,8,0
Samuel Amo-Ameyaw,ENG,"FW,MF",17,Southampton,EFL,0.8,3,2,1,0,2,2,3,66.7,1,2,0,2,0,3,1,0
Samuel Ballet,SUI,"FW,MF",22,Como,Serie B,0.6,3,1,0,1,2,3,5,60.0,2,1,0,1,0,3,0,0
Samuel Edozie,ENG,"FW,MF",20,Southampton,EFL,15.2,31,17,13,8,10,10,24,41.7,14,16,3,13,9,40,9,0
Samuel Giovane,ITA,"MF,DF",20,Ascoli,Serie B,17.2,34,20,8,20,6,21,31,67.7,10,20,4,16,6,40,25,0
Samuel Loric,FRA,DF,23,Quevilly-Rouen,Ligue 2,18.8,67,49,42,21,4,34,56,60.7,22,21,3,18,43,110,50,0
Samuel Ntamack,CMR,FW,22,Annecy,Ligue 2,12.3,6,2,4,1,1,2,5,40.0,3,9,2,7,4,10,7,0
Samuel Ntanda,BEL,"MF,FW",18,Sampdoria,Serie B,0.9,2,2,1,0,1,1,2,50.0,1,0,0,0,0,2,2,0
Samuel Obeng,GHA,FW,27,Huesca,Segunda Division,25.8,11,9,3,6,2,4,6,66.7,2,16,1,15,9,20,35,0
Samuel Parker,WAL,FW,17,Swansea City,EFL,1.5,4,4,1,2,1,2,2,100.0,0,2,1,1,1,5,0,0
Samuel Piette,CAN,MF,28,CF Montréal,MLS,12.1,27,18,14,13,0,14,30,46.7,16,12,4,8,11,38,16,0
Samuel Shashoua,ENG,"FW,MF",25,Albacete,Segunda Division,2.8,11,9,5,4,2,2,3,66.7,1,9,0,9,0,11,0,0
Samuel Sosa,VEN,"FW,MF",23,Querétaro,Liga MX,7.4,3,2,1,2,0,1,4,25.0,3,6,1,5,0,3,3,0
Samy Baghdadi,FRA,"FW,MF",26,Dunkerque,Ligue 2,7.1,7,5,3,4,0,0,2,0.0,2,8,1,7,1,8,5,0
San Román,ESP,GK,26,Elche,Segunda Division,14.0,1,0,1,0,0,1,1,100.0,0,0,0,0,0,1,7,0
Santi Cazorla,ESP,"MF,FW",39,Oviedo,Segunda Division,10.8,25,10,11,11,3,14,27,51.9,13,10,2,8,8,33,6,1
Santiago Arias,COL,DF,31,FC Cincinnati,MLS,18.4,37,26,15,15,7,14,29,48.3,15,19,3,16,29,66,25,0
Santiago Colombatto,ARG,MF,27,Oviedo,Segunda Division,34.7,50,34,23,21,6,31,56,55.4,25,40,8,32,29,79,56,0
Santiago Homenchenko,URU,MF,20,Oviedo,Segunda Division,0.7,6,5,3,3,0,2,3,66.7,1,0,0,0,1,7,1,0
Santiago López,CAN,"DF,FW",18,UNAM,Liga MX,0.1,0,0,0,0,0,0,1,0.0,1,1,0,1,0,0,0,0
Santiago Moreno,COL,"FW,MF",22,Portland Timbers,MLS,25.9,49,24,14,24,11,14,56,25.0,42,38,3,35,23,72,11,0
Santiago Mouriño,URU,DF,22,Zaragoza,Segunda Division,23.8,64,39,35,26,3,27,42,64.3,15,27,7,20,30,94,89,1
Santiago Muñóz,MEX,"FW,MF",20,Santos,Liga MX,7.3,7,4,2,5,0,1,5,20.0,4,3,0,3,2,9,4,0
Santiago Naveda,MEX,MF,22,América,Liga MX,4.5,8,5,2,5,1,4,7,57.1,3,7,5,2,11,19,5,0
Santiago Núñez,ARG,DF,23,Santos,Liga MX,13.7,31,19,26,5,0,13,21,61.9,8,24,19,5,28,59,87,3
Santiago Ormeño,PER,FW,29,Puebla,Liga MX,6.3,7,4,0,5,2,2,6,33.3,4,2,0,2,4,11,5,0
Santiago Ormeño,PER,"FW,MF",29,FC Juárez,Liga MX,1.9,2,0,1,1,0,0,1,0.0,1,0,0,0,1,3,0,0
Santiago Rodríguez,URU,"MF,FW",23,NYCFC,MLS,28.7,36,19,12,12,12,10,41,24.4,31,27,1,26,11,47,10,1
Santiago Sosa,ARG,MF,23,Atlanta Utd,MLS,10.2,24,17,10,12,2,14,23,60.9,9,10,4,6,18,42,21,1
Santiago Trigos,MEX,MF,21,UNAM,Liga MX,6.3,27,20,10,14,3,15,24,62.5,9,6,2,4,4,31,11,0
Sarpreet Singh,NZL,"MF,FW",24,Hansa Rostock,2. Bundesliga,4.7,6,4,3,3,0,2,9,22.2,7,9,2,7,0,6,10,0
Sascha Mockenhaupt,GER,DF,31,Wehen,2. Bundesliga,21.4,29,23,19,8,2,16,31,51.6,15,20,10,10,24,53,60,0
Sauli Väisänen,FIN,DF,29,Ascoli,Serie B,10.1,6,3,3,3,0,3,8,37.5,5,8,3,5,6,12,43,1
Saulo Decarli,SUI,DF,31,Braunschweig,2. Bundesliga,7.9,9,5,3,5,1,6,8,75.0,2,9,3,6,16,25,42,0
Saxon Earley,ENG,DF,20,Plymouth Argyle,EFL,1.0,1,1,1,0,0,0,2,0.0,2,5,1,4,1,2,5,0
Saúl García,ESP,DF,29,Racing Sant,Segunda Division,26.9,67,44,47,17,3,37,68,54.4,31,34,8,26,29,96,70,3
Saúl del Cerro,ESP,"MF,FW",20,Burgos,Segunda Division,0.2,0,0,0,0,0,0,0,0.0,0,1,0,1,0,0,1,0
Scott Arfield,CAN,"MF,FW",34,Charlotte,MLS,4.6,2,2,0,1,1,0,4,0.0,4,9,1,8,3,5,4,0
Scott Banks,SCO,FW,21,St. Pauli,2. Bundesliga,0.8,0,0,0,0,0,0,0,0.0,0,0,0,0,2,2,2,0
Scott Caldwell,USA,MF,31,RSL,MLS,1.9,1,1,0,1,0,1,3,33.3,2,0,0,0,0,1,2,0
Scott Hogan,IRL,FW,31,Birmingham City,EFL,11.2,8,3,3,2,3,2,10,20.0,8,8,0,8,2,10,3,0
Scott Twine,ENG,"FW,MF",24,Hull City,EFL,20.0,20,15,6,12,2,11,28,39.3,17,15,0,15,13,33,6,0
Scott Twine,ENG,"MF,FW",24,Bristol City,EFL,8.2,12,7,2,5,5,3,9,33.3,6,11,1,10,5,17,2,0
Scott Wharton,ENG,DF,25,Blackburn,EFL,23.1,28,16,20,7,1,21,34,61.8,13,29,19,10,33,61,98,1
Sead Haksabanović,MNE,"FW,MF",24,Stoke City,EFL,10.6,15,5,4,10,1,8,23,34.8,15,9,0,9,5,20,7,0
Sean Davis,USA,MF,29,Nashville,MLS,20.8,27,13,7,13,7,17,40,42.5,23,34,15,19,30,57,29,0
Sean Johnson,USA,GK,33,Toronto FC,MLS,20.0,0,0,0,0,0,0,0,0.0,0,1,0,1,0,0,8,2
Sean McLoughlin,IRL,DF,26,Hull City,EFL,13.0,3,1,3,0,0,0,4,0.0,4,30,20,10,20,23,47,1
Sean Morrison,ENG,DF,32,Rotherham Utd,EFL,21.6,26,16,15,9,2,15,25,60.0,10,30,19,11,30,56,120,0
Sean Nealis,USA,DF,26,NY Red Bulls,MLS,30.2,44,28,27,15,2,37,59,62.7,22,32,12,20,30,74,106,0
Sean Rea,CAN,"MF,FW",20,CF Montréal,MLS,8.3,5,3,2,2,1,0,4,0.0,4,7,0,7,2,7,0,0
Sean Zawadzki,USA,"DF,MF",22,Crew,MLS,17.5,33,21,12,15,6,15,23,65.2,8,22,6,16,35,68,34,1
Seb Revan,ENG,DF,20,Rotherham Utd,EFL,30.4,62,37,44,14,4,34,66,51.5,32,50,10,40,30,92,93,2
Sebas Moyano,ESP,"FW,MF",27,Oviedo,Segunda Division,30.4,31,25,13,16,2,15,40,37.5,25,31,2,29,24,55,13,1
Sebastian Anderson,USA,DF,20,Rapids,MLS,3.0,5,2,2,2,1,2,4,50.0,2,3,1,2,1,6,16,0
Sebastian Andersson,SWE,FW,32,Nürnberg,2. Bundesliga,10.5,4,2,1,2,1,2,5,40.0,3,11,7,4,1,5,17,0
Sebastian Berhalter,USA,MF,21,Vancouver W'caps,MLS,14.4,38,24,19,16,3,16,29,55.2,13,23,5,18,19,57,27,0
Sebastian Ernst,GER,"MF,FW",28,Hannover 96,2. Bundesliga,11.0,26,16,7,15,4,11,31,35.5,20,12,2,10,6,32,14,0
Sebastian Griesbeck,GER,"DF,MF",32,Braunschweig,2. Bundesliga,11.7,18,13,12,6,0,12,22,54.5,10,16,8,8,11,29,33,0
Sebastian Jung,GER,DF,33,Karlsruher,2. Bundesliga,26.6,30,22,15,14,1,19,39,48.7,20,28,9,19,22,52,57,1
Sebastian Klaas,GER,"MF,FW",25,Paderborn 07,2. Bundesliga,22.1,18,9,10,6,2,7,27,25.9,20,18,1,17,17,35,16,2
Sebastian Kowalczyk,POL,"FW,MF",24,Dynamo FC,MLS,3.9,2,2,0,2,0,0,1,0.0,1,3,0,3,2,4,1,1
Sebastian Lletget,USA,"MF,FW",30,FC Dallas,MLS,12.9,17,10,5,7,5,10,22,45.5,12,15,6,9,9,26,12,1
Sebastian Polter,GER,FW,32,Schalke 04,2. Bundesliga,4.7,0,0,0,0,0,0,2,0.0,2,0,0,0,0,0,2,0
Sebastian Ring,SWE,"DF,MF",28,Amiens,Ligue 2,14.4,35,18,20,7,8,21,42,50.0,21,22,4,18,14,49,26,0
Sebastian Santos,MEX,"MF,FW",20,León,Liga MX,4.4,16,8,6,7,3,9,13,69.2,4,7,1,6,4,20,9,0
Sebastian Schonlau,GER,DF,28,Hamburger SV,2. Bundesliga,14.3,36,24,20,15,1,17,26,65.4,9,15,4,11,23,59,47,0
Sebastian Vasiliadis,GRE,"MF,DF",25,Hansa Rostock,2. Bundesliga,12.3,35,22,8,23,4,12,35,34.3,23,16,1,15,21,56,31,0
Sebastiano Desplanches,ITA,GK,20,Palermo,Serie B,2.0,0,0,0,0,0,0,0,0.0,0,0,0,0,0,0,4,0
Sebastiano Esposito,ITA,"MF,FW",21,Sampdoria,Serie B,17.4,38,23,8,18,12,13,34,38.2,21,33,1,32,8,46,15,0
Sebastien Ibeagha,USA,DF,31,FC Dallas,MLS,26.5,17,9,13,4,0,7,18,38.9,11,31,21,10,28,45,149,0
Sebastien Salles-Lamonge,FRA,"MF,FW",27,Atlético,Liga MX,14.9,19,13,10,6,3,7,23,30.4,16,14,4,10,13,32,14,0
Sebastián Blanco,ARG,"FW,MF",34,Portland Timbers,MLS,4.9,0,0,0,0,0,0,4,0.0,4,1,0,1,2,2,0,0
Sebastián Cáceres,URU,DF,23,América,Liga MX,16.2,18,11,12,5,1,6,13,46.2,7,16,12,4,25,43,59,0
Sebastián Driussi,ARG,"MF,FW",26,Austin,MLS,25.6,34,23,12,16,6,11,33,33.3,22,29,6,23,8,42,33,0
Sebastián Ferreira,PAR,FW,24,Dynamo FC,MLS,3.4,5,2,1,3,1,3,7,42.9,4,1,0,1,0,5,0,0
Sebastián Fierro,MEX,MF,21,UANL,Liga MX,4.1,5,4,4,1,0,3,6,50.0,3,4,4,0,6,11,4,0
Sebastián Jurado,MEX,GK,25,Cruz Azul,Liga MX,3.4,0,0,0,0,0,0,0,0.0,0,0,0,0,0,0,0,0
Sebastián Jurado,MEX,GK,25,FC Juárez,Liga MX,13.0,2,1,2,0,0,2,3,66.7,1,0,0,0,0,2,3,0
Sebastián Martínez,MEX,MF,20,América,Liga MX,0.6,1,1,0,1,0,1,1,100.0,0,3,2,1,1,2,1,0
Sebastián Olmedo,PAR,DF,22,Puebla,Liga MX,29.1,64,38,48,14,2,32,69,46.4,37,50,30,20,33,97,116,6
Sebastián Pérez Bouquet,MEX,"MF,FW",20,FC Juárez,Liga MX,5.7,15,12,10,3,2,7,21,33.3,14,8,0,8,4,19,1,0
Sebastián Saucedo,USA,"FW,MF",26,FC Juárez,Liga MX,8.9,17,9,10,4,3,12,23,52.2,11,6,0,6,3,20,6,0
Sebastián Vegas,CHI,DF,26,Monterrey,Liga MX,23.9,42,30,20,18,4,21,50,42.0,29,31,16,15,29,71,86,0
Sei Muroya,JPN,DF,29,Hannover 96,2. Bundesliga,17.0,21,8,10,6,5,11,19,57.9,8,25,7,18,20,41,43,0
Sekou Lega,FRA,"FW,DF",20,Bastia,Ligue 2,0.9,0,0,0,0,0,0,1,0.0,1,0,0,0,0,0,0,0
Sekou Mara,FRA,FW,21,Southampton,EFL,6.3,11,5,4,1,6,3,8,37.5,5,6,1,5,4,15,9,0
Selim Amallah,MAR,MF,27,Valladolid,Segunda Division,0.3,1,0,1,0,0,0,0,0.0,0,0,0,0,2,3,0,0
Selmir Pidro,BIH,DF,24,St. Louis,MLS,0.5,3,1,1,1,1,1,2,50.0,1,1,1,0,0,3,1,0
Semi Ajayi,NGA,DF,29,West Brom,EFL,13.4,19,12,11,6,2,9,15,60.0,6,9,5,4,10,29,30,1
Semih Sahin,GER,MF,23,Elversberg,2. Bundesliga,23.5,55,34,34,19,2,26,68,38.2,42,36,8,28,34,89,38,0
Semir Telalovic,GER,FW,23,Blackburn,EFL,3.4,4,4,1,1,2,2,4,50.0,2,2,0,2,1,5,4,0
Semuel Pizzignacco,ITA,GK,21,FeralpiSalò,Serie B,38.0,2,1,2,0,0,2,3,66.7,1,0,0,0,1,3,18,1
Seny Dieng,SEN,GK,28,Middlesbrough,EFL,35.0,4,3,4,0,0,3,5,60.0,2,0,0,0,0,4,18,4
Serge Raux Yao,FRA,DF,24,Rodez Aveyron,Ligue 2,36.6,43,30,30,13,0,23,35,65.7,12,29,17,12,58,101,166,0
Sergi,ESP,DF,32,Leganés,Segunda Division,40.7,43,23,27,16,0,27,39,69.2,12,57,40,17,34,77,168,0
Sergi Enrich,ESP,"FW,MF",34,Zaragoza,Segunda Division,7.6,14,11,1,8,5,8,13,61.5,5,5,0,5,4,18,16,0
Sergi Gómez,ESP,DF,32,Espanyol,Segunda Division,23.7,18,12,15,3,0,11,13,84.6,2,17,13,4,16,34,94,0
Sergi Palencia,ESP,DF,26,LAFC,MLS,14.0,43,30,30,11,2,26,42,61.9,16,21,3,18,22,65,20,0
Sergi Samper,ESP,MF,29,FC Andorra,Segunda Division,11.5,23,14,16,4,3,10,19,52.6,9,6,2,4,15,38,24,0
Sergio Adrián Flores,MEX,MF,28,Mazatlán,Liga MX,20.1,53,34,28,20,5,31,62,50.0,31,30,9,21,21,74,45,1
Sergio Aguayo,USA,FW,20,Pachuca,Liga MX,2.8,3,1,2,1,0,1,2,50.0,1,1,0,1,1,4,0,0
Sergio Barreto,ARG,DF,24,Pachuca,Liga MX,28.8,57,39,47,9,1,36,47,76.6,11,38,17,21,43,100,166,0
Sergio Bermejo,ESP,"MF,FW",26,Elche,Segunda Division,5.6,11,5,3,6,2,6,9,66.7,3,4,0,4,2,13,5,0
Sergio Bermejo,ESP,"MF,FW",26,Zaragoza,Segunda Division,6.6,9,5,5,4,0,4,10,40.0,6,5,0,5,4,13,3,0
Sergio Busquets,ESP,MF,34,Inter Miami,MLS,10.3,37,19,16,18,3,24,37,64.9,13,12,2,10,17,54,7,1
Sergio Canales,ESP,"MF,FW",32,Monterrey,Liga MX,16.0,15,7,5,8,2,6,17,35.3,11,7,1,6,6,21,4,0
Sergio Carreira,ESP,"DF,MF",23,Elche,Segunda Division,16.5,24,16,13,7,4,15,20,75.0,5,15,3,12,13,37,22,1
Sergio Cubero Ezcurra,ESP,DF,24,Racing Ferrol,Segunda Division,24.4,63,40,38,19,6,31,52,59.6,21,33,8,25,38,101,73,0
Sergio Córdova,VEN,"FW,MF",25,Vancouver W'caps,MLS,9.4,13,11,3,9,1,4,7,57.1,3,6,1,5,1,14,11,0
Sergio De los Ríos,MEX,FW,20,América,Liga MX,0.2,0,0,0,0,0,0,0,0.0,0,1,0,1,1,1,0,0
Sergio Escudero,ESP,DF,34,Valladolid,Segunda Division,28.7,64,38,41,19,4,33,54,61.1,21,36,6,30,20,84,70,0
Sergio González,ESP,"MF,DF",27,Tenerife,Segunda Division,26.7,74,39,28,36,10,29,65,44.6,36,42,11,31,39,113,54,0
Sergio León,ESP,FW,35,Eibar,Segunda Division,4.4,4,2,0,1,3,3,5,60.0,2,2,0,2,0,4,2,0
Sergio León,ESP,FW,35,Elche,Segunda Division,5.4,1,1,0,1,0,0,2,0.0,2,1,0,1,0,1,6,0
Sergio León,ESP,"FW,MF",35,Valladolid,Segunda Division,0.7,0,0,0,0,0,0,0,0.0,0,1,0,1,0,0,0,0
Sergio Lozano,ESP,MF,25,Levante,Segunda Division,24.4,56,30,20,32,4,22,45,48.9,23,19,3,16,8,64,21,1
Sergio Molina,ESP,MF,28,FC Andorra,Segunda Division,28.2,49,25,23,19,7,23,47,48.9,24,19,4,15,19,68,29,1
Sergio Navarro,ESP,MF,23,Leganés,Segunda Division,0.0,0,0,0,0,0,0,0,0.0,0,1,0,1,0,0,0,0
Sergio Ortuño,ESP,MF,25,Eldense,Segunda Division,38.0,72,48,25,36,11,31,78,39.7,47,42,10,32,46,118,46,0
Sergio Postigo,ESP,DF,35,Levante,Segunda Division,18.6,12,7,7,5,0,7,13,53.8,6,21,14,7,11,23,109,1
Sergio Santos Gomes,BRA,"FW,MF",28,FC Cincinnati,MLS,10.0,18,16,3,11,4,2,5,40.0,3,6,0,6,1,19,6,0
Sergio Álvarez,MEX,"FW,DF",18,Atlas,Liga MX,0.4,0,0,0,0,0,0,0,0.0,0,2,0,2,0,0,0,0
Sergio Álvarez,ESP,"MF,DF",32,Eibar,Segunda Division,23.5,65,34,31,31,3,32,63,50.8,31,28,11,17,26,91,40,0
Serhat Güler,GER,"FW,MF",26,Hansa Rostock,2. Bundesliga,0.8,2,1,0,2,0,1,1,100.0,0,1,0,1,0,2,1,0
Serhiy Kryvtsov,UKR,DF,31,Inter Miami,MLS,23.5,19,11,11,7,1,6,13,46.2,7,30,18,12,31,50,81,0
Sessi D'Almeida,BEN,MF,27,Pau FC,Ligue 2,20.2,32,23,15,15,2,20,44,45.5,24,32,9,23,32,64,24,0
Seydouba Cissé,GUI,"MF,FW",23,Leganés,Segunda Division,15.1,32,21,15,15,2,14,26,53.8,12,22,2,20,17,49,15,0
Shady Oukhadda,MAR,"DF,MF",24,Modena,Serie B,15.5,16,6,7,6,3,9,14,64.3,5,8,1,7,6,22,22,0
Shane Duffy,IRL,DF,31,Norwich City,EFL,33.4,35,22,27,6,2,18,30,60.0,12,66,47,19,33,68,187,2
Shane Ferguson,NIR,"DF,FW",32,Rotherham Utd,EFL,2.0,8,6,2,4,2,7,8,87.5,1,5,1,4,3,11,7,0
Shane O'Neill,USA,DF,29,Toronto FC,MLS,10.4,17,13,11,6,0,10,15,66.7,5,14,8,6,16,33,28,0
Shanyder Borgelin,HAI,FW,21,Inter Miami,MLS,1.6,0,0,0,0,0,0,1,0.0,1,1,0,1,1,1,1,0
Shaquell Moore,USA,DF,26,Nashville,MLS,30.8,80,50,53,21,6,42,60,70.0,18,33,11,22,25,105,59,0
Shaun Hutchinson,ENG,DF,32,Millwall,EFL,8.5,20,8,15,4,1,7,13,53.8,6,12,9,3,19,39,25,0
Shea Charles,NIR,"MF,DF",19,Southampton,EFL,16.0,34,18,18,10,6,18,36,50.0,18,23,6,17,22,56,25,2
Shinta Appelkamp,GER,"MF,FW",22,Düsseldorf,2. Bundesliga,18.9,18,12,6,10,2,10,15,66.7,5,16,1,15,9,27,17,0
Shuto Machino,JPN,FW,23,Holstein Kiel,2. Bundesliga,22.9,16,12,7,5,4,11,24,45.8,13,15,3,12,5,21,17,0
Siaka Bakayoko,CIV,DF,18,Amiens,Ligue 2,1.0,2,2,2,0,0,2,3,66.7,1,1,1,0,1,3,5,0
Sidi Sané,GER,"FW,MF",20,Braunschweig,2. Bundesliga,3.6,1,1,1,0,0,1,2,50.0,1,6,0,6,1,2,5,0
Sidiki Cherif,FRA,"FW,MF",16,Angers,Ligue 2,1.0,6,4,2,1,3,4,7,57.1,3,2,0,2,1,7,0,0
Sidnei Tavares,POR,MF,21,Rapids,MLS,3.3,2,0,1,0,1,1,5,20.0,4,2,0,2,1,3,0,0
Sigurd Rosted,NOR,DF,28,Toronto FC,MLS,18.3,23,11,12,10,1,14,21,66.7,7,21,14,7,30,53,74,1
Silas Gnaka,CIV,"MF,DF",24,Magdeburg,2. Bundesliga,26.7,33,22,16,14,3,14,45,31.1,31,41,11,30,22,55,42,2
Silvio Merkaj,ALB,"FW,MF",25,Südtirol,Serie B,15.6,20,12,4,8,8,8,22,36.4,14,10,1,9,6,26,11,0
Simon Asta,GER,DF,22,Greuther Fürth,2. Bundesliga,29.4,29,18,14,13,2,16,35,45.7,19,56,15,41,22,51,64,0
Simon Becher,USA,"FW,MF",23,Vancouver W'caps,MLS,6.8,3,3,0,0,3,0,3,0.0,3,3,0,3,0,3,8,0
Simon Elisor,FRA,FW,24,Troyes,Ligue 2,15.2,10,7,2,5,3,2,9,22.2,7,4,0,4,1,11,16,0
Simon Graves Jensen,DEN,DF,24,Palermo,Serie B,8.9,16,12,8,6,2,11,14,78.6,3,7,4,3,9,25,27,0
Simon Rhein,GER,MF,25,Hansa Rostock,2. Bundesliga,10.0,7,3,1,6,0,4,9,44.4,5,4,1,3,8,15,13,0
Simon Sohm,SUI,MF,22,Parma,Serie B,17.8,18,8,3,8,7,8,15,53.3,7,10,4,6,5,23,9,1
Simon Terodde,GER,FW,35,Schalke 04,2. Bundesliga,22.1,15,9,5,8,2,3,6,50.0,3,11,6,5,3,18,30,0
Simon Zoller,GER,"MF,FW",32,St. Pauli,2. Bundesliga,0.5,0,0,0,0,0,0,0,0.0,0,0,0,0,0,0,0,0
Simone Bastoni,ITA,DF,26,Spezia,Serie B,1.2,7,1,6,1,0,2,2,100.0,0,1,0,1,1,8,0,0
Simone Branca,ITA,MF,31,Cittadella,Serie B,28.5,114,71,52,49,13,55,110,50.0,55,43,13,30,46,160,39,0
Simone Canestrelli,ITA,DF,22,Pisa,Serie B,34.9,48,29,27,21,0,22,31,71.0,9,38,28,10,59,107,132,0
Simone D'Uffizi,ITA,"MF,FW",18,Ascoli,Serie B,7.3,8,5,3,3,2,3,6,50.0,3,11,0,11,4,12,4,0
Simone Davì,ITA,DF,23,Südtirol,Serie B,29.2,41,28,26,9,6,17,25,68.0,8,34,7,27,29,70,68,1
Simone Giordano,ITA,"DF,MF",21,Sampdoria,Serie B,21.3,18,9,7,8,3,12,22,54.5,10,33,5,28,12,30,38,0
Simone Mazzocchi,ITA,"FW,MF",24,Cosenza,Serie B,26.5,17,14,8,7,2,8,28,28.6,20,21,7,14,7,24,34,0
Simone Panada,ITA,"MF,FW",21,Sampdoria,Serie B,0.4,0,0,0,0,0,0,1,0.0,1,3,1,2,0,0,1,0
Simone Pontisso,ITA,MF,26,Catanzaro,Serie B,10.7,24,11,15,9,0,5,14,35.7,9,10,5,5,8,32,14,0
Simone Santoro,ITA,"MF,DF",23,Modena,Serie B,13.1,29,17,16,9,4,11,25,44.0,14,28,10,18,17,46,17,0
Simone Verdi,ITA,"MF,FW",31,Como,Serie B,19.7,27,18,4,16,7,12,27,44.4,15,15,2,13,9,36,3,0
Sinan Bakış,TUR,FW,30,Zaragoza,Segunda Division,12.4,7,4,2,4,1,0,4,0.0,4,6,2,4,1,8,13,0
Sinclair Armstrong,IRL,FW,20,QPR,EFL,19.8,5,4,1,1,3,1,5,20.0,4,11,0,11,3,8,1,0
Siriki Dembélé,CIV,"FW,MF",26,Birmingham City,EFL,22.0,33,20,14,15,4,5,14,35.7,9,19,0,19,28,61,6,0
Siriné Doucouré,MLI,FW,21,Valenciennes,Ligue 2,7.3,8,5,1,4,3,1,1,100.0,0,3,1,2,1,9,10,0
Sirlord Conteh,GER,"FW,MF",27,Paderborn 07,2. Bundesliga,12.4,6,2,2,4,0,1,2,50.0,1,11,3,8,4,10,10,0
Smail Prevljak,BIH,"MF,FW",28,Hertha BSC,2. Bundesliga,8.5,8,4,3,4,1,1,7,14.3,6,7,1,6,3,11,8,0
Soberón,ESP,FW,27,Eldense,Segunda Division,25.8,13,8,1,10,2,3,23,13.0,20,11,0,11,7,20,6,0
Sofiane Alakouch,MAR,DF,25,Paris FC,Ligue 2,10.3,29,20,16,11,2,18,35,51.4,17,7,0,7,15,44,23,0
Sofiane Boudraa,FRA,"FW,MF",20,Valenciennes,Ligue 2,3.0,11,2,2,7,2,7,13,53.8,6,5,0,5,2,13,2,0
Sofiane Djeffal,FRA,MF,23,Austin,MLS,3.5,5,3,2,2,1,2,5,40.0,3,4,1,3,2,7,5,0
Soichiro Kozuki,JPN,"FW,MF",22,Schalke 04,2. Bundesliga,2.0,5,2,0,4,1,0,2,0.0,2,2,0,2,1,6,2,0
Sol Sidibé,FRA,MF,16,Stoke City,EFL,0.3,1,1,0,1,0,0,0,0.0,0,0,0,0,0,1,1,0
Sondre Tronstad,NOR,MF,27,Blackburn,EFL,32.6,102,59,36,56,10,52,96,54.2,44,49,16,33,36,138,45,1
Sone Aluko,NGA,FW,34,Ipswich Town,EFL,0.0,0,0,0,0,0,0,0,0.0,0,0,0,0,0,0,0,0
Sonny Degert,FRA,"MF,FW",22,Pau FC,Ligue 2,1.2,2,1,0,2,0,1,1,100.0,0,0,0,0,0,2,0,0
Sonny Finch,ENG,FW,17,Middlesbrough,EFL,0.1,0,0,0,0,0,0,0,0.0,0,0,0,0,0,0,0,0
Sonny Perkins,ENG,FW,19,Leeds United,EFL,0.0,0,0,0,0,0,0,0,0.0,0,0,0,0,0,0,0,0
Sorba Thomas,WAL,"FW,MF",23,Huddersfield,EFL,38.1,19,13,7,10,2,8,23,34.8,15,24,2,22,11,30,27,0
Sota Kitahara,USA,DF,20,Seattle,MLS,0.0,0,0,0,0,0,0,0,0.0,0,0,0,0,0,0,0,0
Souleymane Basse,SEN,"DF,FW",19,Valenciennes,Ligue 2,20.0,48,33,37,11,0,24,41,58.5,17,25,1,24,40,88,43,1
Spencer Richey,USA,GK,30,Fire,MLS,4.7,1,1,1,0,0,1,1,100.0,0,0,0,0,0,1,3,1
Stanko Jurić,CRO,MF,27,Valladolid,Segunda Division,25.8,90,56,30,48,12,54,102,52.9,48,46,12,34,37,127,52,0
Steeve Beusnard,FRA,MF,31,Pau FC,Ligue 2,25.3,51,29,22,21,8,25,42,59.5,17,34,9,25,29,80,15,2
Stefan Cleveland,USA,GK,28,Seattle,MLS,2.0,0,0,0,0,0,0,0,0.0,0,0,0,0,0,0,0,0
Stefan Frei,SUI,GK,36,Seattle,MLS,32.0,0,0,0,0,0,0,0,0.0,0,0,0,0,0,0,10,2
Stefan Lekovic,SRB,DF,20,Villarreal B,Segunda Division,27.1,27,14,19,8,0,16,35,45.7,19,26,15,11,26,53,121,0
Stefan Medina,COL,DF,31,Monterrey,Liga MX,16.5,44,27,27,15,2,24,37,64.9,13,18,10,8,24,68,50,0
Stefan Simić,CZE,DF,29,Eibar,Segunda Division,0.3,0,0,0,0,0,0,1,0.0,1,0,0,0,0,0,0,0
Stefano Girelli,ITA,"MF,FW",22,Sampdoria,Serie B,4.5,7,6,4,0,3,3,4,75.0,1,5,0,5,5,12,3,0
Stefano Marino,GER,"FW,DF",19,Karlsruher,2. Bundesliga,0.1,0,0,0,0,0,0,0,0.0,0,0,0,0,1,1,0,0
Stefano Moreo,ITA,"FW,MF",30,Pisa,Serie B,22.4,16,10,5,11,0,5,17,29.4,12,25,6,19,9,25,39,0
Stefano Negro,ITA,DF,28,Cittadella,Serie B,16.7,28,18,20,7,1,12,22,54.5,10,16,11,5,32,60,79,1
Stefano Pettinari,ITA,FW,31,Reggiana,Serie B,9.0,2,2,0,2,0,0,6,0.0,6,7,1,6,1,3,4,0
Stefano Scognamillo,ITA,DF,29,Catanzaro,Serie B,33.5,47,29,33,12,2,27,42,64.3,15,36,23,13,40,87,106,1
Stephan Ambrosius,GHA,DF,24,Hamburger SV,2. Bundesliga,13.4,32,17,20,12,0,18,32,56.3,14,32,10,22,25,57,57,0
Stephano Carrillo,MEX,FW,17,Santos,Liga MX,3.9,3,1,1,2,0,1,5,20.0,4,1,1,0,0,3,4,0
Stephen Afrifa,CAN,FW,21,Sporting KC,MLS,0.6,0,0,0,0,0,0,0,0.0,0,1,0,1,1,1,1,0
Stephen Duke-McKenna,GUY,"MF,FW",22,QPR,EFL,1.6,3,1,0,3,0,2,4,50.0,2,4,1,3,5,8,2,0
Stephen Quemper,FRA,DF,30,Ajaccio,Ligue 2,21.0,51,32,31,19,1,21,38,55.3,17,19,2,17,33,84,30,1
Stephen Turnbull,USA,"DF,MF",24,NYCFC,MLS,5.4,11,7,7,4,0,9,16,56.3,7,9,3,6,4,15,10,0
Stephy Mavididi,ENG,FW,25,Leicester City,EFL,39.9,70,50,36,25,9,35,79,44.3,44,46,0,46,19,89,11,0
Steve Birnbaum,USA,DF,32,D.C. United,MLS,17.9,16,9,10,4,2,7,11,63.6,4,15,9,6,23,39,75,0
Steve Clark,USA,GK,36,Dynamo FC,MLS,33.0,1,0,1,0,0,1,1,100.0,0,0,0,0,0,1,10,0
Steve Cook,ENG,DF,32,QPR,EFL,34.1,30,21,23,5,2,17,24,70.8,7,40,26,14,41,71,194,1
Steve Shamal,FRA,"FW,MF",27,Annecy,Ligue 2,6.5,7,4,3,4,0,3,13,23.1,10,7,0,7,5,12,5,0
Steven Beitashour,IRN,DF,35,Rapids,MLS,6.7,6,4,4,2,0,5,10,50.0,5,3,2,1,2,8,18,0
Steven Fortes,CPV,DF,31,Quevilly-Rouen,Ligue 2,8.3,14,6,5,9,0,4,9,44.4,5,13,9,4,8,22,37,1
Steven Moreira,CPV,DF,28,Crew,MLS,32.5,39,20,26,13,0,21,37,56.8,16,36,13,23,21,60,58,2
Steven Skrzybski,GER,"MF,FW",30,Holstein Kiel,2. Bundesliga,19.1,24,17,13,9,2,8,22,36.4,14,18,1,17,12,36,12,0
Steven van der Sloot,NED,DF,21,Schalke 04,2. Bundesliga,3.7,8,4,5,2,1,4,9,44.4,5,6,3,3,2,10,7,0
Stian Rode Gregersen,NOR,DF,28,Bordeaux,Ligue 2,10.9,18,11,9,9,0,6,7,85.7,1,7,4,3,19,37,21,0
Stipe Biuk,CRO,"FW,MF",21,Valladolid,Segunda Division,5.0,7,7,1,5,1,5,12,41.7,7,3,0,3,1,8,0,0
Stipe Biuk,CRO,FW,20,LAFC,MLS,14.9,13,8,7,3,3,6,27,22.2,21,14,1,13,8,21,9,0
Stiven Jimenez,USA,FW,15,FC Cincinnati,MLS,0.0,0,0,0,0,0,0,0,0.0,0,0,0,0,0,0,0,0
Stiven Plaza,ECU,"FW,MF",24,Mazatlán,Liga MX,0.4,0,0,0,0,0,0,0,0.0,0,0,0,0,0,0,0,0
Stoichkov,ESP,FW,30,Eibar,Segunda Division,34.1,25,15,8,9,8,14,47,29.8,33,33,5,28,16,41,24,0
Stone Mambo,FRA,DF,24,Rodez Aveyron,Ligue 2,7.9,30,21,18,11,1,15,24,62.5,9,12,5,7,14,44,27,1
Stuart Armstrong,SCO,MF,31,Southampton,EFL,31.4,34,21,12,16,6,15,44,34.1,29,22,1,21,11,45,24,0
Stéphane Diarra,FRA,"FW,MF",24,Saint-Étienne,Ligue 2,6.5,10,7,3,4,3,3,13,23.1,10,5,0,5,7,17,3,0
Sunusi Ibrahim,NGA,"FW,MF",20,CF Montréal,MLS,13.0,7,2,1,5,1,1,4,25.0,3,3,0,3,2,9,1,0
Svante Ingelsson,SWE,"MF,FW",25,Hansa Rostock,2. Bundesliga,25.8,32,21,11,17,4,10,26,38.5,16,22,8,14,10,42,24,0
Sveinn Guðjohnsen,ISL,"FW,MF",25,Hansa Rostock,2. Bundesliga,2.0,0,0,0,0,0,0,0,0.0,0,3,0,3,0,0,2,0
Syam Ben Youssef,TUN,DF,34,Caen,Ligue 2,3.0,4,2,3,1,0,3,5,60.0,2,1,0,1,4,8,9,0
Sydney Osazuwa,ESP,"DF,MF",17,Leganés,Segunda Division,0.0,0,0,0,0,0,0,0,0.0,0,0,0,0,0,0,0,0
Sydney van Hooijdonk,NED,"FW,MF",23,Norwich City,EFL,1.4,0,0,0,0,0,0,1,0.0,1,1,0,1,0,0,1,0
Szymon Żurkowski,POL,MF,25,Spezia,Serie B,7.1,22,14,7,12,3,10,15,66.7,5,9,0,9,8,30,8,0
Sébastien Cibois,FRA,GK,25,Rodez Aveyron,Ligue 2,12.7,0,0,0,0,0,0,0,0.0,0,0,0,0,0,0,11,1
Sébastien Corchia,FRA,DF,32,Amiens,Ligue 2,23.9,44,29,26,13,5,27,47,57.4,20,31,3,28,30,74,59,0
Séga Coulibaly,FRA,DF,26,LA Galaxy,MLS,1.0,3,2,2,1,0,2,4,50.0,2,0,0,0,0,3,2,0
Tachi,ESP,"MF,DF",26,CD Mirandés,Segunda Division,22.8,57,33,28,22,7,40,72,55.6,32,25,14,11,35,92,55,1
Tahiel Jiménez,MEX,"FW,DF",17,Santos,Liga MX,0.2,0,0,0,0,0,0,0,0.0,0,0,0,0,0,0,0,0
Takashi Uchino,JPN,DF,22,Düsseldorf,2. Bundesliga,4.3,10,8,9,0,1,5,7,71.4,2,1,1,0,6,16,10,0
Talles Magno,BRA,FW,20,NYCFC,MLS,21.2,30,16,8,15,7,14,22,63.6,8,16,0,16,5,35,8,0
Tanguy Lienard,FRA,DF,18,Valenciennes,Ligue 2,1.9,3,3,3,0,0,2,5,40.0,3,2,0,2,3,6,7,0
Tanguy Zoukrou,FRA,DF,20,Troyes,Ligue 2,27.0,22,13,18,4,0,11,17,64.7,6,31,20,11,22,44,99,1
Tani Oluwaseyi,CAN,FW,22,Minnesota Utd,MLS,0.1,2,1,1,1,0,0,0,0.0,0,0,0,0,0,2,1,0
Tanner Beason,USA,DF,25,SJ Earthquakes,MLS,15.6,17,10,12,5,0,14,21,66.7,7,21,17,4,24,41,68,1
Tanner Tessmann,USA,MF,21,Venezia,Serie B,34.9,42,26,11,22,9,20,39,51.3,19,38,20,18,33,75,63,0
Tate Schmitt,USA,DF,25,Dynamo FC,MLS,4.4,4,2,2,1,1,1,2,50.0,1,4,0,4,4,8,4,0
Tatsuhiro Sakamoto,JPN,"MF,FW",26,Coventry City,EFL,20.5,37,19,20,9,8,19,36,52.8,17,27,1,26,16,53,17,0
Tatsuya Ito,JPN,"FW,MF",26,Magdeburg,2. Bundesliga,9.7,6,4,2,2,2,4,6,66.7,2,5,0,5,1,7,7,0
Taxiarchis Fountas,GRE,"FW,MF",27,D.C. United,MLS,12.2,15,7,3,9,3,6,22,27.3,16,16,1,15,5,20,1,0
Taylan Bulut,GER,DF,17,Schalke 04,2. Bundesliga,0.0,0,0,0,0,0,0,0,0.0,0,1,0,1,0,0,0,0
Taylan Duman,GER,MF,26,Nürnberg,2. Bundesliga,8.5,8,5,4,2,2,5,18,27.8,13,16,1,15,8,16,7,0
Taylor Gardner-Hickman,ENG,"MF,DF",21,Bristol City,EFL,24.5,55,30,26,24,5,35,66,53.0,31,23,7,16,29,84,33,0
Taylor Gardner-Hickman,ENG,MF,21,West Brom,EFL,0.1,0,0,0,0,0,0,0,0.0,0,0,0,0,0,0,1,0
Taylor Harwood-Bellis,ENG,DF,21,Southampton,EFL,38.9,31,13,20,8,3,19,26,73.1,7,47,35,12,47,78,134,3
Taylor Luvambo,COD,"MF,FW",24,Guingamp,Ligue 2,2.8,5,5,1,2,2,2,5,40.0,3,7,0,7,0,5,4,0
Taylor Moore,ENG,DF,26,Valenciennes,Ligue 2,15.2,22,13,11,11,0,11,15,73.3,4,18,6,12,21,43,54,0
Taylor Richards,ENG,"MF,FW",22,QPR,EFL,0.6,0,0,0,0,0,0,0,0.0,0,0,0,0,0,0,0,0
Taylor Washington,USA,"DF,MF",29,Nashville,MLS,5.4,10,5,7,3,0,5,7,71.4,2,5,2,3,10,20,16,0
Tayvon Gray,JAM,DF,20,NYCFC,MLS,22.7,39,21,22,11,6,20,28,71.4,8,24,8,16,27,66,74,0
Taïryk Arconte,FRA,FW,19,Rodez Aveyron,Ligue 2,11.9,8,5,0,5,3,3,15,20.0,12,6,1,5,10,18,0,0
Teal Bunbury,USA,FW,32,Nashville,MLS,18.3,8,8,1,3,4,1,9,11.1,8,9,2,7,7,15,8,0
Teemu Pukki,FIN,FW,32,Minnesota Utd,MLS,11.5,0,0,0,0,0,0,6,0.0,6,4,0,4,1,1,8,0
Teenage Hadebe,ZIM,DF,27,Dynamo FC,MLS,11.5,9,5,7,2,0,4,14,28.6,10,22,19,3,13,22,57,1
Tega Ikoba,USA,FW,19,Portland Timbers,MLS,1.0,1,1,0,1,0,1,1,100.0,0,1,0,1,0,1,0,0
Terrence Boyd,USA,FW,32,Kaiserslautern,2. Bundesliga,8.0,8,8,1,5,2,2,5,40.0,3,6,2,4,2,10,10,0
Tete Morente,ESP,"MF,DF",27,Elche,Segunda Division,36.0,56,33,20,25,11,33,67,49.3,34,42,5,37,37,93,56,1
Teto,ESP,"MF,FW",22,Tenerife,Segunda Division,13.6,35,24,13,18,4,19,41,46.3,22,17,0,17,8,43,4,0
Thanasis Androutsos,GRE,"DF,MF",26,Osnabrück,2. Bundesliga,8.0,12,10,7,5,0,6,15,40.0,9,4,0,4,8,20,18,0
Themi Antonoglou,CAN,"DF,MF",21,Toronto FC,MLS,5.3,10,5,2,6,2,6,15,40.0,9,7,1,6,5,15,9,0
Theo Mawene,ENG,FW,16,Preston,EFL,0.1,0,0,0,0,0,0,0,0.0,0,0,0,0,0,0,0,0
Theo Valls,FRA,MF,27,Grenoble,Ligue 2,22.1,32,17,9,19,4,14,39,35.9,25,13,2,11,20,52,15,1
Theodore Ku-Dipietro,USA,"FW,MF",21,D.C. United,MLS,13.0,21,12,10,7,4,5,19,26.3,14,6,0,6,6,27,2,0
Therence Koudou,FRA,DF,18,Pau FC,Ligue 2,11.4,14,7,3,8,3,6,15,40.0,9,14,2,12,10,24,41,0
Thiago,BRA,"FW,MF",22,NYCFC,MLS,1.5,4,2,3,1,0,0,1,0.0,1,2,1,1,0,4,1,0
Thiago Almada,ARG,MF,21,Atlanta Utd,MLS,30.3,24,14,5,11,8,9,32,28.1,23,11,1,10,9,33,1,2
Thiago Martins,BRA,DF,27,NYCFC,MLS,24.3,30,20,23,7,0,19,24,79.2,5,21,10,11,12,42,122,1
Thibault Campanini,FRA,DF,25,Ajaccio,Ligue 2,4.0,4,0,1,2,1,2,7,28.6,5,3,0,3,1,5,10,1
Thibault Delphis,FRA,DF,20,Annecy,Ligue 2,10.8,7,3,4,3,0,4,8,50.0,4,18,12,6,10,17,38,1
Thibault Sinquin,FRA,"MF,DF",31,US Concarneau,Ligue 2,6.2,10,8,6,3,1,5,12,41.7,7,4,1,3,8,18,15,0
Thibaut Vargas,FRA,"DF,MF",23,Stade Laval,Ligue 2,33.0,42,27,24,14,4,28,57,49.1,29,43,7,36,17,59,48,3
Thierno Balde,FRA,DF,21,Troyes,Ligue 2,6.7,10,8,7,2,1,6,12,50.0,6,6,2,4,5,15,13,0
Thijmen Goppel,NED,DF,26,Wehen,2. Bundesliga,24.4,46,28,31,11,4,29,68,42.6,39,22,3,19,14,60,30,0
Thomas Battistella,ITA,MF,22,Modena,Serie B,12.6,35,16,15,19,1,11,23,47.8,12,14,1,13,18,53,27,0
Thomas Bloxham,IRL,FW,18,Blackburn,EFL,0.1,0,0,0,0,0,0,0,0.0,0,0,0,0,0,0,0,0
Thomas Callens,FRA,GK,24,Annecy,Ligue 2,4.5,0,0,0,0,0,0,0,0.0,0,0,0,0,0,0,2,0
Thomas Cannon,IRL,FW,20,Leicester City,EFL,4.8,1,0,1,0,0,0,2,0.0,2,2,0,2,1,2,2,1
Thomas Colléaux,FRA,"DF,FW",18,Pau FC,Ligue 2,2.2,10,6,5,4,1,6,9,66.7,3,3,0,3,4,14,1,0
Thomas Dähne,GER,GK,29,Holstein Kiel,2. Bundesliga,3.0,0,0,0,0,0,0,0,0.0,0,0,0,0,0,0,1,2
Thomas Goiginger,AUT,FW,30,Osnabrück,2. Bundesliga,2.0,6,3,1,4,1,4,7,57.1,3,1,0,1,2,8,2,0
Thomas Hasal,CAN,GK,23,Vancouver W'caps,MLS,1.0,0,0,0,0,0,0,0,0.0,0,0,0,0,0,0,0,0
Thomas Mangani,FRA,MF,36,Ajaccio,Ligue 2,32.5,61,31,22,30,9,30,79,38.0,49,27,13,14,57,118,66,0
Thomas McNamara,USA,"MF,FW",31,NE Revolution,MLS,2.1,1,1,0,0,1,1,3,33.3,2,1,1,0,2,3,3,0
Thomas Monconduit,FRA,MF,32,Saint-Étienne,Ligue 2,14.5,42,26,14,23,5,19,37,51.4,18,10,3,7,15,57,21,0
Thomas Ouwejan,NED,"DF,MF",26,Schalke 04,2. Bundesliga,22.8,45,35,29,12,4,22,40,55.0,18,38,6,32,25,70,48,0
Thore Jacobsen,GER,MF,26,Elversberg,2. Bundesliga,18.1,30,18,17,10,3,15,42,35.7,27,19,4,15,30,60,30,2
Théo De Percin,MTQ,GK,22,Auxerre,Ligue 2,1.0,0,0,0,0,0,0,0,0.0,0,0,0,0,0,0,0,0
Théo Pellenard,FRA,DF,29,Auxerre,Ligue 2,31.9,55,30,40,14,1,33,50,66.0,17,36,21,15,43,98,104,2
Théo Pionnier,FRA,DF,21,Quevilly-Rouen,Ligue 2,0.8,3,2,2,1,0,2,2,100.0,0,3,1,2,2,5,3,0
Tiago Casasola,ARG,"DF,FW",27,Ternana,Serie B,31.9,52,36,26,16,10,36,85,42.4,49,27,8,19,21,73,65,1
Tiago Geralnik,ARG,"MF,FW",21,Villarreal B,Segunda Division,7.2,11,9,5,6,0,5,11,45.5,6,3,0,3,4,15,5,0
Tiago Volpi,BRA,GK,32,Toluca,Liga MX,34.0,1,1,1,0,0,0,0,0.0,0,0,0,0,0,1,18,2
Tidiam Gomis,FRA,"MF,FW",16,Caen,Ligue 2,4.7,6,1,2,3,1,4,5,80.0,1,7,1,6,1,7,2,0
Tidiane Keita,GUI,MF,26,Dunkerque,Ligue 2,10.9,26,19,12,11,3,11,30,36.7,19,12,2,10,11,37,7,0
Tidyane Diagouraga,FRA,MF,20,Valenciennes,Ligue 2,1.5,6,5,2,4,0,3,7,42.9,4,1,0,1,2,8,2,0
Till Cissokho,FRA,DF,23,Quevilly-Rouen,Ligue 2,36.6,52,35,42,9,1,23,32,71.9,9,26,15,11,41,93,154,1
Tim Boss,GER,GK,30,Elversberg,2. Bundesliga,1.0,0,0,0,0,0,0,0,0.0,0,0,0,0,0,0,0,0
Tim Handwerker,GER,"DF,MF",25,Nürnberg,2. Bundesliga,7.7,12,8,4,7,1,8,12,66.7,4,10,4,6,4,16,26,0
Tim Hoffmann,GER,DF,18,Hertha BSC,2. Bundesliga,0.3,0,0,0,0,0,0,0,0.0,0,2,0,2,0,0,1,0
Tim Jabol,FRA,MF,23,Ajaccio,Ligue 2,31.5,55,35,24,25,6,22,38,57.9,16,38,5,33,34,89,31,1
Tim Leibold,GER,DF,29,Sporting KC,MLS,9.7,22,13,8,10,4,9,22,40.9,13,11,1,10,17,39,14,0
Tim Lemperle,GER,"FW,DF",21,Greuther Fürth,2. Bundesliga,26.2,23,11,5,9,9,8,27,29.6,19,46,5,41,12,35,21,0
Tim Melia,USA,GK,36,Sporting KC,MLS,15.8,0,0,0,0,0,0,0,0.0,0,0,0,0,0,0,8,1
Tim Oberdorf,GER,DF,26,Düsseldorf,2. Bundesliga,14.9,11,4,9,0,2,4,9,44.4,5,23,13,10,27,38,69,0
Tim Parker,USA,DF,29,St. Louis,MLS,28.5,29,20,20,6,3,13,27,48.1,14,26,20,6,45,74,151,1
Tim Rossmann,GER,FW,19,Karlsruher,2. Bundesliga,1.3,2,0,0,1,1,1,1,100.0,0,2,2,0,2,4,1,0
Timmy Tillman,GER,MF,24,LAFC,MLS,18.3,41,25,15,22,4,19,52,36.5,33,27,2,25,17,58,12,0
Timo Baumgartl,GER,DF,27,Schalke 04,2. Bundesliga,10.4,17,11,11,5,1,5,13,38.5,8,8,3,5,6,23,34,1
Timo Becker,GER,"DF,MF",26,Holstein Kiel,2. Bundesliga,25.3,36,22,21,9,6,21,39,53.8,18,30,14,16,22,58,87,0
Timo Beermann,GER,DF,32,Osnabrück,2. Bundesliga,5.1,4,2,3,1,0,4,7,57.1,3,6,5,1,7,11,22,0
Timon Weiner,GER,GK,24,Holstein Kiel,2. Bundesliga,30.0,0,0,0,0,0,0,1,0.0,1,0,0,0,0,0,18,1
Timothee Pembele,FRA,"MF,DF",20,Sunderland,EFL,3.2,5,4,4,1,0,3,7,42.9,4,2,1,1,4,9,5,0
Timothée Kolodziejczak,FRA,DF,31,Paris FC,Ligue 2,9.5,8,6,7,1,0,3,7,42.9,4,11,5,6,7,15,27,0
Tino Casali,AUT,GK,27,Braunschweig,2. Bundesliga,1.0,0,0,0,0,0,0,0,0.0,0,0,0,0,0,0,1,0
Tino Costa,ARG,MF,38,Pau FC,Ligue 2,0.5,0,0,0,0,0,0,0,0.0,0,0,0,0,1,1,2,0
Tio Cipot,SVN,"FW,MF",20,Spezia,Serie B,2.3,4,2,0,2,2,2,6,33.3,4,1,0,1,1,5,1,0
Titouan Thomas,FRA,MF,21,Stade Laval,Ligue 2,11.9,20,16,9,11,0,10,18,55.6,8,3,2,1,7,27,14,0
Tjark Ernst,GER,GK,20,Hertha BSC,2. Bundesliga,27.0,0,0,0,0,0,0,1,0.0,1,0,0,0,0,0,10,3
Tjark Scheller,GER,"FW,MF",21,St. Pauli,2. Bundesliga,0.0,0,0,0,0,0,0,0,0.0,0,0,0,0,0,0,0,0
Tjaš Begić,SVN,"MF,FW",20,Parma,Serie B,2.8,5,4,2,2,1,2,4,50.0,2,4,2,2,4,9,2,0
Tobias Mohr,GER,"MF,DF",27,Schalke 04,2. Bundesliga,11.6,18,6,4,13,1,7,24,29.2,17,25,7,18,17,35,14,2
Tobias Müller,GER,DF,29,Paderborn 07,2. Bundesliga,7.4,4,4,3,1,0,3,5,60.0,2,9,5,4,4,8,38,0
Tobias Müller,GER,DF,29,Magdeburg,2. Bundesliga,14.1,18,13,10,8,0,11,22,50.0,11,26,11,15,14,32,40,1
Tobias Raschl,GER,MF,23,Kaiserslautern,2. Bundesliga,22.5,55,27,16,34,5,24,56,42.9,32,19,3,16,25,80,24,0
Tobías Reinhart,ARG,MF,23,Reggiana,Serie B,0.4,1,1,1,0,0,1,1,100.0,0,0,0,0,1,2,0,0
Tolaji Bola,ENG,"MF,DF",24,Rotherham Utd,EFL,0.3,1,1,1,0,0,0,0,0.0,0,1,0,1,1,2,1,0
Tom Barlow,USA,FW,27,NY Red Bulls,MLS,20.5,11,6,3,6,2,4,13,30.8,9,10,1,9,5,16,11,0
Tom Bradshaw,WAL,FW,31,Millwall,EFL,22.3,10,6,0,6,4,5,8,62.5,3,14,4,10,1,11,20,0
Tom Dele-Bashiru,NGA,"MF,DF",23,Watford,EFL,25.1,39,26,18,16,5,16,28,57.1,12,22,6,16,28,67,29,2
Tom Ducrocq,FRA,MF,23,Bastia,Ligue 2,32.6,102,67,50,43,9,45,101,44.6,56,49,7,42,72,174,54,0
Tom Eaves,ENG,FW,31,Rotherham Utd,EFL,11.8,8,6,4,3,1,2,14,14.3,12,8,1,7,0,8,24,0
Tom Edwards,ENG,DF,24,Huddersfield,EFL,7.5,21,16,9,11,1,12,23,52.2,11,8,4,4,10,31,26,0
Tom Fellows,ENG,"FW,MF",20,West Brom,EFL,16.6,13,6,5,3,5,5,14,35.7,9,11,1,10,5,18,9,0
Tom Glover,AUS,GK,25,Middlesbrough,EFL,11.0,0,0,0,0,0,0,3,0.0,3,0,0,0,0,0,6,0
Tom Gomes,FRA,DF,19,Pau FC,Ligue 2,0.1,0,0,0,0,0,0,0,0.0,0,0,0,0,0,0,0,0
Tom Ince,ENG,"FW,MF",31,Watford,EFL,9.4,14,8,5,6,3,9,16,56.3,7,12,1,11,7,21,7,0
Tom Iorpenda,ENG,MF,18,Huddersfield,EFL,0.6,0,0,0,0,0,0,1,0.0,1,2,0,2,1,1,0,0
Tom Lebeau,FRA,MF,25,US Concarneau,Ligue 2,1.0,2,1,1,0,1,2,5,40.0,3,2,0,2,2,4,0,0
Tom Lees,ENG,DF,32,Huddersfield,EFL,28.0,28,20,16,10,2,15,21,71.4,6,36,24,12,29,57,127,0
Tom Meynadier,FRA,"DF,MF",23,Bastia,Ligue 2,7.8,16,13,12,3,1,13,20,65.0,7,5,2,3,15,31,32,0
Tom Rothe,GER,"DF,MF",18,Holstein Kiel,2. Bundesliga,29.7,41,26,23,9,9,22,51,43.1,29,41,6,35,32,73,81,2
Tom Watson,ENG,FW,17,Sunderland,EFL,0.0,1,0,0,1,0,1,1,100.0,0,0,0,0,0,1,0,0
Tom van de Looi,NED,MF,24,Brescia,Serie B,17.4,29,18,9,14,6,15,26,57.7,11,18,5,13,20,49,37,0
Tomas Romero,SLV,GK,22,Toronto FC,MLS,6.0,0,0,0,0,0,0,0,0.0,0,0,0,0,0,0,5,2
Tomeu Nadal,ESP,GK,35,Tenerife,Segunda Division,2.8,0,0,0,0,0,0,0,0.0,0,0,0,0,0,0,2,0
Tommaso Arrigoni,ITA,"MF,FW",29,Como,Serie B,0.3,0,0,0,0,0,0,0,0.0,0,0,0,0,0,0,1,0
Tommaso Arrigoni,ITA,MF,29,Südtirol,Serie B,16.5,21,14,12,9,0,10,23,43.5,13,13,1,12,12,33,15,1
Tommaso Barbieri,ITA,DF,20,Pisa,Serie B,22.9,49,28,21,18,10,18,38,47.4,20,33,7,26,30,79,44,1
Tommaso Biasci,ITA,"FW,MF",28,Catanzaro,Serie B,23.1,22,14,6,15,1,9,16,56.3,7,10,1,9,2,24,13,0
Tommaso Cassandro,ITA,"DF,MF",23,Como,Serie B,9.8,15,11,9,6,0,11,11,100.0,0,11,3,8,11,26,19,0
Tommaso D'Orazio,ITA,DF,33,Cosenza,Serie B,19.0,38,28,20,16,2,17,34,50.0,17,31,9,22,14,52,53,0
Tommaso Fumagalli,ITA,"MF,FW",23,Como,Serie B,1.0,0,0,0,0,0,0,2,0.0,2,3,0,3,0,0,2,0
Tommaso Milanese,ITA,"MF,FW",21,Ascoli,Serie B,6.2,6,4,3,3,0,4,10,40.0,6,9,0,9,5,11,2,0
Tommaso Silvestri,ITA,DF,31,Modena,Serie B,0.0,0,0,0,0,0,0,0,0.0,0,0,0,0,0,0,1,0
Tommaso Vitali,ITA,GK,23,Ternana,Serie B,6.0,0,0,0,0,0,0,0,0.0,0,0,0,0,0,0,0,0
Tommy Conway,SCO,FW,20,Bristol City,EFL,25.4,17,7,3,9,5,5,13,38.5,8,20,3,17,3,20,7,0
Tommy Maistrello,ITA,FW,30,Cittadella,Serie B,10.7,11,5,1,5,5,2,13,15.4,11,14,3,11,3,14,8,0
Tommy Simkin,ENG,GK,18,Stoke City,EFL,1.0,0,0,0,0,0,0,0,0.0,0,0,0,0,0,0,0,0
Tommy Smith,ENG,DF,31,Middlesbrough,EFL,4.3,10,5,7,3,0,8,14,57.1,6,6,0,6,10,20,11,0
Tommy Thompson,USA,"MF,DF",27,SJ Earthquakes,MLS,3.9,7,6,5,1,1,4,9,44.4,5,2,0,2,2,9,11,0
Tomás Alarcón,CHI,MF,25,Cartagena,Segunda Division,26.5,38,24,23,12,3,16,31,51.6,15,27,8,19,27,65,39,0
Tomás Avilés,ARG,DF,18,Inter Miami,MLS,9.7,24,15,16,7,1,16,27,59.3,11,9,5,4,19,43,10,0
Tomás Belmonte,ARG,MF,25,Toluca,Liga MX,15.6,60,46,30,21,9,29,50,58.0,21,26,5,21,26,86,29,1
Tomás Chancalay,ARG,"FW,MF",24,NE Revolution,MLS,9.5,17,11,6,7,4,8,22,36.4,14,8,0,8,3,20,5,0
Tomás Esteves,POR,"DF,MF",21,Pisa,Serie B,24.7,36,23,13,16,7,15,29,51.7,14,14,4,10,14,50,43,0
Tomás Mejías,ESP,GK,35,Cartagena,Segunda Division,2.0,0,0,0,0,0,0,0,0.0,0,0,0,0,0,0,4,1
Tomáš Kalas,CZE,DF,30,Schalke 04,2. Bundesliga,23.4,19,9,10,8,1,13,17,76.5,4,32,17,15,49,68,107,0
Tomáš Ostrák,CZE,"MF,FW",22,St. Louis,MLS,12.8,25,17,11,9,5,11,31,35.5,20,11,0,11,2,27,5,0
Tomáš Vaclík,CZE,GK,35,Albacete,Segunda Division,12.0,0,0,0,0,0,0,0,0.0,0,0,0,0,0,0,4,0
Toni Datković,CRO,DF,30,Albacete,Segunda Division,3.6,6,3,2,4,0,0,3,0.0,3,1,0,1,3,9,15,0
Toni Datković,CRO,DF,30,Cartagena,Segunda Division,1.0,0,0,0,0,0,0,0,0.0,0,2,1,1,1,1,3,0
Toni Leistner,GER,DF,32,Hertha BSC,2. Bundesliga,22.4,32,21,21,11,0,21,25,84.0,4,32,22,10,40,72,121,0
Toni Moya,ESP,MF,26,Zaragoza,Segunda Division,28.5,58,39,26,27,5,31,54,57.4,23,31,8,23,16,74,33,1
Tony Abad,ESP,DF,27,Eldense,Segunda Division,31.8,51,37,26,20,5,22,36,61.1,14,35,8,27,30,81,83,2
Tony Alfaro,USA,DF,29,LA Galaxy,MLS,4.2,4,3,2,2,0,2,6,33.3,4,8,7,1,5,9,19,0
Tony Alfaro,USA,DF,29,NYCFC,MLS,4.2,4,1,3,1,0,2,6,33.3,4,4,3,1,4,8,12,0
Tony Rölke,GER,MF,20,Hertha BSC,2. Bundesliga,0.3,3,1,1,1,1,3,3,100.0,0,1,0,1,1,4,0,0
Tony Springett,IRL,"FW,MF",20,Norwich City,EFL,2.4,5,3,2,3,0,4,5,80.0,1,6,2,4,1,6,2,0
Tony Strata,FRA,DF,18,Ajaccio,Ligue 2,13.9,29,22,16,13,0,16,28,57.1,12,9,2,7,29,58,25,0
Trai Hume,NIR,DF,21,Sunderland,EFL,45.2,152,97,73,68,11,90,159,56.6,69,78,28,50,64,216,100,1
Tristan Blackmon,USA,DF,26,Vancouver W'caps,MLS,28.0,17,10,12,4,1,11,19,57.9,8,24,17,7,34,51,116,1
Tristan Muyumba,FRA,MF,25,Atlanta Utd,MLS,9.1,31,15,16,13,2,12,27,44.4,15,13,1,12,4,35,2,1
Tsiki Ntsabeleng,RSA,"MF,FW",24,FC Dallas,MLS,3.9,7,2,3,3,1,3,6,50.0,3,4,1,3,3,10,2,0
Tuomas Ollila,FIN,"DF,FW",23,Paris FC,Ligue 2,3.4,6,5,3,3,0,6,9,66.7,3,2,0,2,2,8,1,0
Tyler Blackett,ENG,DF,29,Rotherham Utd,EFL,10.0,16,11,11,5,0,9,14,64.3,5,21,13,8,11,27,47,0
Tyler Boyd,USA,"FW,MF",28,LA Galaxy,MLS,25.8,35,23,14,14,7,17,43,39.5,26,25,3,22,12,47,11,0
Tyler Dibling,ENG,FW,17,Southampton,EFL,0.0,1,1,0,1,0,1,1,100.0,0,1,0,1,0,1,0,0
Tyler Miller,USA,GK,29,D.C. United,MLS,24.5,0,0,0,0,0,0,2,0.0,2,0,0,0,2,2,21,5
Tyler Morton,ENG,MF,20,Hull City,EFL,33.0,53,32,21,29,3,26,55,47.3,29,52,14,38,24,77,43,0
Tyler Roberts,WAL,"FW,MF",24,Birmingham City,EFL,8.1,13,7,3,8,2,5,11,45.5,6,7,0,7,4,17,8,0
Tyler Wolff,USA,"FW,MF",19,Atlanta Utd,MLS,7.2,19,9,7,11,1,8,23,34.8,15,9,2,7,4,23,3,0
Tymoteusz Puchacz,POL,DF,24,Kaiserslautern,2. Bundesliga,28.9,37,23,26,10,1,19,45,42.2,26,23,4,19,17,54,48,0
Tyreeq Bakinson,ENG,MF,24,Sheffield Weds,EFL,3.2,3,2,1,2,0,0,2,0.0,2,4,1,3,6,9,7,0
Tyreik Wright,IRL,FW,21,Plymouth Argyle,EFL,1.0,3,2,1,2,0,1,2,50.0,1,0,0,0,2,5,2,0
Tyrell Sellars-Fleming,ENG,FW,18,Hull City,EFL,0.0,0,0,0,0,0,0,0,0.0,0,0,0,0,0,0,0,0
Tyrese Campbell,ENG,FW,23,Stoke City,EFL,13.3,12,11,4,5,3,5,8,62.5,3,14,4,10,1,13,13,0
Tyrhys Dolan,ENG,"FW,MF",21,Blackburn,EFL,25.8,26,16,6,14,6,7,26,26.9,19,25,2,23,10,36,10,0
Ugo Bonnet,FRA,FW,29,Valenciennes,Ligue 2,7.5,2,0,0,1,1,1,5,20.0,4,6,1,5,0,2,7,0
Ugo Bonnet,FRA,"MF,FW",29,Guingamp,Ligue 2,1.0,1,1,0,1,0,0,2,0.0,2,1,0,1,0,1,0,0
Ulises Rivas,MEX,MF,27,UNAM,Liga MX,27.2,51,34,15,32,4,21,57,36.8,36,29,10,19,18,69,52,0
Umberto Eusepi,ITA,"FW,MF",34,Calcio Lecco 1912,Serie B,2.1,1,1,0,1,0,0,1,0.0,1,0,0,0,0,1,2,0
Umberto Saracco,ITA,GK,29,Calcio Lecco 1912,Serie B,12.5,0,0,0,0,0,0,0,0.0,0,0,0,0,0,0,3,0
Unai Bilbao,ESP,DF,29,Atlético,Liga MX,25.0,18,13,11,7,0,8,14,57.1,6,42,33,9,15,33,156,1
Unai Bustinza,ESP,DF,32,Amorebieta,Segunda Division,16.5,35,20,24,10,1,21,31,67.7,10,21,11,10,22,57,76,0
Unai Elgezabal,ESP,"DF,MF",31,Burgos,Segunda Division,30.7,41,25,23,15,3,25,46,54.3,21,41,24,17,37,78,141,0
Unai Vencedor Paris,ESP,MF,23,Eibar,Segunda Division,15.1,27,18,11,14,2,15,33,45.5,18,23,8,15,14,41,31,0
Uriel Antuna,MEX,"MF,FW",25,Cruz Azul,Liga MX,29.8,16,10,2,11,3,7,16,43.8,9,22,2,20,13,29,10,0
Uroš Đurđević,MNE,FW,30,Sporting Gijón,Segunda Division,22.5,13,7,6,4,3,10,15,66.7,5,18,1,17,2,15,20,0
Uziel García,MEX,"DF,FW",22,Atlético,Liga MX,2.1,1,1,0,1,0,0,0,0.0,0,1,1,0,3,4,1,0
Vakoun Issouf Bayo,CIV,FW,26,Watford,EFL,24.7,22,15,4,14,4,6,12,50.0,6,10,5,5,8,30,19,0
Valber Huerta,CHI,DF,29,Toluca,Liga MX,22.3,26,16,14,10,2,13,22,59.1,9,17,12,5,28,54,77,1
Valentin Antov,BUL,DF,22,Cremonese,Serie B,29.3,48,31,24,20,4,23,34,67.6,11,38,18,20,35,83,91,1
Valentin Henry,FRA,DF,29,Caen,Ligue 2,30.5,57,35,30,24,3,41,78,52.6,37,32,4,28,20,77,36,0
Valentin Jacob,FRA,"MF,FW",29,Ajaccio,Ligue 2,16.5,46,32,17,25,4,22,41,53.7,19,19,0,19,18,64,12,1
Valentin Mihaila,ROU,"FW,MF",23,Parma,Serie B,17.8,20,14,7,6,7,8,23,34.8,15,22,1,21,10,30,10,0
Valentín Rodríguez,URU,DF,22,Pachuca,Liga MX,3.0,9,7,5,3,1,2,4,50.0,2,1,0,1,3,12,10,0
Valerio Crespi,ITA,"FW,MF",18,Cosenza,Serie B,3.4,2,1,0,2,0,0,2,0.0,2,0,0,0,1,3,2,0
Valerio Di Cesare,ITA,DF,40,Bari,Serie B,26.6,25,19,17,7,1,12,15,80.0,3,34,20,14,24,49,91,0
Valerio Mantovani,ITA,DF,27,Ascoli,Serie B,15.8,15,10,7,8,0,10,13,76.9,3,17,13,4,20,35,44,2
Valerio Mantovani,ITA,DF,27,Ternana,Serie B,11.0,17,9,10,6,1,10,16,62.5,6,19,10,9,19,36,44,0
Valerio Mastrantonio,ITA,MF,24,Cittadella,Serie B,9.2,28,18,8,14,6,11,20,55.0,9,10,2,8,11,39,9,0
Valerio Verre,ITA,"MF,FW",29,Sampdoria,Serie B,19.5,26,18,8,12,6,11,27,40.7,16,22,1,21,14,40,10,0
Vallejo,ESP,GK,29,Eldense,Segunda Division,11.0,0,0,0,0,0,0,0,0.0,0,0,0,0,0,0,1,2
Vasilios Zagaritis,GRE,DF,22,Parma,Serie B,7.1,9,3,4,4,1,5,12,41.7,7,10,2,8,6,15,20,0
Vedran Celjak,CRO,DF,31,Calcio Lecco 1912,Serie B,26.8,26,22,15,10,1,14,25,56.0,11,34,26,8,31,57,121,0
Ventura Alvarado,USA,DF,30,Mazatlán,Liga MX,12.7,21,11,17,3,1,13,20,65.0,7,10,7,3,11,32,48,1
Vicente Poggi,URU,MF,21,Necaxa,Liga MX,5.8,16,15,11,5,0,5,17,29.4,12,8,1,7,11,27,5,1
Victor Griffith,PAN,MF,22,Portland Timbers,MLS,1.0,0,0,0,0,0,0,0,0.0,0,2,0,2,0,0,3,0
Victor Lobry,FRA,MF,28,Guingamp,Ligue 2,13.9,23,15,10,11,2,13,24,54.2,11,14,3,11,23,46,9,0
Victor Lobry,FRA,"MF,DF",28,Saint-Étienne,Ligue 2,3.6,8,5,3,2,3,2,6,33.3,4,7,0,7,5,13,6,0
Victor Lopez,MEX,"MF,FW",20,Monterrey,Liga MX,4.2,9,4,4,3,2,3,9,33.3,6,5,0,5,3,12,0,0
Victor Mollejo,ESP,"FW,MF",23,Zaragoza,Segunda Division,20.3,30,21,15,10,5,17,37,45.9,20,16,1,15,11,41,18,0
Victor Moreno,ESP,"FW,MF",40,Villarreal B,Segunda Division,1.7,2,1,0,1,1,1,4,25.0,3,0,0,0,0,2,1,0
Victor Pálsson,ISL,"DF,MF",31,D.C. United,MLS,17.5,28,16,11,15,2,14,27,51.9,13,17,5,12,25,53,58,0
Victor Torp,DEN,MF,24,Coventry City,EFL,7.8,19,9,8,8,3,7,12,58.3,5,13,1,12,7,26,14,0
Victor Ulloa,USA,MF,30,Inter Miami,MLS,1.8,6,3,4,2,0,4,11,36.4,7,1,1,0,2,8,2,0
Victor Wanyama,KEN,MF,31,CF Montréal,MLS,19.9,31,16,13,17,1,9,31,29.0,22,12,2,10,23,54,24,1
Viktor Johansson,SWE,GK,24,Rotherham Utd,EFL,44.0,2,1,2,0,0,2,3,66.7,1,0,0,0,0,2,22,1
Vincent Manceau,FRA,DF,34,Guingamp,Ligue 2,6.6,12,10,7,3,2,5,12,41.7,7,11,4,7,7,19,14,0
Vincent Marchetti,FRA,MF,26,Ajaccio,Ligue 2,12.7,21,12,11,9,1,13,29,44.8,16,15,5,10,12,33,14,1
Vincent Marchetti,FRA,MF,26,Paris FC,Ligue 2,4.5,5,3,2,3,0,0,9,0.0,9,2,0,2,4,9,5,0
Vincent Pajot,FRA,MF,32,Annecy,Ligue 2,26.6,70,42,18,39,13,19,41,46.3,22,43,8,35,38,108,50,0
Vincent Vermeij,NED,FW,28,Düsseldorf,2. Bundesliga,20.4,7,6,1,4,2,3,11,27.3,8,13,4,9,3,10,36,0
Vincenzo Colangiuli,ITA,FW,18,Bari,Serie B,0.7,0,0,0,0,0,0,0,0.0,0,2,0,2,0,0,0,0
Vincenzo Millico,ITA,"MF,FW",22,Ascoli,Serie B,2.4,4,4,2,1,1,2,5,40.0,3,1,0,1,0,4,0,0
Vinicius Mello,BRA,FW,20,Charlotte,MLS,0.6,0,0,0,0,0,0,1,0.0,1,0,0,0,0,0,2,0
Virgiliu Postolachi,MDA,FW,23,Grenoble,Ligue 2,14.3,5,3,0,3,2,3,4,75.0,1,6,0,6,5,10,12,0
Visar Musliu,MKD,DF,28,Paderborn 07,2. Bundesliga,22.1,32,21,18,12,2,13,26,50.0,13,21,13,8,25,57,71,2
Vital N'Simba,COD,DF,30,Bordeaux,Ligue 2,22.4,54,34,24,24,6,23,41,56.1,18,21,5,16,28,82,35,1
Viti,ESP,"DF,MF",26,Oviedo,Segunda Division,37.0,60,37,35,18,7,34,56,60.7,22,34,6,28,36,96,37,0
Vitinho,BRA,"FW,MF",22,Atlético,Liga MX,18.0,24,15,8,14,2,14,35,40.0,21,12,1,11,6,30,3,0
Vittorio Agostinelli,ITA,FW,21,Calcio Lecco 1912,Serie B,0.3,2,1,1,1,0,1,2,50.0,1,1,0,1,0,2,0,0
Vittorio Parigini,ITA,"DF,MF",27,FeralpiSalò,Serie B,6.4,15,9,10,2,3,5,14,35.7,9,4,1,3,5,20,6,0
Vittorio Parigini,ITA,"FW,MF",27,Calcio Lecco 1912,Serie B,7.7,9,5,4,5,0,1,6,16.7,5,5,1,4,8,17,5,0
Vladimir Loroña,MEX,DF,24,UANL,Liga MX,1.1,4,3,0,1,3,3,5,60.0,2,1,0,1,2,6,3,0
Vladimir Loroña,MEX,"DF,MF",24,Santos,Liga MX,1.9,4,2,2,2,0,2,6,33.3,4,2,1,1,1,5,5,0
Václav Hladký,CZE,GK,32,Ipswich Town,EFL,46.0,2,2,2,0,0,2,4,50.0,2,0,0,0,1,3,27,5
Vénuste Baboula,CTA,MF,24,Quevilly-Rouen,Ligue 2,1.0,4,2,0,3,1,2,4,50.0,2,0,0,0,0,4,0,0
Víctor Arteaga,MEX,MF,19,Toluca,Liga MX,0.8,2,0,1,1,0,1,2,50.0,1,0,0,0,0,2,1,0
Víctor Barajas,MEX,MF,20,León,Liga MX,0.4,0,0,0,0,0,0,0,0.0,0,0,0,0,1,1,1,0
Víctor Camarasa,ESP,MF,30,Oviedo,Segunda Division,5.1,6,4,2,4,0,4,10,40.0,6,7,0,7,10,16,7,0
Víctor Campuzano,ESP,FW,27,Sporting Gijón,Segunda Division,9.6,9,6,1,5,3,5,8,62.5,3,5,1,4,0,9,5,0
Víctor Dávila,CHI,FW,25,León,Liga MX,2.8,1,1,0,1,0,1,3,33.3,2,4,0,4,0,1,1,0
Víctor García,ESP,"MF,DF",27,Alcorcón,Segunda Division,30.7,64,43,27,26,11,36,74,48.6,38,41,6,35,42,106,41,0
Víctor Guzmán,MEX,MF,28,Guadalajara,Liga MX,18.5,41,22,14,23,4,20,43,46.5,23,20,1,19,5,46,14,0
Víctor Guzmán,MEX,DF,21,Monterrey,Liga MX,25.9,39,23,29,9,1,18,20,90.0,2,29,15,14,44,83,76,2
Víctor Meseguer,ESP,"MF,FW",25,Valladolid,Segunda Division,23.7,36,18,13,15,8,15,31,48.4,16,33,3,30,18,54,23,0
Víctor Rofino,ESP,DF,21,Valladolid,Segunda Division,1.0,1,0,0,1,0,1,3,33.3,2,3,2,1,2,3,5,0
Víctor Ruiz,ESP,DF,35,Espanyol,Segunda Division,10.4,9,7,7,2,0,5,8,62.5,3,6,4,2,11,20,24,1
Víctor Ríos,MEX,MF,19,Atlas,Liga MX,3.3,16,10,10,5,1,8,14,57.1,6,10,5,5,6,22,16,0
Víctor Vázquez,ESP,"MF,FW",36,Toronto FC,MLS,2.7,3,2,2,1,0,0,0,0.0,0,1,1,0,2,5,2,1
Wahid Faghir,DEN,FW,20,Elversberg,2. Bundesliga,5.9,5,3,1,4,0,3,8,37.5,5,8,2,6,0,5,2,0
Waldo Madrid,MEX,"DF,FW",19,Necaxa,Liga MX,0.5,3,3,2,1,0,1,2,50.0,1,0,0,0,1,4,0,0
Waldo Rubio,ESP,"MF,FW",28,Tenerife,Segunda Division,15.3,11,8,3,5,3,6,22,27.3,16,10,0,10,4,15,17,0
Walker Zimmerman,USA,DF,29,Nashville,MLS,20.5,31,19,23,7,1,12,24,50.0,12,31,19,12,32,63,100,0
Waniss Taibi,FRA,MF,21,Rodez Aveyron,Ligue 2,26.4,72,42,26,37,9,22,54,40.7,32,26,5,21,29,101,17,0
Wanya Marcal-Madivadua,POR,FW,20,Leicester City,EFL,1.6,2,2,0,2,0,2,3,66.7,1,3,0,3,0,2,1,0
Warren Caddy,MAD,FW,26,Annecy,Ligue 2,6.8,5,5,2,2,1,3,4,75.0,1,0,0,0,0,5,2,0
Warren Caddy,MAD,MF,26,Paris FC,Ligue 2,0.2,0,0,0,0,0,0,0,0.0,0,0,0,0,0,0,0,0
Wes Burns,WAL,FW,28,Ipswich Town,EFL,26.5,27,14,8,11,8,14,40,35.0,26,33,3,30,15,42,11,0
Wes Harding,JAM,DF,26,Millwall,EFL,21.2,29,17,10,19,0,18,25,72.0,7,24,13,11,32,61,67,0
Wesley Hoedt,NED,DF,29,Watford,EFL,44.0,89,61,67,18,4,62,83,74.7,21,62,36,26,77,166,204,3
Wesley Moraes,BRA,"FW,MF",26,Stoke City,EFL,7.4,2,2,0,1,1,1,1,100.0,0,3,0,3,2,4,10,0
Wikelman Carmona,VEN,"FW,MF",19,NY Red Bulls,MLS,7.4,8,6,3,2,3,3,15,20.0,12,2,0,2,3,11,3,0
Wil Trapp,USA,MF,30,Minnesota Utd,MLS,26.9,56,38,27,23,6,21,72,29.2,51,28,7,21,30,86,32,1
Wilder Cartagena,PER,MF,28,Orlando City,MLS,21.1,57,30,20,31,6,24,58,41.4,34,31,7,24,11,68,25,0
Wilfred Ndidi,NGA,MF,26,Leicester City,EFL,23.6,37,25,10,21,6,11,22,50.0,11,20,6,14,27,64,36,0
Wilfried Gnonto,ITA,"FW,MF",19,Leeds United,EFL,18.4,33,23,15,9,9,16,31,51.6,15,23,1,22,4,37,21,0
Wilitty Younoussa,CMR,MF,21,Rodez Aveyron,Ligue 2,19.3,48,29,17,23,8,27,50,54.0,23,20,1,19,20,68,4,1
Will Bruin,USA,FW,33,Austin,MLS,3.9,0,0,0,0,0,0,4,0.0,4,0,0,0,0,0,8,0
Will Keane,IRL,"FW,MF",30,Preston,EFL,29.0,26,18,7,15,4,10,21,47.6,11,22,5,17,10,36,23,0
Will Vaulks,WAL,MF,29,Sheffield Weds,EFL,26.2,82,48,43,35,4,44,100,44.0,56,43,8,35,51,133,49,1
Willer Ditta,COL,DF,26,Cruz Azul,Liga MX,27.3,39,30,26,11,2,16,33,48.5,17,31,14,17,23,62,71,1
William Agada,NGA,FW,23,Sporting KC,MLS,7.6,3,2,1,1,1,1,5,20.0,4,6,2,4,2,5,1,0
William Benard,FRA,MF,20,Stade Laval,Ligue 2,2.0,4,3,2,1,1,2,9,22.2,7,3,1,2,6,10,2,0
William Mikelbrencis,FRA,DF,19,Hamburger SV,2. Bundesliga,4.3,7,5,5,1,1,5,7,71.4,2,5,2,3,10,17,20,0
William Sands,USA,"DF,MF",22,Crew,MLS,5.4,11,9,4,4,3,7,11,63.6,4,8,3,5,4,15,5,0
William Smallbone,IRL,MF,23,Southampton,EFL,33.4,49,34,18,23,8,18,47,38.3,29,33,8,25,30,79,23,0
William Tesillo,COL,DF,33,León,Liga MX,20.8,35,18,23,10,2,17,33,51.5,16,14,7,7,21,56,64,0
William Yarbrough,USA,GK,33,Rapids,MLS,20.0,0,0,0,0,0,0,2,0.0,2,0,0,0,0,0,13,1
Wolo Touré,CIV,"FW,MF",19,Ajaccio,Ligue 2,0.6,0,0,0,0,0,0,1,0.0,1,0,0,0,1,1,0,0
Wout Faes,BEL,DF,25,Leicester City,EFL,42.5,58,36,31,24,3,29,42,69.0,13,56,35,21,59,117,133,2
Wouter Burger,NED,MF,22,Stoke City,EFL,29.2,102,63,30,59,13,32,67,47.8,35,52,9,43,34,136,39,0
Woyo Coulibaly,FRA,DF,24,Parma,Serie B,20.9,38,26,20,12,6,18,25,72.0,7,15,4,11,27,65,42,0
Wyatt Omsberg,USA,DF,27,Fire,MLS,7.9,7,2,6,1,0,3,6,50.0,3,14,13,1,14,21,33,0
Wylan Cyprien,FRA,MF,28,Parma,Serie B,8.5,12,7,4,7,1,5,9,55.6,4,12,4,8,4,16,5,0
Xabier Etxeita,ESP,DF,36,Amorebieta,Segunda Division,25.3,35,18,26,8,1,27,39,69.2,12,19,12,7,22,57,128,0
Xande Silva,POR,FW,25,Atlanta Utd,MLS,7.1,4,0,0,2,2,1,6,16.7,5,1,0,1,4,8,7,0
Xavi Grande,ESP,DF,19,Levante,Segunda Division,6.8,12,6,8,4,0,9,12,75.0,3,12,4,8,4,16,11,0
Xavi Quintillà,ESP,DF,27,Alcorcón,Segunda Division,20.3,30,20,18,8,4,17,23,73.9,6,16,5,11,12,42,45,0
Xavier Amaechi,ENG,"MF,FW",22,Magdeburg,2. Bundesliga,7.8,8,5,3,5,0,3,10,30.0,7,6,0,6,3,11,4,0
Xavier Arreaga,ECU,"DF,MF",28,Seattle,MLS,3.9,6,6,4,2,0,3,4,75.0,1,2,1,1,1,7,6,0
Xavier Chavalerin,FRA,MF,32,Troyes,Ligue 2,30.2,42,32,21,18,3,13,34,38.2,21,29,8,21,29,71,48,0
Xavier Kouassi,CIV,DF,33,Pau FC,Ligue 2,23.5,27,16,18,8,1,12,17,70.6,5,27,13,14,35,62,93,0
Xavier Simons,ENG,"MF,FW",20,Hull City,EFL,0.2,0,0,0,0,0,0,0,0.0,0,1,1,0,0,0,1,1
Xherdan Shaqiri,SUI,MF,31,Fire,MLS,22.8,10,6,6,4,0,2,10,20.0,8,12,2,10,5,15,1,2
Yacine Bammou,MAR,"FW,MF",31,Ajaccio,Ligue 2,15.3,22,16,9,11,2,9,18,50.0,9,23,2,21,11,33,17,0
Yacine El Amri,FRA,"DF,MF",19,Valenciennes,Ligue 2,1.0,1,0,0,1,0,0,0,0.0,0,1,0,1,1,2,0,0
Yacine Qasmi,MAR,FW,33,Eibar,Segunda Division,0.8,1,1,1,0,0,0,1,0.0,1,3,0,3,0,1,1,0
Yacouba Barry,FRA,"MF,DF",20,Annecy,Ligue 2,18.0,44,30,15,22,7,23,51,45.1,28,23,3,20,22,66,23,0
Yael Mouanga,FRA,DF,18,Bordeaux,Ligue 2,0.0,0,0,0,0,0,0,0,0.0,0,0,0,0,0,0,2,0
Yahia Fofana,CIV,GK,22,Angers,Ligue 2,33.0,0,0,0,0,0,0,2,0.0,2,0,0,0,0,0,16,2
Yakou Méïte,CIV,FW,27,Cardiff City,EFL,23.9,22,18,4,11,7,7,15,46.7,8,12,2,10,6,28,22,0
Yamil Asad,ARG,"MF,FW",28,D.C. United,MLS,5.8,10,4,1,6,3,5,23,21.7,18,9,0,9,4,14,3,1
Yan Brice Eteki,CMR,MF,26,Alcorcón,Segunda Division,26.6,61,38,26,31,4,32,59,54.2,27,29,8,21,25,86,40,2
Yan Phillipe,BRA,"FW,MF",19,Atlético,Liga MX,2.0,4,2,1,3,0,1,4,25.0,3,3,0,3,1,5,1,0
Yan Valery,TUN,DF,24,Angers,Ligue 2,33.5,74,45,31,28,15,31,43,72.1,12,30,7,23,46,120,74,0
Yanis Begraoui,MAR,"MF,FW",22,Pau FC,Ligue 2,11.3,8,4,1,4,3,5,13,38.5,8,6,0,6,5,13,3,0
Yanis Merdji,ALG,FW,29,US Concarneau,Ligue 2,7.6,5,3,1,4,0,2,10,20.0,8,3,1,2,4,9,0,0
Yanis Rahmani,FRA,"MF,FW",29,Tenerife,Segunda Division,9.3,18,16,9,7,2,9,23,39.1,14,16,3,13,6,24,11,0
Yanis Rahmani,FRA,FW,29,Eibar,Segunda Division,6.2,11,10,4,5,2,4,11,36.4,7,5,0,5,4,15,5,0
Yann Bodiger,FRA,MF,29,Tenerife,Segunda Division,12.1,18,11,7,10,1,11,26,42.3,15,19,3,16,14,32,22,0
Yann M'Vila,FRA,MF,33,West Brom,EFL,3.1,7,4,2,5,0,3,8,37.5,5,1,0,1,4,11,2,0
Yannick Bolasie,COD,"FW,MF",34,Swansea City,EFL,3.4,7,4,3,3,1,6,10,60.0,4,0,0,0,4,11,2,1
Yannik Engelhardt,GER,MF,22,Düsseldorf,2. Bundesliga,28.1,69,43,33,31,5,36,68,52.9,32,43,8,35,33,102,47,1
Yannik Lührs,GER,DF,19,Hannover 96,2. Bundesliga,2.1,1,1,0,1,0,0,1,0.0,1,2,2,0,5,6,14,0
Yannis Clementia,MTQ,GK,26,Caen,Ligue 2,4.0,0,0,0,0,0,0,0,0.0,0,0,0,0,0,0,3,0
Yannis Verdier,FRA,"FW,MF",20,Rodez Aveyron,Ligue 2,1.1,0,0,0,0,0,0,3,0.0,3,0,0,0,0,0,0,0
Yaser Asprilla,COL,"FW,MF",19,Watford,EFL,30.4,47,30,9,26,12,20,55,36.4,35,29,0,29,20,67,4,0
Yasin Ayari,SWE,MF,19,Coventry City,EFL,6.1,13,8,4,5,4,7,12,58.3,5,5,0,5,5,18,3,0
Yasin Ayari,SWE,MF,19,Blackburn,EFL,3.7,15,9,5,4,6,5,12,41.7,7,5,0,5,4,19,2,0
Yasser Baldé,GUI,DF,30,Stade Laval,Ligue 2,18.9,24,20,14,6,4,15,23,65.2,8,20,14,6,21,45,62,0
Yassin Belkhdim,FRA,MF,21,Angers,Ligue 2,0.8,6,2,4,1,1,2,4,50.0,2,0,0,0,2,8,2,1
Yassine Haouari,FRA,FW,20,Valenciennes,Ligue 2,1.6,2,1,1,1,0,1,1,100.0,0,3,1,2,1,3,1,0
Yaw Yeboah,GHA,"DF,MF",25,Crew,MLS,22.0,31,21,11,16,4,19,54,35.2,35,23,1,22,20,51,5,0
Yayah Kallon,SLE,FW,22,Bari,Serie B,7.0,7,4,3,3,1,5,9,55.6,4,8,1,7,3,10,3,0
Yayo González,ESP,MF,19,Oviedo,Segunda Division,0.1,0,0,0,0,0,0,0,0.0,0,0,0,0,0,0,0,0
Yehiya Silvestri,ITA,"MF,DF",18,Ascoli,Serie B,0.4,0,0,0,0,0,0,0,0.0,0,0,0,0,2,2,1,0
Yeimar Gómez Andrade,COL,DF,30,Seattle,MLS,32.1,48,30,34,14,0,23,46,50.0,23,31,19,12,73,121,143,0
Yekeson Subah,LBR,FW,18,LAFC,MLS,0.2,2,2,1,0,1,1,1,100.0,0,0,0,0,0,2,0,0
Yeray Cabanzón,ESP,"FW,MF",21,Racing Sant,Segunda Division,2.3,4,4,3,1,0,2,4,50.0,2,5,0,5,2,6,2,0
Yerson Mosquera,COL,DF,21,FC Cincinnati,MLS,25.0,45,37,31,11,3,20,37,54.1,17,31,16,15,47,92,112,1
Yevhen Cheberko,UKR,DF,25,Crew,MLS,2.2,4,3,3,1,0,1,3,33.3,2,0,0,0,2,6,12,1
Yimmi Chará,COL,FW,31,Portland Timbers,MLS,8.2,16,11,6,6,4,5,13,38.5,8,7,0,7,5,21,8,0
Yllan Okou,FRA,DF,20,Bastia,Ligue 2,22.4,15,9,11,4,0,7,20,35.0,13,12,8,4,35,50,97,0
Yoan Koré,FRA,DF,18,Paris FC,Ligue 2,17.1,36,27,18,18,0,22,33,66.7,11,16,12,4,6,42,52,0
Yoann Barbet,FRA,DF,30,Bordeaux,Ligue 2,33.5,37,23,29,7,1,32,46,69.6,14,49,33,16,33,70,113,1
Yoann Court,FRA,MF,33,Caen,Ligue 2,9.7,17,13,4,6,7,6,30,20.0,24,17,0,17,6,23,1,0
Yoann Touzghar,TUN,FW,36,Ajaccio,Ligue 2,19.6,4,2,1,2,1,3,7,42.9,4,3,0,3,6,10,10,0
Yohan Bai,FRA,MF,26,Bastia,Ligue 2,0.2,1,1,0,1,0,0,0,0.0,0,0,0,0,0,1,1,0
Yohan Bilingi,FRA,DF,24,Dunkerque,Ligue 2,31.6,46,22,30,11,5,23,32,71.9,9,28,10,18,26,72,90,1
Yohan Cassubie,FRA,"MF,DF",22,Bordeaux,Ligue 2,10.8,26,11,8,17,1,8,30,26.7,22,20,4,16,23,49,10,1
Yohan Demoncy,FRA,MF,27,Paris FC,Ligue 2,5.4,11,6,5,4,2,5,15,33.3,10,6,0,6,5,16,1,0
Yohan Demoncy,FRA,MF,27,Annecy,Ligue 2,12.7,23,14,6,14,3,5,25,20.0,20,21,3,18,5,28,4,0
Yohan Roche,BEN,DF,26,Quevilly-Rouen,Ligue 2,7.2,12,8,7,3,2,6,11,54.5,5,7,5,2,7,19,30,0
Yohan Tavares,POR,DF,35,Stade Laval,Ligue 2,20.0,16,9,13,3,0,9,12,75.0,3,20,16,4,23,39,98,2
Yohei Takaoka,JPN,GK,26,Vancouver W'caps,MLS,33.0,1,1,1,0,0,1,1,100.0,0,1,0,1,0,1,9,2
Yonis Njoh,FRA,"FW,MF",19,Pau FC,Ligue 2,4.2,6,4,4,0,2,4,5,80.0,1,2,0,2,5,11,3,0
Yordan Osorio,VEN,DF,29,Parma,Serie B,21.7,14,6,9,5,0,4,6,66.7,2,28,26,2,29,43,83,0
Yostin Valadez,MEX,MF,21,Mazatlán,Liga MX,0.0,0,0,0,0,0,0,0,0.0,0,0,0,0,0,0,0,0
Yosuke Hanya,JPN,"FW,MF",24,Rapids,MLS,0.5,0,0,0,0,0,0,0,0.0,0,0,0,0,0,0,0,0
Youness Lachhab Didi,MAR,"MF,DF",25,Eldense,Segunda Division,3.4,13,9,7,5,1,7,11,63.6,4,3,1,2,4,17,13,0
Youssef Amyn,IRQ,"FW,MF",19,Braunschweig,2. Bundesliga,3.6,6,6,2,2,2,3,9,33.3,6,6,0,6,0,6,1,0
Youssouf Assogba,BEN,DF,21,Amiens,Ligue 2,8.3,24,12,17,6,1,11,18,61.1,7,8,2,6,13,37,30,0
Youssouf M'Changama,COM,MF,32,Troyes,Ligue 2,19.3,16,11,4,10,2,5,17,29.4,12,12,4,8,18,34,14,1
Yunus Akgün,TUR,"MF,FW",23,Leicester City,EFL,9.9,16,10,5,7,4,4,11,36.4,7,10,0,10,6,22,3,0
Yuri Rocchetti,ITA,FW,20,Cremonese,Serie B,0.0,0,0,0,0,0,0,0,0.0,0,0,0,0,0,0,0,0
Yusuf Kabadayı,GER,"MF,FW",19,Schalke 04,2. Bundesliga,12.8,21,14,8,11,2,10,28,35.7,18,16,1,15,5,26,15,1
Yuta Nakayama,JPN,DF,26,Huddersfield,EFL,18.8,28,21,16,10,2,14,25,56.0,11,25,9,16,17,45,51,0
Yuya Kubo,JPN,"MF,FW",29,FC Cincinnati,MLS,11.9,18,12,9,8,1,4,21,19.0,17,9,1,8,10,28,8,0
Yvan Ikia Dimi,FRA,"MF,FW",18,Amiens,Ligue 2,3.4,9,4,6,3,0,5,7,71.4,2,6,0,6,1,10,4,0
Yvan Neyou,CMR,MF,27,Leganés,Segunda Division,28.8,68,42,31,33,4,32,58,55.2,26,36,10,26,35,103,24,0
Yvann Macon,FRA,DF,24,Saint-Étienne,Ligue 2,16.1,43,28,21,18,4,21,48,43.8,27,27,8,19,23,66,24,2
Yvann Titi,FRA,DF,17,Troyes,Ligue 2,1.0,1,1,1,0,0,1,2,50.0,1,0,0,0,2,3,3,0
Zac MacMath,USA,GK,31,RSL,MLS,27.5,0,0,0,0,0,0,0,0.0,0,0,0,0,1,1,17,3
Zac McGraw,CAN,DF,25,Portland Timbers,MLS,26.9,44,20,28,16,0,27,40,67.5,13,43,28,15,42,86,159,2
Zacharie Boucher,FRA,GK,31,Bastia,Ligue 2,2.0,0,0,0,0,0,0,0,0.0,0,0,0,0,0,0,0,0
Zachary Brault-Guillard,CAN,"DF,MF",24,CF Montréal,MLS,14.5,15,9,10,2,3,8,20,40.0,12,20,5,15,12,27,21,0
Zahid Muñoz,MEX,MF,22,Guadalajara,Liga MX,0.2,1,0,0,1,0,0,1,0.0,1,0,0,0,0,1,1,0
Zahid Muñoz,MEX,MF,22,FC Juárez,Liga MX,0.2,0,0,0,0,0,0,0,0.0,0,0,0,0,0,0,0,0
Zak Gilsenan,IRL,MF,20,Blackburn,EFL,0.0,0,0,0,0,0,0,0,0.0,0,0,0,0,0,0,0,0
Zak Vyner,KEN,DF,26,Bristol City,EFL,35.0,56,34,34,22,0,28,42,66.7,14,51,38,13,51,107,112,3
Zakaria Bengueddoudj,FRA,"MF,FW",23,Annecy,Ligue 2,3.4,8,7,0,6,2,2,4,50.0,2,5,0,5,4,12,6,0
Zakaria Naidji,ALG,"FW,MF",28,Stade Laval,Ligue 2,0.7,2,2,0,2,0,1,3,33.3,2,0,0,0,1,3,0,0
Zarek Valentin,PUR,DF,31,Minnesota Utd,MLS,14.7,16,9,11,5,0,8,19,42.1,11,16,7,9,13,29,35,0
Zavier Gozo,USA,FW,15,RSL,MLS,0.1,0,0,0,0,0,0,0,0.0,0,0,0,0,0,0,0,0
Zavier Massiah,ENG,MF,16,Watford,EFL,0.0,0,0,0,0,0,0,1,0.0,1,0,0,0,0,0,0,0
Zaydan Bello,AUS,MF,20,Minnesota Utd,MLS,0.2,1,1,0,0,1,0,1,0.0,1,0,0,0,0,1,0,0
Zian Flemming,NED,"FW,MF",24,Millwall,EFL,41.0,54,33,15,31,8,23,49,46.9,26,44,5,39,22,76,78,0
Zinedine Ferhat,ALG,"MF,FW",30,Angers,Ligue 2,18.4,17,12,7,7,3,9,23,39.1,14,16,2,14,14,31,15,0
Zinédine Ould Khaled,FRA,MF,23,Angers,Ligue 2,12.6,34,17,13,19,2,18,27,66.7,9,13,3,10,24,58,18,1
Ziyad Larkeche,FRA,"DF,FW",20,QPR,EFL,4.2,13,8,4,6,3,6,7,85.7,1,8,3,5,2,15,12,1
Zuriko Davitashvili,GEO,"FW,MF",22,Bordeaux,Ligue 2,29.9,34,18,7,19,8,17,42,40.5,25,29,2,27,10,44,9,0
kan Kouassi,CIV,MF,18,Ajaccio,Ligue 2,0.3,2,1,0,1,1,2,2,100.0,0,0,0,0,0,2,1,0
Alex Carbonell,ESP,MF,26,Amorebieta,Segunda Division,21.8,38,24,17,18,3,13,38,34.2,25,22,2,20,29,67,31,1
Adám Nagy,HUN,MF,28,Spezia,Serie B,14.6,22,13,9,13,0,15,30,50.0,15,13,3,10,15,37,11,0
Adám Nagy,HUN,MF,28,Pisa,Serie B,4.7,7,6,3,2,2,5,10,50.0,5,11,3,8,8,15,14,0
Alex Bermejo,ESP,"MF,FW",25,Burgos,Segunda Division,14.0,19,6,9,4,6,10,21,47.6,11,17,1,16,4,23,8,0
Alex Bernal,ESP,"MF,FW",33,Eldense,Segunda Division,18.9,35,19,11,17,7,11,24,45.8,13,27,2,25,29,64,8,0
Alex Calvo,ESP,"FW,DF",20,FC Andorra,Segunda Division,13.4,22,15,11,6,5,14,27,51.9,13,18,1,17,6,28,8,0
Alex Cantero,ESP,"FW,MF",24,Levante,Segunda Division,9.8,8,4,4,1,3,2,6,33.3,4,4,0,4,4,12,5,0
Alex Corredera,ESP,MF,28,Tenerife,Segunda Division,36.2,54,34,20,27,7,28,51,54.9,23,36,9,27,39,93,33,0
Alex Forés,ESP,FW,23,Villarreal B,Segunda Division,31.5,10,6,1,6,3,1,10,10.0,9,18,2,16,4,14,13,0
Alex López,ESP,"MF,FW",27,Alcorcón,Segunda Division,3.4,1,0,0,0,1,1,3,33.3,2,5,1,4,5,6,1,0
Alex López,ESP,MF,36,Racing Ferrol,Segunda Division,13.1,27,16,9,12,6,12,28,42.9,16,6,1,5,9,36,10,0
Alex Martín,ESP,"DF,MF",26,Elche,Segunda Division,3.5,15,10,11,4,0,10,11,90.9,1,2,1,1,12,27,15,0
Alex Martín,ESP,"DF,FW",26,Racing Ferrol,Segunda Division,2.7,6,4,5,1,0,4,5,80.0,1,2,0,2,5,11,19,0
Alex Martínez,ESP,DF,33,Eldense,Segunda Division,3.0,4,3,3,1,0,3,3,100.0,0,3,0,3,2,6,11,0
Alex Millán,ESP,"FW,MF",24,Oviedo,Segunda Division,1.1,0,0,0,0,0,0,1,0.0,1,0,0,0,0,0,1,0
Alex Muñoz,ESP,DF,29,Levante,Segunda Division,29.6,40,25,19,18,3,22,35,62.9,13,38,17,21,29,69,115,0
Alex Valle,ESP,DF,20,Levante,Segunda Division,25.6,71,40,40,18,13,53,79,67.1,26,36,7,29,36,107,79,0
Alvaro Aceves,ESP,GK,20,Eldense,Segunda Division,14.0,1,1,1,0,0,1,2,50.0,1,0,0,0,0,1,6,0
Alvaro Aguado,ESP,MF,28,Espanyol,Segunda Division,23.7,21,14,10,8,3,8,30,26.7,22,17,2,15,15,36,19,2
Alvaro Barreal,ARG,DF,22,FC Cincinnati,MLS,31.3,50,34,28,17,5,28,70,40.0,42,52,4,48,36,86,52,0
Alvaro Bustos,ESP,"MF,FW",28,Alcorcón,Segunda Division,2.7,3,3,0,1,2,0,2,0.0,2,4,0,4,3,6,4,0
Alvaro Fernández,ESP,GK,26,Huesca,Segunda Division,41.0,1,1,1,0,0,1,2,50.0,1,0,0,0,0,1,18,3
Alvaro Fidalgo,ESP,MF,26,América,Liga MX,26.1,37,26,14,18,5,17,46,37.0,29,20,5,15,19,56,17,1
Alvaro Giménez,ESP,FW,33,Racing Ferrol,Segunda Division,30.0,20,13,3,11,6,8,16,50.0,8,7,2,5,5,25,23,1
Alvaro Jiménez,ESP,MF,29,Tenerife,Segunda Division,4.2,3,1,1,1,1,1,2,50.0,1,7,0,7,2,5,1,0
Alvaro Martín de Frías,ESP,MF,23,FC Andorra,Segunda Division,9.8,20,11,4,11,5,7,19,36.8,12,12,1,11,6,26,3,0
Alvaro Negredo,ESP,FW,38,Valladolid,Segunda Division,6.5,3,2,1,2,0,1,2,50.0,1,1,0,1,0,3,4,0
Alvaro Rodríguez,ESP,DF,29,Albacete,Segunda Division,19.9,43,32,27,8,8,23,58,39.7,35,22,6,16,14,57,41,0
Alvaro Romero,ESP,"MF,FW",28,Tenerife,Segunda Division,1.1,2,2,2,0,0,1,3,33.3,2,4,0,4,0,2,1,0
Alvaro Santamaría,ESP,MF,22,Racing Sant,Segunda Division,0.1,0,0,0,0,0,0,0,0.0,0,0,0,0,0,0,0,0
Alvaro Tejero,ESP,DF,27,Eibar,Segunda Division,33.4,32,18,18,12,2,23,65,35.4,42,30,4,26,36,68,69,2
Alvaro Vadillo,ESP,FW,29,Racing Ferrol,Segunda Division,3.1,5,5,3,1,1,3,10,30.0,7,1,0,1,0,5,0,0
Angel Algobia,ESP,MF,24,Levante,Segunda Division,12.8,23,8,11,10,2,14,30,46.7,16,19,8,11,10,33,21,0
Angel Estrada,MEX,FW,20,Pachuca,Liga MX,0.0,0,0,0,0,0,0,0,0.0,0,0,0,0,0,0,0,0
Angel Jordán Acosta,MEX,"MF,FW",18,Monterrey,Liga MX,0.5,1,1,0,1,0,1,1,100.0,0,0,0,0,1,2,0,0
Angel Mena,ECU,"FW,MF",35,León,Liga MX,21.3,27,16,12,8,7,11,23,47.8,12,7,1,6,14,41,10,0
Angel Márquez,MEX,MF,23,Atlas,Liga MX,20.0,47,27,20,23,4,25,59,42.4,34,22,2,20,28,75,11,0
Angel Orelién,PAN,"FW,MF",22,Dunkerque,Ligue 2,5.6,3,2,1,1,1,0,6,0.0,6,2,0,2,5,8,3,0
Angel Robles,MEX,"FW,MF",21,Puebla,Liga MX,6.8,5,3,1,3,1,2,7,28.6,5,8,0,8,1,6,2,0
Angel Rodríguez,ESP,FW,37,Tenerife,Segunda Division,20.5,14,7,2,6,6,6,16,37.5,10,21,4,17,2,16,24,0
Angel Sepúlveda,MEX,FW,32,Querétaro,Liga MX,3.6,5,4,2,3,0,3,5,60.0,2,2,1,1,0,5,0,0
Angel Sepúlveda,MEX,FW,32,Cruz Azul,Liga MX,18.7,6,5,0,5,1,1,6,16.7,5,5,0,5,0,6,9,0
Angel Zaldívar,MEX,FW,29,Atlético,Liga MX,2.6,4,4,2,1,1,0,5,0.0,5,2,0,2,1,5,2,0
Angel Zaldívar,MEX,FW,29,FC Juárez,Liga MX,7.9,8,5,2,2,4,3,6,50.0,3,4,0,4,1,9,5,0
Angel Zapata,MEX,MF,22,FC Juárez,Liga MX,3.3,11,5,4,5,2,3,8,37.5,5,3,0,3,1,12,5,0
Edgar Badía,ESP,GK,32,Elche,Segunda Division,7.0,0,0,0,0,0,0,0,0.0,0,0,0,0,0,0,8,1
Edgar Badía,ESP,GK,32,Zaragoza,Segunda Division,18.0,0,0,0,0,0,0,0,0.0,0,0,0,0,0,0,6,0
Edgar Méndez,ESP,"FW,MF",33,Necaxa,Liga MX,14.3,14,7,3,10,1,6,15,40.0,9,9,2,7,4,18,12,0
Edgar Yoel Bárcenas,PAN,"FW,MF",29,Mazatlán,Liga MX,20.5,34,23,16,11,7,18,42,42.9,24,13,1,12,11,45,10,0
Eric Vandenabeele,FRA,DF,31,Rodez Aveyron,Ligue 2,0.5,1,0,0,1,0,1,1,100.0,0,1,1,0,0,1,8,0
Erick Aguirre,MEX,DF,26,Monterrey,Liga MX,16.7,54,35,36,14,4,35,51,68.6,16,18,3,15,22,76,45,0
Isak Jóhannesson,ISL,MF,20,Düsseldorf,2. Bundesliga,23.6,25,17,9,14,2,14,37,37.8,23,20,8,12,10,35,31,0
Iñigo Sainz Maza,ESP,MF,26,Racing Sant,Segunda Division,25.5,68,44,32,31,5,27,85,31.8,58,38,9,29,30,98,39,0
Oscar Clemente,ESP,MF,25,Levante,Segunda Division,8.8,14,6,7,4,3,7,24,29.2,17,5,0,5,7,21,7,0
Oscar Gil,ESP,DF,27,Espanyol,Segunda Division,9.1,21,12,12,8,1,6,14,42.9,8,19,9,10,12,33,17,1
Oscar Manzanarez,MEX,DF,28,Querétaro,Liga MX,21.4,35,21,25,7,3,17,25,68.0,8,39,16,23,33,68,91,0
Oscar Plano,ESP,"FW,MF",33,Elche,Segunda Division,15.1,19,10,5,13,1,6,15,40.0,9,16,2,14,14,33,7,0
Oscar Rivas,ESP,"DF,MF",24,Alcorcón,Segunda Division,25.2,32,19,18,12,2,21,46,45.7,25,38,26,12,34,66,131,3
Oscar Sielva,ESP,MF,32,Huesca,Segunda Division,33.7,51,28,22,24,5,31,57,54.4,26,43,17,26,40,91,89,0
Oscar Ustari,ARG,GK,37,Pachuca,Liga MX,3.0,0,0,0,0,0,0,1,0.0,1,0,0,0,0,0,1,0
Umaro Embaló,POR,"FW,MF",23,Cartagena,Segunda Division,6.0,7,5,5,2,0,1,9,11.1,8,7,0,7,2,9,4,0
Thorleifur Úlfarsson,ISL,"FW,MF",22,Dynamo FC,MLS,5.3,1,1,0,1,0,0,6,0.0,6,1,0,1,2,3,4,0
Thórir Jóhann Helgason,ISL,MF,22,Braunschweig,2. Bundesliga,18.5,21,12,7,14,0,8,24,33.3,16,21,7,14,20,41,23,0
Dorđe Petrović,SRB,GK,23,NE Revolution,MLS,22.0,0,0,0,0,0,0,1,0.0,1,0,0,0,1,1,7,1
Lukasz Poręba,POL,MF,23,Hamburger SV,2. Bundesliga,7.3,12,7,2,6,4,6,11,54.5,5,18,2,16,2,14,5,0
Zan Kolmanič,SVN,DF,22,Austin,MLS,4.7,14,11,7,7,0,7,10,70.0,3,4,1,3,6,20,15,0
Zan Majer,SVN,MF,31,Cremonese,Serie B,8.6,11,8,6,5,0,4,13,30.8,9,9,5,4,8,19,10,1
Zan Vipotnik,SVN,FW,21,Bordeaux,Ligue 2,26.5,4,2,2,1,1,1,6,16.7,5,5,2,3,1,5,11,0
Zan Žužek,SVN,DF,26,Bari,Serie B,7.4,18,13,10,8,0,4,6,66.7,2,9,6,3,15,33,32,1
